a_o,mes,nacionalidad,codigo_iso_3166,femenino,masculino,total,latitud_longitud
2016,Febrero,Desconocido,99999,1,4,5,"(3.541112,-76.384584)"
2021,Septiembre,Turquía,792,1,3,4,"(10.445761,-75.516429)"
2012,Julio,Francia,250,61,73,134,"(0.814836,-77.662532)"
2012,Junio,Turquía,792,0,3,3,"(11.360009,-72.129330)"
2013,Julio,Eslovaquia,703,12,14,26,"(3.541112,-76.384584)"
2012,Septiembre,Bolivia,68,2,0,2,"(7.927209,-72.507910)"
2023,Enero,Francia,250,16,11,27,"(-4.197703,-69.941278)"
2021,Diciembre,España,724,8,10,18,"(7.927209,-72.507910)"
2013,Agosto,Países Bajos,528,6,6,12,"(7.128456,-73.183637)"
2013,Julio,Países Bajos,528,0,1,1,"(10.886611,-74.776708)"
2022,Octubre,Uruguay,858,1,2,3,"(7.818934,-72.453226)"
2012,Julio,Isla de Man,833,1,8,9,"(10.886611,-74.776708)"
2012,Febrero,Panamá,591,0,5,5,"(10.408582,-75.538003)"
2019,Noviembre,Bélgica,56,1,1,2,"(0.25129,-76.875963)"
2022,Marzo,Eslovaquia,703,1,0,1,"(-4.197703,-69.941278)"
2013,Junio,Sudáfrica,710,3,0,3,"(10.408582,-75.538003)"
2022,Junio,Eslovenia,705,0,1,1,"(12.5744111,-81.703935)"
2013,Julio,Surinam,740,3,2,5,"(6.171601,-75.427454)"
2023,Abril,Polonia,616,1,0,1,"(12.586067,-81.702563)"
2023,Marzo,Islandia,352,2,3,5,"(4.697144,-74.140516)"
2019,Enero,Austria,40,0,1,1,"(13.3387613,-81.372937)"
2022,Agosto,Honduras,340,19,25,44,"(10.886611,-74.776708)"
2014,Enero,Eslovaquia,703,0,2,2,"(6.171601,-75.427454)"
2023,Abril,Italia,380,28,40,68,"(7.818934,-72.453226)"
2012,Septiembre,Finlandia,246,0,2,2,"(3.541112,-76.384584)"
2018,Julio,Cuba,192,1,2,3,"(7.818934,-72.453226)"
2021,Agosto,India,356,0,2,2,"(11.247723,-74.213989)"
2018,Junio,Suiza,756,1,1,2,"(4.815061,-75.736532)"
2015,Junio,Dinamarca,208,2,1,3,"(10.408582,-75.538003)"
2019,Octubre,Israel,376,119,365,484,"(4.697144,-74.140516)"
2013,Junio,Italia,380,17,43,60,"(10.445761,-75.516429)"
2014,Junio,Cuba,192,14,19,33,"(10.445761,-75.516429)"
2023,Febrero,Taiwán,158,8,9,17,"(6.171601,-75.427454)"
2016,Julio,Nueva Zelanda,554,2,1,3,"(3.541112,-76.384584)"
2016,Enero,Cuba,192,0,1,1,"(4.452882,-75.766298)"
2020,Marzo,Letonia,428,1,0,1,"(6.171601,-75.427454)"
2012,Agosto,Honduras,340,0,7,7,"(10.408582,-75.538003)"
2015,Agosto,Cuba,192,0,2,2,"(12.5744111,-81.703935)"
2021,Septiembre,Israel,376,209,435,644,"(4.697144,-74.140516)"
2017,Noviembre,Argelia,12,2,3,5,"(4.697144,-74.140516)"
2023,Enero,Argentina,32,1,3,4,"(7.927209,-72.507910)"
2023,Enero,Malta,470,4,0,4,"(10.445761,-75.516429)"
2022,Noviembre,Bangladesh,50,0,1,1,"(10.886611,-74.776708)"
2021,Junio,Jamaica,388,5,9,14,"(10.445761,-75.516429)"
2021,Mayo,Malta,470,0,2,2,"(6.171601,-75.427454)"
2016,Julio,Desconocido,99999,0,3,3,"(6.171601,-75.427454)"
2020,Marzo,El Salvador,222,1,1,2,"(10.886611,-74.776708)"
2015,Noviembre,Costa Rica,188,2,3,5,"(4.815061,-75.736532)"
2019,Septiembre,Ecuador,218,21,50,71,"(10.408582,-75.538003)"
2016,Enero,Canadá,124,9,16,25,"(8.635765,-77.346578)"
2022,Enero,Zimbabue,716,0,1,1,"(6.171601,-75.427454)"
2017,Diciembre,Líbano,422,16,43,59,"(4.697144,-74.140516)"
2017,Mayo,Austria,40,11,8,19,"(0.814836,-77.662532)"
2019,Mayo,Nigeria,566,1,5,6,"(6.171601,-75.427454)"
2018,Agosto,Líbano,422,0,1,1,"(7.128456,-73.183637)"
2023,Marzo,Bélgica,56,28,43,71,"(10.445761,-75.516429)"
2023,Enero,Guatemala,320,5,8,13,"(4.815061,-75.736532)"
2021,Septiembre,Polonia,616,3,14,17,"(10.445761,-75.516429)"
2017,Mayo,Perú,604,0,5,5,"(7.088729,-70.740253)"
2021,Noviembre,Venezuela,862,324,337,661,"(3.541112,-76.384584)"
2022,Agosto,Perú,604,295,367,662,"(3.541112,-76.384584)"
2019,Junio,Ecuador,218,6,8,14,"(11.360009,-72.129330)"
2014,Diciembre,Japón,392,1,0,1,"(7.927209,-72.507910)"
2012,Julio,Belice,84,1,1,2,"(6.171601,-75.427454)"
2014,Octubre,Grecia,300,19,53,72,"(4.697144,-74.140516)"
2022,Septiembre,Venezuela,862,7,7,14,"(0.25129,-76.875963)"
2014,Abril,Italia,380,0,12,12,"(-4.197703,-69.941278)"
2018,Abril,Eslovenia,705,29,53,82,"(4.697144,-74.140516)"
2018,Enero,Federación de Rusia,643,0,5,5,"(9.402978,-75.681599)"
2019,Abril,Bolivia,68,18,16,34,"(3.541112,-76.384584)"
2017,Agosto,Bélgica,56,349,494,843,"(4.697144,-74.140516)"
2012,Noviembre,Singapur,702,13,22,35,"(4.697144,-74.140516)"
2012,Octubre,Honduras,340,12,21,33,"(3.541112,-76.384584)"
2018,Noviembre,Georgia,268,0,1,1,"(11.247723,-74.213989)"
2022,Junio,Filipinas,608,1,0,1,"(4.452882,-75.766298)"
2016,Enero,Bélgica,56,0,2,2,"(7.128456,-73.183637)"
2019,Abril,México,484,5,4,9,"(12.586067,-81.702563)"
2017,Marzo,Venezuela,862,6887,9246,16133,"(7.818934,-72.453226)"
2017,Noviembre,Países Bajos,528,0,4,4,"(10.971302,-74.765397)"
2012,Febrero,Croacia,191,0,4,4,"(10.445761,-75.516429)"
2014,Febrero,Dinamarca,208,0,2,2,"(8.635765,-77.346578)"
2015,Marzo,Ecuador,218,2,1,3,"(-4.197703,-69.941278)"
2013,Diciembre,Austria,40,0,1,1,"(8.635765,-77.346578)"
2016,Enero,Cuba,192,2,2,4,"(12.586067,-81.702563)"
2018,Enero,Mauricio,480,0,1,1,"(10.408582,-75.538003)"
2016,Noviembre,Alemania,276,8,8,16,"(8.635765,-77.346578)"
2014,Octubre,San  Vicente y las Granadinas,670,1,1,2,"(12.586067,-81.702563)"
2012,Octubre,Venezuela,862,20,12,32,"(12.586067,-81.702563)"
2023,Enero,Luxemburgo,442,0,1,1,"(3.541112,-76.384584)"
2017,Agosto,República de Corea,410,0,1,1,"(10.408582,-75.538003)"
2022,Marzo,Estados Unidos de América,840,1,3,4,"(0.25129,-76.875963)"
2017,Junio,Venezuela,862,1,1,2,"(-4.223468,-69.945098)"
2014,Diciembre,Rumania,642,35,60,95,"(4.697144,-74.140516)"
2023,Enero,Bélgica,56,1,1,2,"(-4.223468,-69.945098)"
2017,Junio,Chile,152,1,5,6,"(4.815061,-75.736532)"
2015,Febrero,España,724,1,1,2,"(7.128456,-73.183637)"
2022,Octubre,Italia,380,0,9,9,"(4.815061,-75.736532)"
2015,Febrero,Suecia,752,1,3,4,"(10.886611,-74.776708)"
2018,Octubre,Países Bajos,528,1574,2123,3697,"(4.697144,-74.140516)"
2012,Septiembre,Haití,332,0,1,1,"(6.171601,-75.427454)"
2023,Enero,Estados Unidos de América,840,1,2,3,"(7.088729,-70.740253)"
2017,Febrero,Taiwán,158,8,14,22,"(6.171601,-75.427454)"
2017,Mayo,Argentina,32,17,21,38,"(10.886611,-74.776708)"
2018,Enero,Argentina,32,2164,1559,3723,"(10.445761,-75.516429)"
2017,Abril,Indonesia,360,0,4,4,"(10.971302,-74.765397)"
2012,Febrero,Turquía,792,0,4,4,"(7.818934,-72.453226)"
2012,Enero,Costa Rica,188,3,4,7,"(7.128456,-73.183637)"
2012,Noviembre,Bolivia,68,0,4,4,"(11.360009,-72.129330)"
2023,Febrero,Polonia,616,2,4,6,"(-4.197703,-69.941278)"
2017,Mayo,Cuba,192,16,18,34,"(3.541112,-76.384584)"
2017,Enero,Canadá,124,30,42,72,"(0.814836,-77.662532)"
2022,Junio,Italia,380,601,1319,1920,"(4.697144,-74.140516)"
2019,Mayo,Tailandia,764,2,3,5,"(6.171601,-75.427454)"
2012,Enero,Estados Unidos de América,840,1,0,1,"(7.088729,-70.740253)"
2022,Febrero,México,484,3,5,8,"(7.927209,-72.507910)"
2014,Septiembre,Bolivia,68,2,1,3,"(10.886611,-74.776708)"
2019,Julio,Egipto,818,0,1,1,"(0.814836,-77.662532)"
2016,Abril,Bolivia,68,13,9,22,"(10.408582,-75.538003)"
2022,Agosto,República Checa,203,1,1,2,"(1.813928,-78.763924)"
2020,Enero,España,724,32,58,90,"(7.818934,-72.453226)"
2019,Diciembre,Filipinas,608,0,20,20,"(10.971302,-74.765397)"
2013,Febrero,Paraguay,600,25,17,42,"(10.445761,-75.516429)"
2018,Julio,República Democrática Popular  Lao,418,1,2,3,"(4.697144,-74.140516)"
2014,Noviembre,Brasil,76,1,2,3,"(-4.223468,-69.945098)"
2015,Mayo,República Checa,203,11,4,15,"(10.445761,-75.516429)"
2023,Marzo,Federación de Rusia,643,2,2,4,"(11.117806,-74.232622)"
2019,Mayo,Alemania,276,85,119,204,"(10.445761,-75.516429)"
2016,Marzo,Líbano,422,0,2,2,"(10.886611,-74.776708)"
2019,Mayo,Finlandia,246,34,44,78,"(4.697144,-74.140516)"
2012,Septiembre,Guyana,328,0,1,1,"(4.815061,-75.736532)"
2015,Junio,Lesoto,426,2,0,2,"(4.697144,-74.140516)"
2023,Junio,República de Irlanda,372,1,2,3,"(10.408582,-75.538003)"
2021,Septiembre,Suiza,756,13,57,70,"(6.171601,-75.427454)"
2015,Septiembre,Alemania,276,9,13,22,"(-4.197703,-69.941278)"
2012,Enero,Alemania,276,0,1,1,"(3.893038,-77.067921)"
2016,Abril,Guinea,324,0,1,1,"(4.697144,-74.140516)"
2020,Diciembre,Bangladesh,50,0,1,1,"(11.247723,-74.213989)"
2022,Noviembre,Indonesia,360,2,0,2,"(3.541112,-76.384584)"
2022,Marzo,Belice,84,1,0,1,"(10.886611,-74.776708)"
2022,Diciembre,San  Vicente y las Granadinas,670,1,2,3,"(3.541112,-76.384584)"
2016,Febrero,Andorra,20,1,11,12,"(4.697144,-74.140516)"
2016,Septiembre,Austria,40,3,3,6,"(8.635765,-77.346578)"
2013,Febrero,Granada,308,1,0,1,"(4.697144,-74.140516)"
2017,Septiembre,Uruguay,858,0,1,1,"(11.360009,-72.129330)"
2017,Junio,Bolivia,68,3,2,5,"(-4.197703,-69.941278)"
2018,Noviembre,Eslovaquia,703,56,61,117,"(4.697144,-74.140516)"
2016,Septiembre,Malasia,458,14,33,47,"(4.697144,-74.140516)"
2021,Febrero,India,356,0,1,1,"(4.815061,-75.736532)"
2014,Febrero,Ucrania,804,0,2,2,"(3.893038,-77.067921)"
2017,Octubre,Japón,392,0,1,1,"(7.818934,-72.453226)"
2017,Octubre,Dinamarca,208,2,3,5,"(12.5744111,-81.703935)"
2015,Diciembre,Reino Unido de Gran Bretaña e Irlanda del Norte,826,52,109,161,"(3.541112,-76.384584)"
2019,Febrero,Filipinas,608,6,72,78,"(10.408582,-75.538003)"
2022,Enero,Israel,376,251,453,704,"(4.697144,-74.140516)"
2017,Enero,Países Bajos,528,0,3,3,"(10.971302,-74.765397)"
2014,Agosto,Pakistán,586,0,1,1,"(10.408582,-75.538003)"
2013,Agosto,Kenia,404,0,2,2,"(3.541112,-76.384584)"
2014,Octubre,Francia,250,39,58,97,"(0.814836,-77.662532)"
2020,Enero,Chile,152,655,433,1088,"(10.445761,-75.516429)"
2019,Septiembre,República de Moldavia,498,5,3,8,"(4.697144,-74.140516)"
2015,Mayo,República Dominicana,214,7,10,17,"(12.586067,-81.702563)"
2014,Julio,Australia,36,38,43,81,"(0.814836,-77.662532)"
2020,Diciembre,Georgia,268,0,1,1,"(10.408582,-75.538003)"
2013,Marzo,Grecia,300,0,2,2,"(7.818934,-72.453226)"
2013,Marzo,Bahamas,44,0,1,1,"(10.445761,-75.516429)"
2022,Febrero,Jamaica,388,11,10,21,"(10.445761,-75.516429)"
2019,Septiembre,Kazajistán,398,1,1,2,"(10.445761,-75.516429)"
2013,Abril,Costa Rica,188,1,1,2,"(4.452882,-75.766298)"
2023,Mayo,Japón,392,2,3,5,"(0.814836,-77.662532)"
2014,Febrero,Argentina,32,5,14,19,"(8.635765,-77.346578)"
2012,Noviembre,Guayana Francesa/Departamento de Ultramar Francés,254,0,1,1,"(4.697144,-74.140516)"
2012,Diciembre,Israel,376,1,0,1,"(11.247723,-74.213989)"
2018,Mayo,Federación de Rusia,643,1,0,1,"(11.360009,-72.129330)"
2022,Noviembre,México,484,8,8,16,"(4.452882,-75.766298)"
2014,Julio,Santa Lucia,662,0,1,1,"(3.541112,-76.384584)"
2019,Enero,Granada,308,0,9,9,"(4.697144,-74.140516)"
2017,Octubre,República de Irlanda,372,1,1,2,"(-4.197703,-69.941278)"
2023,Marzo,Nepal,524,0,10,10,"(4.697144,-74.140516)"
2015,Agosto,Dinamarca,208,1,2,3,"(10.408582,-75.538003)"
2013,Octubre,Paraguay,600,1,2,3,"(0.814836,-77.662532)"
2021,Diciembre,Dinamarca,208,1,0,1,"(4.452882,-75.766298)"
2016,Mayo,Dinamarca,208,5,7,12,"(10.445761,-75.516429)"
2017,Noviembre,Australia,36,27,19,46,"(8.635765,-77.346578)"
2020,Febrero,Líbano,422,1,1,2,"(3.541112,-76.384584)"
2018,Mayo,Brasil,76,1,1,2,"(11.360009,-72.129330)"
2018,Julio,Ecuador,218,36,22,58,"(0.812436,-77.847006)"
2022,Mayo,Suiza,756,0,1,1,"(0.25129,-76.875963)"
2015,Septiembre,El Salvador,222,37,36,73,"(12.586067,-81.702563)"
2018,Octubre,Refugiado Otro,99999,0,1,1,"(4.697144,-74.140516)"
2022,Enero,Guinea Bissau,624,0,1,1,"(4.697144,-74.140516)"
2022,Mayo,Noruega,578,64,90,154,"(4.697144,-74.140516)"
2013,Marzo,México,484,57,128,185,"(3.541112,-76.384584)"
2016,Octubre,India,356,0,10,10,"(11.247723,-74.213989)"
2022,Septiembre,Papúa Nueva Guinea,598,0,1,1,"(4.697144,-74.140516)"
2021,Enero,República de Belarús,112,0,2,2,"(6.171601,-75.427454)"
2013,Noviembre,Perú,604,48,32,80,"(10.408582,-75.538003)"
2013,Junio,Perú,604,14,39,53,"(-4.197703,-69.941278)"
2017,Julio,Filipinas,608,0,1,1,"(11.360009,-72.129330)"
2022,Diciembre,El Salvador,222,3,1,4,"(12.586067,-81.702563)"
2021,Agosto,Alemania,276,3,8,11,"(10.408582,-75.538003)"
2018,Abril,Trinidad y Tobago,780,0,1,1,"(7.818934,-72.453226)"
2021,Noviembre,España,724,0,5,5,"(10.408582,-75.538003)"
2018,Junio,Chile,152,7,15,22,"(10.886611,-74.776708)"
2023,Junio,Brasil,76,1,1,2,"(0.25129,-76.875963)"
2020,Diciembre,Panamá,591,44,74,118,"(10.886611,-74.776708)"
2014,Septiembre,Argentina,32,2,7,9,"(-4.197703,-69.941278)"
2022,Enero,México,484,0,6,6,"(1.813928,-78.763924)"
2015,Febrero,República de Moldavia,498,1,0,1,"(6.171601,-75.427454)"
2012,Octubre,Etiopia,231,1,1,2,"(4.697144,-74.140516)"
2021,Octubre,República de Belarús,112,1,0,1,"(6.171601,-75.427454)"
2017,Marzo,Nueva Zelanda,554,1,1,2,"(13.3387613,-81.372937)"
2015,Noviembre,Emiratos Árabes,784,0,1,1,"(3.541112,-76.384584)"
2014,Marzo,Finlandia,246,0,1,1,"(7.818934,-72.453226)"
2015,Abril,Guatemala,320,10,8,18,"(12.586067,-81.702563)"
2017,Septiembre,Nicaragua,558,1,1,2,"(10.408582,-75.538003)"
2020,Septiembre,Alemania,276,17,20,37,"(4.697144,-74.140516)"
2015,Septiembre,Irán,364,1,0,1,"(0.814836,-77.662532)"
2022,Mayo,Irán,364,7,15,22,"(4.697144,-74.140516)"
2019,Abril,Luxemburgo,442,7,14,21,"(4.697144,-74.140516)"
2013,Noviembre,República Checa,203,1,1,2,"(0.25129,-76.875963)"
2017,Mayo,Egipto,818,0,1,1,"(7.818934,-72.453226)"
2016,Febrero,Uruguay,858,52,57,109,"(10.445761,-75.516429)"
2017,Junio,Turquía,792,0,1,1,"(-4.223468,-69.945098)"
2014,Febrero,Suiza,756,4,6,10,"(-4.197703,-69.941278)"
2019,Julio,Malasia,458,1,2,3,"(6.171601,-75.427454)"
2015,Febrero,Bélgica,56,0,1,1,"(7.818934,-72.453226)"
2023,Mayo,Guatemala,320,1,2,3,"(0.814836,-77.662532)"
2012,Noviembre,Panamá,591,2,2,4,"(8.635765,-77.346578)"
2022,Marzo,Perú,604,0,2,2,"(-0.193180,-74.784874)"
2018,Septiembre,Nueva Zelanda,554,1,3,4,"(3.541112,-76.384584)"
2018,Noviembre,Noruega,578,1,3,4,"(4.815061,-75.736532)"
2016,Mayo,Austria,40,0,2,2,"(7.818934,-72.453226)"
2019,Junio,República de Moldavia,498,6,1,7,"(4.697144,-74.140516)"
2017,Septiembre,Turquía,792,2,9,11,"(6.171601,-75.427454)"
2014,Noviembre,India,356,0,3,3,"(10.408582,-75.538003)"
2019,Diciembre,Grecia,300,12,31,43,"(10.445761,-75.516429)"
2019,Octubre,Grecia,300,0,3,3,"(3.541112,-76.384584)"
2014,Octubre,India,356,0,1,1,"(11.360009,-72.129330)"
2015,Abril,China,156,2,13,15,"(7.818934,-72.453226)"
2023,Marzo,Bolivia,68,3,5,8,"(11.117806,-74.232622)"
2022,Junio,Chile,152,0,2,2,"(7.128456,-73.183637)"
2018,Mayo,Bosnia y Herzegovina,70,4,7,11,"(4.697144,-74.140516)"
2016,Diciembre,Chile,152,3639,4738,8377,"(4.697144,-74.140516)"
2022,Noviembre,Bélgica,56,0,1,1,"(7.916725,-72.462544)"
2019,Junio,República de Irlanda,372,8,10,18,"(8.635765,-77.346578)"
2015,Septiembre,Australia,36,2,6,8,"(7.818934,-72.453226)"
2020,Septiembre,Desconocido,99999,4,15,19,"(4.697144,-74.140516)"
2022,Marzo,Italia,380,0,1,1,"(0.25129,-76.875963)"
2017,Abril,Canadá,124,27,50,77,"(10.886611,-74.776708)"
2014,Octubre,Paraguay,600,115,110,225,"(4.697144,-74.140516)"
2019,Diciembre,Túnez,788,0,3,3,"(6.171601,-75.427454)"
2023,Mayo,República Dominicana,214,89,147,236,"(10.886611,-74.776708)"
2019,Noviembre,República Árabe Siria,760,0,2,2,"(4.697144,-74.140516)"
2019,Abril,Jamaica,388,3,10,13,"(6.171601,-75.427454)"
2018,Septiembre,Australia,36,56,96,152,"(10.445761,-75.516429)"
2018,Junio,Uganda,800,2,3,5,"(4.697144,-74.140516)"
2018,Septiembre,Italia,380,676,1709,2386,"(4.697144,-74.140516)"
2016,Enero,Austria,40,2,1,3,"(11.247723,-74.213989)"
2014,Agosto,Panamá,591,558,831,1389,"(6.171601,-75.427454)"
2012,Diciembre,Guyana,328,0,1,1,"(12.586067,-81.702563)"
2021,Septiembre,República de Corea,410,1,0,1,"(7.818934,-72.453226)"
2022,Noviembre,Argentina,32,1,1,2,"(0.25129,-76.875963)"
2021,Junio,Venezuela,862,1787,2063,3850,"(11.360009,-72.129330)"
2020,Febrero,San  Vicente y las Granadinas,670,1,1,2,"(12.586067,-81.702563)"
2013,Noviembre,El Salvador,222,45,69,114,"(6.171601,-75.427454)"
2012,Junio,España,724,7,13,20,"(10.886611,-74.776708)"
2014,Diciembre,Grecia,300,0,1,1,"(7.818934,-72.453226)"
2018,Diciembre,Ucrania,804,0,1,1,"(10.886611,-74.776708)"
2018,Septiembre,Paraguay,600,1,0,1,"(4.452882,-75.766298)"
2020,Febrero,Turquía,792,7,17,24,"(10.445761,-75.516429)"
2022,Diciembre,Hong Kong,344,2,2,4,"(10.445761,-75.516429)"
2021,Marzo,Emiratos Árabes,784,0,2,2,"(4.697144,-74.140516)"
2020,Agosto,Estados Unidos de América,840,3,9,12,"(10.445761,-75.516429)"
2022,Septiembre,Montenegro,499,0,3,3,"(3.893038,-77.067921)"
2023,Enero,Uzbekistán,860,1,0,1,"(6.171601,-75.427454)"
2014,Diciembre,Venezuela,862,5536,6081,11617,"(7.818934,-72.453226)"
2014,Enero,España,724,0,2,2,"(7.088729,-70.740253)"
2019,Julio,Federación de Rusia,643,0,1,1,"(9.402978,-75.681599)"
2015,Octubre,Venezuela,862,1,7,8,"(4.815061,-75.736532)"
2014,Octubre,Ecuador,218,2078,3141,5219,"(4.697144,-74.140516)"
2023,Junio,Islas Caimán/Territorio Británico de Ultramar,136,0,2,2,"(10.445761,-75.516429)"
2015,Junio,República de Corea,410,16,18,34,"(0.814836,-77.662532)"
2019,Junio,Suecia,752,1,5,6,"(4.815061,-75.736532)"
2016,Mayo,Ecuador,218,1498,2731,4229,"(0.814836,-77.662532)"
2017,Noviembre,Andorra,20,2,8,10,"(4.697144,-74.140516)"
2022,Diciembre,China,156,57,64,121,"(6.171601,-75.427454)"
2019,Julio,República Dominicana,214,0,3,3,"(7.128456,-73.183637)"
2014,Febrero,Suiza,756,15,17,32,"(10.408582,-75.538003)"
2017,Febrero,República Checa,203,6,15,21,"(3.541112,-76.384584)"
2022,Octubre,Suiza,756,53,58,111,"(10.445761,-75.516429)"
2023,Abril,Canadá,124,1,3,4,"(-4.197703,-69.941278)"
2021,Julio,Federación de Rusia,643,0,1,1,"(9.402978,-75.681599)"
2016,Diciembre,Alemania,276,18,23,41,"(-4.197703,-69.941278)"
2019,Septiembre,Rumania,642,1,4,5,"(10.886611,-74.776708)"
2018,Agosto,Australia,36,287,577,864,"(4.697144,-74.140516)"
2023,Mayo,México,484,0,3,3,"(13.3387613,-81.372937)"
2014,Julio,San Cristóbal y Nevis,659,1,1,2,"(4.697144,-74.140516)"
2017,Marzo,Belice,84,1,1,2,"(6.171601,-75.427454)"
2022,Agosto,Sudáfrica,710,1,0,1,"(11.117806,-74.232622)"
2016,Junio,Estados Unidos de América,840,251,333,584,"(4.815061,-75.736532)"
2014,Noviembre,El Salvador,222,3,3,6,"(10.886611,-74.776708)"
2015,Noviembre,Polonia,616,5,7,12,"(10.445761,-75.516429)"
2019,Septiembre,Sri Lanka,144,0,1,1,"(10.445761,-75.516429)"
2015,Marzo,Israel,376,16,100,116,"(6.171601,-75.427454)"
2022,Agosto,Indonesia,360,1,2,3,"(10.445761,-75.516429)"
2015,Abril,Australia,36,0,1,1,"(7.128456,-73.183637)"
2017,Abril,República de Irlanda,372,9,25,34,"(6.171601,-75.427454)"
2015,Febrero,Australia,36,231,368,599,"(4.697144,-74.140516)"
2014,Junio,Camerún,120,1,0,1,"(0.814836,-77.662532)"
2014,Mayo,Austria,40,1,1,2,"(11.247723,-74.213989)"
2015,Marzo,Filipinas,608,0,32,32,"(11.247723,-74.213989)"
2014,Abril,Paraguay,600,1,2,3,"(4.815061,-75.736532)"
2016,Octubre,Australia,36,1,3,4,"(7.818934,-72.453226)"
2018,Noviembre,Italia,380,2,4,6,"(8.635765,-77.346578)"
2018,Junio,República Dominicana,214,64,92,156,"(10.445761,-75.516429)"
2019,Noviembre,Noruega,578,19,51,70,"(10.445761,-75.516429)"
2022,Junio,Estados Unidos de América,840,9,21,30,"(-4.197703,-69.941278)"
2023,Mayo,Islas Caimán/Territorio Británico de Ultramar,136,0,1,1,"(10.445761,-75.516429)"
2023,Junio,Mozambique,508,1,0,1,"(10.445761,-75.516429)"
2015,Mayo,Japón,392,1,1,2,"(-4.197703,-69.941278)"
2021,Diciembre,Portugal,620,26,27,53,"(7.818934,-72.453226)"
2019,Octubre,Nueva Zelanda,554,1,2,3,"(3.541112,-76.384584)"
2022,Abril,Liechtenstein,438,1,0,1,"(10.445761,-75.516429)"
2017,Junio,Grecia,300,0,1,1,"(3.893038,-77.067921)"
2012,Octubre,Venezuela,862,55,81,136,"(3.541112,-76.384584)"
2015,Junio,Francia,250,30,52,82,"(10.445761,-75.516429)"
2016,Septiembre,República Dominicana,214,90,107,197,"(6.171601,-75.427454)"
2019,Mayo,Francia,250,10,24,34,"(10.408582,-75.538003)"
2013,Mayo,Estados Unidos de América,840,8,11,19,"(7.927209,-72.507910)"
2023,Febrero,España,724,0,1,1,"(0.812436,-77.847006)"
2022,Enero,Tanzania,834,0,4,4,"(4.697144,-74.140516)"
2018,Mayo,Refugiado,99999,2,2,4,"(4.697144,-74.140516)"
2012,Noviembre,Reino Unido de Gran Bretaña e Irlanda del Norte,826,186,493,679,"(4.697144,-74.140516)"
2016,Marzo,Panamá,591,3,3,6,"(7.818934,-72.453226)"
2020,Agosto,Suiza,756,12,8,20,"(4.697144,-74.140516)"
2018,Enero,República de Irlanda,372,0,2,2,"(-4.197703,-69.941278)"
2014,Julio,India,356,1,7,8,"(10.886611,-74.776708)"
2022,Junio,Brasil,76,7,35,42,"(10.886611,-74.776708)"
2020,Febrero,Panamá,591,4,3,7,"(8.635765,-77.346578)"
2021,Octubre,Perú,604,17,27,44,"(7.818934,-72.453226)"
2014,Agosto,Ucrania,804,0,3,3,"(10.445761,-75.516429)"
2021,Mayo,Venezuela,862,1,3,4,"(4.452882,-75.766298)"
2022,Marzo,Cuba,192,2,2,4,"(4.815061,-75.736532)"
2017,Enero,Guatemala,320,1,2,3,"(11.360009,-72.129330)"
2012,Febrero,Vietnam,704,1,0,1,"(6.171601,-75.427454)"
2021,Marzo,Nigeria,566,0,1,1,"(10.886611,-74.776708)"
2020,Febrero,Jamaica,388,43,32,75,"(4.697144,-74.140516)"
2015,Mayo,Alemania,276,5,11,16,"(10.886611,-74.776708)"
2012,Marzo,Polonia,616,4,1,5,"(10.445761,-75.516429)"
2017,Agosto,República de Kosovo,901,0,1,1,"(4.697144,-74.140516)"
2018,Julio,Arabia Saudita,682,1,1,2,"(6.171601,-75.427454)"
2012,Noviembre,Panamá,591,444,687,1131,"(4.697144,-74.140516)"
2012,Febrero,Nueva Zelanda,554,1,0,1,"(11.360009,-72.129330)"
2012,Agosto,España,724,5,2,7,"(12.586067,-81.702563)"
2022,Octubre,Nicaragua,558,1,0,1,"(12.586067,-81.702563)"
2021,Febrero,Países Bajos,528,12,21,33,"(10.886611,-74.776708)"
2019,Octubre,México,484,1,4,5,"(-4.197703,-69.941278)"
2015,Noviembre,República Dominicana,214,1,3,4,"(10.408582,-75.538003)"
2018,Diciembre,Guatemala,320,41,63,104,"(3.541112,-76.384584)"
2016,Febrero,Polonia,616,10,16,26,"(6.171601,-75.427454)"
2015,Enero,Finlandia,246,2,6,8,"(0.814836,-77.662532)"
2019,Abril,Chile,152,11,22,33,"(10.886611,-74.776708)"
2014,Junio,Hungría,348,0,1,1,"(3.541112,-76.384584)"
2014,Enero,Guatemala,320,26,69,95,"(6.171601,-75.427454)"
2017,Abril,Federación de Rusia,643,0,1,1,"(11.528919,-72.919681)"
2014,Septiembre,Bermudas/Territorio Británico de Ultramar,60,0,1,1,"(6.171601,-75.427454)"
2016,Junio,El Salvador,222,0,1,1,"(4.815061,-75.736532)"
2019,Abril,México,484,0,1,1,"(8.36068,-72.409396)"
2017,Abril,República de Armenia,51,1,1,2,"(4.697144,-74.140516)"
2018,Agosto,República de Irlanda,372,21,55,76,"(6.171601,-75.427454)"
2013,Diciembre,Turquía,792,0,1,1,"(10.886611,-74.776708)"
2022,Octubre,Bulgaria,100,0,1,1,"(3.893038,-77.067921)"
2022,Enero,Dinamarca,208,0,6,6,"(10.408582,-75.538003)"
2015,Junio,Nueva Zelanda,554,3,15,18,"(6.171601,-75.427454)"
2021,Febrero,Bahamas,44,1,2,3,"(10.445761,-75.516429)"
2018,Diciembre,Estonia,233,0,1,1,"(10.408582,-75.538003)"
2021,Agosto,Singapur,702,1,1,2,"(10.886611,-74.776708)"
2017,Abril,Islas Caimán/Territorio Británico de Ultramar,136,3,9,12,"(12.586067,-81.702563)"
2022,Enero,Alemania,276,1,1,2,"(4.452882,-75.766298)"
2012,Abril,Haití,332,4,17,21,"(4.697144,-74.140516)"
2017,Febrero,Alemania,276,5,2,7,"(12.586067,-81.702563)"
2014,Enero,Costa Rica,188,3,2,5,"(0.814836,-77.662532)"
2013,Septiembre,Rumania,642,1,0,1,"(4.815061,-75.736532)"
2022,Mayo,Jamaica,388,12,25,37,"(6.171601,-75.427454)"
2022,Junio,Suiza,756,25,43,68,"(10.445761,-75.516429)"
2013,Septiembre,Australia,36,0,2,2,"(4.815061,-75.736532)"
2015,Diciembre,Trinidad y Tobago,780,16,47,63,"(4.697144,-74.140516)"
2015,Mayo,Hungría,348,0,1,1,"(3.541112,-76.384584)"
2022,Abril,Tailandia,764,2,0,2,"(10.886611,-74.776708)"
2017,Abril,Taiwán,158,1,1,2,"(0.814836,-77.662532)"
2015,Febrero,Malasia,458,0,1,1,"(10.445761,-75.516429)"
2021,Abril,Paraguay,600,0,44,44,"(7.128456,-73.183637)"
2018,Mayo,Argentina,32,0,3,3,"(8.36068,-72.409396)"
2014,Marzo,Indonesia,360,0,2,2,"(10.408582,-75.538003)"
2013,Enero,Alemania,276,9,24,33,"(7.818934,-72.453226)"
2015,Junio,Bulgaria,100,1,2,3,"(10.445761,-75.516429)"
2012,Febrero,Australia,36,23,33,56,"(10.445761,-75.516429)"
2017,Julio,Costa Rica,188,1431,1586,3017,"(4.697144,-74.140516)"
2012,Julio,Canadá,124,0,1,1,"(11.247723,-74.213989)"
2019,Noviembre,Letonia,428,12,19,31,"(4.697144,-74.140516)"
2015,Mayo,Venezuela,862,5,10,15,"(10.408582,-75.538003)"
2014,Octubre,Eslovenia,705,0,1,1,"(10.408582,-75.538003)"
2019,Febrero,Ghana,288,0,1,1,"(6.171601,-75.427454)"
2022,Octubre,El Salvador,222,164,164,328,"(10.445761,-75.516429)"
2012,Octubre,Filipinas,608,0,12,12,"(3.541112,-76.384584)"
2017,Mayo,Suecia,752,2,2,4,"(11.247723,-74.213989)"
2017,Enero,Estados Unidos de América,840,85,135,220,"(0.814836,-77.662532)"
2013,Enero,Ecuador,218,905,1563,2468,"(0.814836,-77.662532)"
2013,Junio,Guatemala,320,3,12,15,"(10.886611,-74.776708)"
2015,Diciembre,Granada,308,0,1,1,"(7.927209,-72.507910)"
2019,Enero,Países Bajos,528,5,7,12,"(11.247723,-74.213989)"
2013,Noviembre,Portugal,620,0,1,1,"(12.586067,-81.702563)"
2015,Mayo,Portugal,620,2,2,4,"(10.408582,-75.538003)"
2019,Septiembre,Argentina,32,220,158,378,"(10.408582,-75.538003)"
2021,Mayo,Estados Unidos de América,840,0,2,2,"(-4.197703,-69.941278)"
2014,Agosto,Jamaica,388,2,0,2,"(10.886611,-74.776708)"
2017,Mayo,Honduras,340,0,2,2,"(11.360009,-72.129330)"
2012,Febrero,India,356,0,26,26,"(6.171601,-75.427454)"
2014,Diciembre,Azerbaiyán,31,2,2,4,"(4.697144,-74.140516)"
2020,Enero,Guatemala,320,1,1,2,"(7.128456,-73.183637)"
2019,Diciembre,Países Bajos,528,4,14,18,"(11.360009,-72.129330)"
2018,Enero,Perú,604,21,18,39,"(-4.197703,-69.941278)"
2018,Enero,Croacia,191,12,16,28,"(10.445761,-75.516429)"
2019,Julio,Malawi,454,0,1,1,"(6.171601,-75.427454)"
2017,Julio,Nicaragua,558,72,134,206,"(4.697144,-74.140516)"
2019,Diciembre,Bolivia,68,1,0,1,"(-4.223468,-69.945098)"
2016,Febrero,Estados Unidos de América,840,6,12,18,"(7.927209,-72.507910)"
2017,Agosto,España,724,1,2,3,"(-4.223468,-69.945098)"
2016,Octubre,Bélgica,56,0,1,1,"(4.815061,-75.736532)"
2017,Abril,Austria,40,1,1,2,"(0.25129,-76.875963)"
2023,Enero,Bolivia,68,23,17,40,"(12.586067,-81.702563)"
2017,Enero,Reino Unido de Gran Bretaña e Irlanda del Norte,826,1170,2193,3363,"(4.697144,-74.140516)"
2016,Enero,Jamaica,388,1,0,1,"(12.586067,-81.702563)"
2014,Septiembre,Reino Unido de Gran Bretaña e Irlanda del Norte,826,4,11,15,"(10.886611,-74.776708)"
2023,Enero,China,156,1,2,3,"(-4.197703,-69.941278)"
2014,Enero,Chad,148,0,1,1,"(4.697144,-74.140516)"
2022,Septiembre,Paraguay,600,278,206,484,"(4.697144,-74.140516)"
2012,Octubre,Honduras,340,0,2,2,"(7.128456,-73.183637)"
2015,Noviembre,Bosnia y Herzegovina,70,1,3,4,"(4.697144,-74.140516)"
2015,Abril,Turquía,792,1,5,6,"(6.171601,-75.427454)"
2017,Noviembre,República de Irlanda,372,6,4,10,"(8.635765,-77.346578)"
2017,Febrero,Israel,376,10,53,63,"(10.445761,-75.516429)"
2014,Abril,El Salvador,222,16,27,43,"(10.445761,-75.516429)"
2022,Abril,Antigua y Barbuda,28,1,1,2,"(10.886611,-74.776708)"
2018,Noviembre,Barbados,52,1,0,1,"(3.541112,-76.384584)"
2023,Enero,Bélgica,56,1,3,4,"(4.815061,-75.736532)"
2016,Octubre,Guatemala,320,3,10,13,"(7.128456,-73.183637)"
2020,Enero,Bélgica,56,0,2,2,"(7.818934,-72.453226)"
2012,Abril,Países Bajos,528,31,60,91,"(6.171601,-75.427454)"
2012,Agosto,Islandia,352,0,1,1,"(10.408582,-75.538003)"
2018,Noviembre,México,484,42,71,113,"(10.886611,-74.776708)"
2013,Mayo,Japón,392,0,2,2,"(8.635765,-77.346578)"
2020,Marzo,Panamá,591,558,569,1127,"(6.171601,-75.427454)"
2018,Marzo,Bélgica,56,0,1,1,"(11.360009,-72.129330)"
2021,Diciembre,Hungría,348,1,3,4,"(10.886611,-74.776708)"
2018,Octubre,República Dominicana,214,0,3,3,"(4.815061,-75.736532)"
2012,Mayo,Portugal,620,63,303,366,"(4.697144,-74.140516)"
2017,Enero,Argelia,12,0,1,1,"(6.171601,-75.427454)"
2018,Enero,Ucrania,804,2,2,4,"(0.814836,-77.662532)"
2014,Diciembre,República Del Congo,178,0,1,1,"(4.697144,-74.140516)"
2012,Febrero,Bahamas,44,1,4,5,"(10.445761,-75.516429)"
2019,Noviembre,Ecuador,218,615,583,1198,"(3.541112,-76.384584)"
2023,Mayo,Antigua y Barbuda,28,2,6,8,"(4.697144,-74.140516)"
2012,Febrero,Isla de Man,833,13,34,47,"(0.814836,-77.662532)"
2017,Octubre,España,724,5,4,9,"(11.360009,-72.129330)"
2014,Enero,Santa Sede/Ciudad del Vaticano,336,0,2,2,"(4.697144,-74.140516)"
2015,Septiembre,Tanzania,834,2,0,2,"(4.697144,-74.140516)"
2012,Julio,Suiza,756,3,3,6,"(4.815061,-75.736532)"
2021,Diciembre,Suiza,756,0,2,2,"(7.128456,-73.183637)"
2022,Junio,Suecia,752,6,3,9,"(10.886611,-74.776708)"
2016,Junio,Panamá,591,1,6,7,"(10.408582,-75.538003)"
2016,Julio,Venezuela,862,18,22,40,"(8.36068,-72.409396)"
2012,Agosto,República Checa,203,1,0,1,"(7.128456,-73.183637)"
2014,Julio,Alemania,276,1,5,6,"(4.815061,-75.736532)"
2018,Junio,Honduras,340,2,6,8,"(0.814836,-77.662532)"
2022,Marzo,República de Moldavia,498,3,3,6,"(4.697144,-74.140516)"
2023,Febrero,Nicaragua,558,97,86,183,"(4.697144,-74.140516)"
2020,Febrero,República de Tayikistán,762,1,0,1,"(4.697144,-74.140516)"
2016,Abril,Argentina,32,260,163,423,"(12.586067,-81.702563)"
2017,Junio,República de Corea,410,1,0,1,"(4.452882,-75.766298)"
2015,Mayo,Taiwán,158,1,0,1,"(-4.197703,-69.941278)"
2020,Septiembre,Noruega,578,0,1,1,"(3.541112,-76.384584)"
2013,Febrero,Bélgica,56,1,4,5,"(7.818934,-72.453226)"
2013,Septiembre,Cuba,192,0,1,1,"(11.360009,-72.129330)"
2018,Marzo,Polonia,616,2,0,2,"(4.815061,-75.736532)"
2022,Diciembre,Países Bajos,528,1,2,3,"(0.25129,-76.875963)"
2013,Marzo,Lesoto,426,0,2,2,"(4.697144,-74.140516)"
2012,Enero,Estados Unidos de América,840,4,6,10,"(13.3387613,-81.372937)"
2018,Junio,Reino Unido de Gran Bretaña e Irlanda del Norte,826,123,225,348,"(6.171601,-75.427454)"
2020,Febrero,República de Corea,410,28,38,66,"(6.171601,-75.427454)"
2022,Abril,Eslovenia,705,0,1,1,"(3.541112,-76.384584)"
2013,Marzo,Desconocido,99999,0,1,1,"(4.697144,-74.140516)"
2019,Enero,Liechtenstein,438,0,1,1,"(10.445761,-75.516429)"
2018,Junio,Suecia,752,4,4,8,"(10.408582,-75.538003)"
2012,Diciembre,Alemania,276,1412,2176,3588,"(4.697144,-74.140516)"
2023,Enero,Ecuador,218,0,8,8,"(3.893038,-77.067921)"
2016,Julio,Honduras,340,1,2,3,"(4.815061,-75.736532)"
2017,Diciembre,Argentina,32,0,1,1,"(4.452882,-75.766298)"
2013,Julio,España,724,0,1,1,"(7.088729,-70.740253)"
2012,Febrero,Grecia,300,0,4,4,"(6.171601,-75.427454)"
2014,Junio,Bolivia,68,7,15,22,"(3.541112,-76.384584)"
2016,Agosto,Reino Unido de Gran Bretaña e Irlanda del Norte,826,30,25,55,"(8.635765,-77.346578)"
2019,Julio,Malasia,458,1,0,1,"(0.814836,-77.662532)"
2018,Agosto,Ecuador,218,0,3,3,"(7.088729,-70.740253)"
2012,Agosto,Argentina,32,20,41,61,"(11.360009,-72.129330)"
2016,Noviembre,Surinam,740,2,12,14,"(6.171601,-75.427454)"
2022,Diciembre,República de Corea,410,1,1,2,"(11.117806,-74.232622)"
2012,Abril,Bolivia,68,32,74,106,"(10.445761,-75.516429)"
2021,Noviembre,Chile,152,2935,3349,6284,"(4.697144,-74.140516)"
2012,Junio,Bélgica,56,159,293,452,"(4.697144,-74.140516)"
2018,Junio,Reino Unido de Gran Bretaña e Irlanda del Norte,826,79,116,195,"(0.814836,-77.662532)"
2016,Junio,Francia,250,1,0,1,"(4.452882,-75.766298)"
2013,Marzo,Jamaica,388,16,19,35,"(4.697144,-74.140516)"
2012,Octubre,Reino Unido de Gran Bretaña e Irlanda del Norte,826,196,581,777,"(4.697144,-74.140516)"
2018,Enero,Suiza,756,66,114,180,"(6.171601,-75.427454)"
2018,Agosto,Canadá,124,181,242,423,"(10.445761,-75.516429)"
2016,Febrero,Islandia,352,0,1,1,"(8.635765,-77.346578)"
2013,Noviembre,Costa Rica,188,1,1,2,"(7.128456,-73.183637)"
2019,Noviembre,República Checa,203,0,4,4,"(0.814836,-77.662532)"
2016,Marzo,Reino Unido de Gran Bretaña e Irlanda del Norte,826,208,224,432,"(10.445761,-75.516429)"
2021,Enero,Bolivia,68,0,2,2,"(4.815061,-75.736532)"
2019,Agosto,Cuba,192,0,1,1,"(7.088729,-70.740253)"
2012,Abril,República Dominicana,214,0,3,3,"(4.815061,-75.736532)"
2022,Octubre,Malasia,458,1,0,1,"(10.445761,-75.516429)"
2013,Septiembre,Cuba,192,1,0,1,"(12.586067,-81.702563)"
2018,Junio,Italia,380,17,24,41,"(0.814836,-77.662532)"
2014,Septiembre,Reino Unido de Gran Bretaña e Irlanda del Norte,826,19,32,51,"(10.408582,-75.538003)"
2017,Febrero,Bolivia,68,4,4,8,"(-4.197703,-69.941278)"
2019,Octubre,Taiwán,158,58,61,119,"(4.697144,-74.140516)"
2017,Noviembre,Países Bajos,528,0,4,4,"(7.818934,-72.453226)"
2019,Agosto,Australia,36,313,539,852,"(4.697144,-74.140516)"
2012,Noviembre,Polonia,616,13,2,15,"(-4.197703,-69.941278)"
2021,Agosto,Filipinas,608,0,45,45,"(11.247723,-74.213989)"
2022,Noviembre,Egipto,818,0,3,3,"(10.445761,-75.516429)"
2017,Junio,Japón,392,0,2,2,"(7.818934,-72.453226)"
2022,Enero,Uruguay,858,20,35,55,"(6.171601,-75.427454)"
2019,Febrero,Desconocido,99999,78,126,204,"(4.697144,-74.140516)"
2017,Junio,Alemania,276,0,1,1,"(9.402978,-75.681599)"
2016,Diciembre,Bolivia,68,31,22,53,"(0.814836,-77.662532)"
2015,Junio,Venezuela,862,2,1,3,"(4.452882,-75.766298)"
2018,Julio,Costa Rica,188,1688,1876,3564,"(4.697144,-74.140516)"
2020,Abril,Países Bajos,528,5,27,32,"(4.697144,-74.140516)"
2016,Noviembre,Nueva Zelanda,554,1,7,8,"(10.408582,-75.538003)"
2018,Noviembre,El Salvador,222,1,0,1,"(11.360009,-72.129330)"
2020,Noviembre,Nepal,524,0,2,2,"(4.697144,-74.140516)"
2012,Noviembre,Uruguay,858,120,277,397,"(4.697144,-74.140516)"
2019,Mayo,Tanzania,834,3,4,7,"(4.697144,-74.140516)"
2013,Noviembre,Trinidad y Tobago,780,0,1,1,"(7.927209,-72.507910)"
2021,Septiembre,Hungría,348,5,3,8,"(6.171601,-75.427454)"
2017,Agosto,Lituania,440,2,3,5,"(10.445761,-75.516429)"
2013,Enero,Reino Unido de Gran Bretaña e Irlanda del Norte,826,0,1,1,"(12.5744111,-81.703935)"
2014,Marzo,Burundi,108,0,1,1,"(3.541112,-76.384584)"
2021,Febrero,Estados Unidos de América,840,1,2,3,"(12.586067,-81.702563)"
2023,Mayo,Iraq,368,1,0,1,"(10.445761,-75.516429)"
2020,Mayo,Francia,250,8,10,18,"(4.697144,-74.140516)"
2018,Abril,Canadá,124,225,547,772,"(6.171601,-75.427454)"
2012,Julio,Chile,152,0,1,1,"(4.452882,-75.766298)"
2013,Abril,Alemania,276,45,47,92,"(0.814836,-77.662532)"
2021,Noviembre,Honduras,340,112,102,214,"(6.171601,-75.427454)"
2020,Enero,Santa Lucia,662,2,0,2,"(4.697144,-74.140516)"
2017,Febrero,San Marino,674,0,1,1,"(10.445761,-75.516429)"
2013,Julio,Reino Unido de Gran Bretaña e Irlanda del Norte,826,0,1,1,"(10.886611,-74.776708)"
2022,Abril,Italia,380,91,195,287,"(10.445761,-75.516429)"
2015,Diciembre,Perú,604,0,2,2,"(4.452882,-75.766298)"
2012,Septiembre,Brasil,76,0,1,1,"(11.247723,-74.213989)"
2016,Noviembre,Angola,24,1,2,3,"(4.697144,-74.140516)"
2016,Mayo,Zambia,894,1,3,4,"(4.697144,-74.140516)"
2018,Marzo,Chad,148,0,1,1,"(6.171601,-75.427454)"
2018,Diciembre,Francia,250,0,1,1,"(4.452882,-75.766298)"
2023,Febrero,Polonia,616,2,5,7,"(-4.223468,-69.945098)"
2021,Octubre,Costa Rica,188,0,2,2,"(7.927209,-72.507910)"
2015,Junio,Costa Rica,188,18,20,38,"(10.886611,-74.776708)"
2018,Febrero,República de Corea,410,3,0,3,"(-4.223468,-69.945098)"
2022,Agosto,Chipre,196,12,16,28,"(4.697144,-74.140516)"
2013,Mayo,Panamá,591,115,233,348,"(6.171601,-75.427454)"
2015,Septiembre,Kazajistán,398,1,0,1,"(10.445761,-75.516429)"
2012,Abril,Cuba,192,87,157,244,"(4.697144,-74.140516)"
2018,Abril,Sierra Leona,694,0,1,1,"(4.697144,-74.140516)"
2017,Enero,Panamá,591,434,443,877,"(10.445761,-75.516429)"
2013,Febrero,Francia,250,41,87,128,"(6.171601,-75.427454)"
2014,Junio,España,724,1,4,5,"(-4.197703,-69.941278)"
2012,Octubre,Cuba,192,98,175,273,"(4.697144,-74.140516)"
2018,Abril,China,156,2,1,3,"(-4.197703,-69.941278)"
2023,Enero,Perú,604,0,1,1,"(3.893038,-77.067921)"
2023,Abril,China,156,48,78,126,"(6.171601,-75.427454)"
2019,Octubre,Austria,40,2,3,5,"(-4.223468,-69.945098)"
2013,Agosto,República de Corea,410,7,16,23,"(0.814836,-77.662532)"
2014,Octubre,Japón,392,5,13,18,"(3.541112,-76.384584)"
2014,Abril,Uganda,800,8,9,17,"(4.697144,-74.140516)"
2012,Diciembre,Surinam,740,0,1,1,"(6.171601,-75.427454)"
2016,Marzo,Bangladesh,50,0,1,1,"(10.445761,-75.516429)"
2015,Septiembre,Austria,40,1,0,1,"(0.25129,-76.875963)"
2022,Abril,Kenia,404,0,1,1,"(0.25129,-76.875963)"
2021,Agosto,Dinamarca,208,2,12,14,"(6.171601,-75.427454)"
2013,Febrero,República de Irlanda,372,1,1,2,"(11.360009,-72.129330)"
2018,Julio,Argentina,32,8,11,19,"(0.25129,-76.875963)"
2019,Noviembre,Cuba,192,15,27,42,"(10.445761,-75.516429)"
2017,Noviembre,Suecia,752,0,2,2,"(12.586067,-81.702563)"
2023,Febrero,Desconocido,99999,0,1,1,"(8.364293,-72.405710)"
2016,Enero,Eslovaquia,703,23,37,60,"(4.697144,-74.140516)"
2022,Julio,Trinidad y Tobago,780,25,36,61,"(6.171601,-75.427454)"
2015,Mayo,Reino Unido de Gran Bretaña e Irlanda del Norte,826,39,76,115,"(10.445761,-75.516429)"
2023,Enero,México,484,1,5,6,"(-4.223468,-69.945098)"
2019,Febrero,Santa Lucia,662,1,0,1,"(10.445761,-75.516429)"
2016,Marzo,Australia,36,52,88,140,"(6.171601,-75.427454)"
2015,Noviembre,Japón,392,0,5,5,"(7.818934,-72.453226)"
2018,Abril,Francia,250,2,5,7,"(7.818934,-72.453226)"
2013,Diciembre,Estados Unidos de América,840,2347,4330,6677,"(6.171601,-75.427454)"
2020,Enero,Grecia,300,1,4,5,"(10.886611,-74.776708)"
2017,Diciembre,República Dominicana,214,11,38,49,"(10.886611,-74.776708)"
2019,Julio,Sudáfrica,710,3,7,10,"(10.408582,-75.538003)"
2022,Marzo,Antigua y Barbuda,28,2,3,5,"(4.697144,-74.140516)"
2020,Marzo,Cabo Verde,132,1,0,1,"(4.697144,-74.140516)"
2018,Febrero,Bulgaria,100,0,1,1,"(11.247723,-74.213989)"
2017,Septiembre,Grecia,300,0,13,13,"(10.445761,-75.516429)"
2015,Diciembre,Australia,36,12,27,39,"(8.635765,-77.346578)"
2017,Noviembre,Panamá,591,696,596,1292,"(10.445761,-75.516429)"
2016,Febrero,Chile,152,503,345,848,"(10.445761,-75.516429)"
2019,Octubre,Alemania,276,0,2,2,"(7.128456,-73.183637)"
2023,Junio,Canadá,124,0,2,2,"(4.452882,-75.766298)"
2019,Agosto,Uruguay,858,275,500,775,"(4.697144,-74.140516)"
2016,Abril,Finlandia,246,3,4,7,"(10.445761,-75.516429)"
2020,Febrero,Surinam,740,0,1,1,"(3.541112,-76.384584)"
2014,Agosto,Argentina,32,85,129,214,"(0.814836,-77.662532)"
2017,Enero,Haití,332,1,0,1,"(10.886611,-74.776708)"
2013,Septiembre,Senegal,686,0,1,1,"(3.541112,-76.384584)"
2022,Octubre,Cuba,192,1,6,7,"(10.886611,-74.776708)"
2021,Noviembre,Turquía,792,0,1,1,"(10.408582,-75.538003)"
2021,Octubre,Croacia,191,0,1,1,"(10.886611,-74.776708)"
2015,Mayo,Portugal,620,0,3,3,"(10.886611,-74.776708)"
2023,Marzo,Lituania,440,16,7,23,"(6.171601,-75.427454)"
2022,Marzo,Alemania,276,14,12,26,"(8.635765,-77.346578)"
2017,Diciembre,Nicaragua,558,2,1,3,"(12.586067,-81.702563)"
2016,Marzo,Brasil,76,5,8,13,"(-4.223468,-69.945098)"
2022,Diciembre,Japón,392,1,2,3,"(12.586067,-81.702563)"
2018,Noviembre,Costa Rica,188,54,63,117,"(3.541112,-76.384584)"
2017,Diciembre,India,356,0,1,1,"(10.971302,-74.765397)"
2017,Octubre,Rumania,642,0,1,1,"(11.247723,-74.213989)"
2016,Septiembre,Eslovenia,705,11,21,32,"(4.697144,-74.140516)"
2020,Febrero,Alemania,276,0,1,1,"(4.452882,-75.766298)"
2021,Noviembre,Belice,84,0,1,1,"(10.886611,-74.776708)"
2018,Octubre,España,724,1,2,3,"(7.128456,-73.183637)"
2018,Diciembre,Venezuela,862,338,336,674,"(3.541112,-76.384584)"
2022,Julio,India,356,0,44,44,"(10.408582,-75.538003)"
2018,Agosto,Estonia,233,1,0,1,"(8.635765,-77.346578)"
2012,Junio,Brasil,76,55,63,118,"(-4.197703,-69.941278)"
2016,Enero,México,484,0,1,1,"(3.893038,-77.067921)"
2021,Septiembre,Chile,152,8,11,19,"(7.818934,-72.453226)"
2012,Agosto,Grecia,300,0,2,2,"(9.402978,-75.681599)"
2015,Octubre,Suecia,752,1,2,3,"(10.886611,-74.776708)"
2018,Diciembre,Luxemburgo,442,2,2,4,"(10.445761,-75.516429)"
2022,Enero,Venezuela,862,29,28,57,"(7.128456,-73.183637)"
2019,Mayo,México,484,16,15,31,"(10.408582,-75.538003)"
2016,Marzo,Argentina,32,0,2,2,"(4.452882,-75.766298)"
2022,Abril,Venezuela,862,134,125,259,"(7.088729,-70.740253)"
2022,Diciembre,República de Belarús,112,1,0,1,"(8.635765,-77.346578)"
2016,Enero,Estados Unidos de América,840,0,1,1,"(11.117806,-74.232622)"
2021,Enero,Canadá,124,60,175,235,"(6.171601,-75.427454)"
2020,Julio,Federación de Rusia,643,22,37,59,"(4.697144,-74.140516)"
2017,Julio,Países Bajos,528,2651,3015,5666,"(4.697144,-74.140516)"
2021,Septiembre,Austria,40,0,1,1,"(10.886611,-74.776708)"
2016,Diciembre,República Del Congo,178,0,1,1,"(4.697144,-74.140516)"
2013,Diciembre,República de Corea,410,3,9,12,"(3.541112,-76.384584)"
2014,Julio,Israel,376,33,91,124,"(0.814836,-77.662532)"
2015,Abril,Estonia,233,7,17,24,"(4.697144,-74.140516)"
2022,Octubre,Guatemala,320,15,17,32,"(10.886611,-74.776708)"
2016,Junio,Paraguay,600,72,34,106,"(10.445761,-75.516429)"
2018,Julio,Ecuador,218,68,212,280,"(0.25129,-76.875963)"
2019,Junio,Belice,84,12,16,28,"(4.697144,-74.140516)"
2019,Mayo,Honduras,340,0,1,1,"(7.818934,-72.453226)"
2018,Diciembre,Japón,392,1,2,3,"(-4.223468,-69.945098)"
2019,Diciembre,Malí,466,0,2,2,"(4.697144,-74.140516)"
2021,Enero,Suiza,756,2,9,11,"(3.541112,-76.384584)"
2018,Diciembre,Argelia,12,0,1,1,"(10.445761,-75.516429)"
2013,Marzo,Lituania,440,0,1,1,"(7.818934,-72.453226)"
2014,Marzo,Uruguay,858,8,3,11,"(10.408582,-75.538003)"
2019,Marzo,Francia,250,232,367,599,"(10.445761,-75.516429)"
2022,Mayo,Reino Unido de Gran Bretaña e Irlanda del Norte,826,18,55,73,"(0.814836,-77.662532)"
2016,Febrero,Suecia,752,5,5,10,"(8.635765,-77.346578)"
2023,Febrero,Honduras,340,0,42,42,"(12.5744111,-81.703935)"
2022,Enero,Noruega,578,1,2,3,"(10.408582,-75.538003)"
2022,Agosto,India,356,5,1,6,"(0.814836,-77.662532)"
2020,Febrero,Honduras,340,8,12,20,"(10.886611,-74.776708)"
2019,Febrero,Países Bajos,528,1675,2245,3920,"(4.697144,-74.140516)"
2013,Abril,Reino Unido de Gran Bretaña e Irlanda del Norte,826,5,6,11,"(-4.197703,-69.941278)"
2018,Junio,Ucrania,804,1,0,1,"(-4.197703,-69.941278)"
2018,Marzo,Honduras,340,66,40,106,"(3.541112,-76.384584)"
2012,Mayo,China,156,3,6,9,"(3.541112,-76.384584)"
2016,Mayo,Países Bajos,528,6,8,14,"(8.635765,-77.346578)"
2020,Diciembre,Líbano,422,3,20,23,"(4.697144,-74.140516)"
2014,Abril,Venezuela,862,0,1,1,"(11.247723,-74.213989)"
2014,Abril,Bulgaria,100,0,1,1,"(10.886611,-74.776708)"
2014,Marzo,Islandia,352,0,1,1,"(6.171601,-75.427454)"
2014,Octubre,Nicaragua,558,0,1,1,"(4.452882,-75.766298)"
2014,Agosto,Estados Unidos de América,840,0,2,2,"(6.185799,-67.483929)"
2012,Mayo,Taiwán,158,1,0,1,"(-4.197703,-69.941278)"
2022,Abril,República Dominicana,214,0,1,1,"(11.360009,-72.129330)"
2017,Enero,Perú,604,421,644,1065,"(6.171601,-75.427454)"
2021,Agosto,Argentina,32,52,126,178,"(6.171601,-75.427454)"
2015,Marzo,Argentina,32,4,31,35,"(10.886611,-74.776708)"
2015,Septiembre,San  Vicente y las Granadinas,670,0,3,3,"(4.697144,-74.140516)"
2016,Octubre,Albania,8,4,7,11,"(4.697144,-74.140516)"
2021,Julio,República de Moldavia,498,3,2,5,"(4.697144,-74.140516)"
2012,Enero,República de Irlanda,372,2,4,6,"(-4.197703,-69.941278)"
2020,Septiembre,China,156,1,3,4,"(4.697144,-74.140516)"
2021,Febrero,México,484,1,4,5,"(7.128456,-73.183637)"
2012,Enero,Bolivia,68,4,3,7,"(10.408582,-75.538003)"
2016,Junio,Alemania,276,17,26,43,"(10.886611,-74.776708)"
2015,Enero,Jamaica,388,1,0,1,"(7.818934,-72.453226)"
2018,Octubre,Ucrania,804,1,3,4,"(6.171601,-75.427454)"
2017,Diciembre,Surinam,740,3,12,15,"(4.697144,-74.140516)"
2018,Abril,Ecuador,218,0,1,1,"(6.185799,-67.483929)"
2015,Abril,Alemania,276,7,11,18,"(12.586067,-81.702563)"
2015,Julio,Israel,376,38,90,128,"(0.814836,-77.662532)"
2022,Octubre,Uruguay,858,0,1,1,"(10.408582,-75.538003)"
2016,Enero,Japón,392,4,3,7,"(-4.197703,-69.941278)"
2012,Agosto,Reino Unido de Gran Bretaña e Irlanda del Norte,826,19,31,50,"(10.445761,-75.516429)"
2013,Agosto,Alemania,276,35,55,90,"(10.445761,-75.516429)"
2014,Enero,Alemania,276,7,6,13,"(12.586067,-81.702563)"
2015,Marzo,Desconocido,99999,0,2,2,"(6.171601,-75.427454)"
2022,Febrero,Surinam,740,3,6,9,"(4.697144,-74.140516)"
2021,Agosto,Ucrania,804,0,19,19,"(10.971302,-74.765397)"
2012,Enero,Bulgaria,100,6,8,14,"(4.697144,-74.140516)"
2017,Febrero,Libia,434,0,1,1,"(0.814836,-77.662532)"
2013,Noviembre,Perú,604,61,49,110,"(12.586067,-81.702563)"
2019,Marzo,Israel,376,18,48,66,"(3.541112,-76.384584)"
2016,Agosto,Bélgica,56,6,10,16,"(10.445761,-75.516429)"
2016,Abril,República Dominicana,214,0,4,4,"(10.408582,-75.538003)"
2022,Agosto,Panamá,591,77,119,196,"(4.815061,-75.736532)"
2017,Mayo,Perú,604,0,2,2,"(12.5744111,-81.703935)"
2022,Marzo,República de Corea,410,96,201,297,"(4.697144,-74.140516)"
2021,Noviembre,Países Bajos,528,0,1,1,"(8.36068,-72.409396)"
2022,Noviembre,Kazajistán,398,25,35,60,"(4.697144,-74.140516)"
2019,Enero,Santa Lucia,662,1,1,2,"(10.445761,-75.516429)"
2012,Marzo,Argentina,32,1,0,1,"(4.452882,-75.766298)"
2018,Octubre,Ecuador,218,54,97,151,"(6.171601,-75.427454)"
2014,Marzo,República Árabe Siria,760,0,3,3,"(4.697144,-74.140516)"
2021,Diciembre,Chile,152,11,2,13,"(7.916725,-72.462544)"
2017,Octubre,Perú,604,0,2,2,"(8.635765,-77.346578)"
2019,Octubre,Reino Unido de Gran Bretaña e Irlanda del Norte,826,94,270,364,"(6.171601,-75.427454)"
2013,Agosto,Nueva Zelanda,554,8,12,20,"(10.408582,-75.538003)"
2016,Septiembre,Serbia,688,1,0,1,"(6.171601,-75.427454)"
2019,Agosto,Chile,152,29,66,95,"(0.814836,-77.662532)"
2016,Marzo,Panamá,591,1139,1170,2309,"(6.171601,-75.427454)"
2014,Mayo,Suecia,752,0,2,2,"(8.635765,-77.346578)"
2022,Enero,China,156,1,0,1,"(7.128456,-73.183637)"
2017,Febrero,Alemania,276,0,1,1,"(8.36068,-72.409396)"
2023,Mayo,Sri Lanka,144,0,4,4,"(4.697144,-74.140516)"
2016,Junio,Australia,36,20,24,44,"(8.635765,-77.346578)"
2017,Julio,Guatemala,320,3,1,4,"(12.586067,-81.702563)"
2022,Diciembre,Estonia,233,16,26,42,"(4.697144,-74.140516)"
2018,Mayo,México,484,1,10,11,"(7.128456,-73.183637)"
2018,Julio,República Dominicana,214,33,44,77,"(3.541112,-76.384584)"
2019,Febrero,Nueva Zelanda,554,2,0,2,"(0.25129,-76.875963)"
2021,Mayo,Perú,604,0,1,1,"(1.813928,-78.763924)"
2012,Noviembre,Taiwán,158,1,0,1,"(4.452882,-75.766298)"
2012,Marzo,Bélgica,56,0,1,1,"(7.927209,-72.507910)"
2021,Septiembre,Bolivia,68,6,7,13,"(3.541112,-76.384584)"
2016,Diciembre,Líbano,422,14,31,45,"(4.697144,-74.140516)"
2020,Marzo,Marruecos,504,0,1,1,"(3.541112,-76.384584)"
2021,Septiembre,Ecuador,218,0,51,51,"(1.813928,-78.763924)"
2022,Octubre,Lituania,440,0,1,1,"(3.893038,-77.067921)"
2015,Agosto,Togo,768,0,1,1,"(4.697144,-74.140516)"
2012,Abril,España,724,170,408,578,"(4.697144,-74.140516)"
2016,Julio,Trinidad y Tobago,780,3,9,12,"(3.541112,-76.384584)"
2023,Marzo,Iraq,368,0,1,1,"(4.697144,-74.140516)"
2021,Enero,Federación de Rusia,643,4,10,14,"(10.445761,-75.516429)"
2016,Agosto,Liechtenstein,438,1,0,1,"(4.697144,-74.140516)"
2016,Diciembre,Guatemala,320,38,65,103,"(3.541112,-76.384584)"
2018,Marzo,Uruguay,858,18,21,39,"(12.586067,-81.702563)"
2021,Octubre,Honduras,340,4,1,5,"(7.128456,-73.183637)"
2013,Junio,Finlandia,246,2,2,4,"(10.886611,-74.776708)"
2018,Marzo,Bolivia,68,3,4,7,"(4.815061,-75.736532)"
2018,Marzo,Etiopia,231,0,3,3,"(6.171601,-75.427454)"
2012,Diciembre,Bolivia,68,384,454,838,"(4.697144,-74.140516)"
2012,Enero,Uruguay,858,3,1,4,"(10.408582,-75.538003)"
2023,Marzo,Venezuela,862,28,21,49,"(6.18189,-67.47535)"
2022,Junio,Perú,604,2,1,3,"(0.25129,-76.875963)"
2013,Junio,Perú,604,0,1,1,"(10.971302,-74.765397)"
2013,Abril,Líbano,422,11,21,32,"(4.697144,-74.140516)"
2016,Febrero,Croacia,191,1,0,1,"(0.814836,-77.662532)"
2012,Febrero,Francia,250,0,1,1,"(3.893038,-77.067921)"
2014,Abril,Rwanda,646,0,1,1,"(4.697144,-74.140516)"
2020,Febrero,China,156,15,11,26,"(10.445761,-75.516429)"
2013,Noviembre,San  Vicente y las Granadinas,670,0,1,1,"(6.171601,-75.427454)"
2023,Mayo,Eslovaquia,703,5,1,6,"(10.445761,-75.516429)"
2022,Julio,Alemania,276,1,0,1,"(7.916725,-72.462544)"
2022,Julio,Perú,604,161,135,296,"(-4.197703,-69.941278)"
2016,Diciembre,Austria,40,12,10,22,"(0.814836,-77.662532)"
2017,Marzo,Israel,376,5,5,10,"(12.586067,-81.702563)"
2016,Enero,Malasia,458,16,26,42,"(4.697144,-74.140516)"
2013,Mayo,Países Bajos,528,0,3,3,"(8.635765,-77.346578)"
2017,Diciembre,Brasil,76,0,3,3,"(7.088729,-70.740253)"
2014,Diciembre,Bélgica,56,169,377,546,"(4.697144,-74.140516)"
2019,Octubre,Antigua y Barbuda,28,7,8,15,"(4.697144,-74.140516)"
2017,Mayo,Montenegro,499,0,1,1,"(10.445761,-75.516429)"
2013,Julio,Australia,36,212,369,581,"(4.697144,-74.140516)"
2012,Diciembre,República Checa,203,2,3,5,"(10.408582,-75.538003)"
2023,Abril,Estados Unidos de América,840,8,16,24,"(7.818934,-72.453226)"
2019,Enero,España,724,3,10,13,"(8.36068,-72.409396)"
2022,Marzo,Alemania,276,2,6,8,"(-4.197703,-69.941278)"
2016,Octubre,Argentina,32,3538,4921,8459,"(4.697144,-74.140516)"
2021,Febrero,España,724,71,144,215,"(6.171601,-75.427454)"
2021,Noviembre,Bahamas,44,0,1,1,"(10.886611,-74.776708)"
2019,Octubre,Italia,380,7,16,23,"(0.814836,-77.662532)"
2018,Septiembre,Jordania,400,0,1,1,"(10.445761,-75.516429)"
2017,Abril,México,484,0,1,1,"(10.971302,-74.765397)"
2016,Octubre,Israel,376,1,2,3,"(4.815061,-75.736532)"
2014,Septiembre,Paraguay,600,8,11,19,"(3.541112,-76.384584)"
2023,Marzo,Costa Rica,188,1,3,4,"(7.818934,-72.453226)"
2012,Noviembre,Croacia,191,0,1,1,"(3.541112,-76.384584)"
2013,Febrero,Jamaica,388,1,4,5,"(6.171601,-75.427454)"
2019,Julio,Chile,152,2,3,5,"(11.360009,-72.129330)"
2017,Agosto,Panamá,591,2,3,5,"(8.635765,-77.346578)"
2012,Junio,Nueva Zelanda,554,4,4,8,"(10.408582,-75.538003)"
2012,Marzo,Canadá,124,14,18,32,"(10.886611,-74.776708)"
2019,Abril,Venezuela,862,5,8,13,"(-4.223468,-69.945098)"
2019,Octubre,Italia,380,4,14,18,"(10.408582,-75.538003)"
2018,Diciembre,Canadá,124,2,4,6,"(7.818934,-72.453226)"
2013,Septiembre,Estados Unidos de América,840,806,1695,2501,"(10.445761,-75.516429)"
2016,Agosto,Federación de Rusia,643,4,8,12,"(0.814836,-77.662532)"
2012,Junio,Albania,8,2,1,3,"(4.697144,-74.140516)"
2015,Agosto,Trinidad y Tobago,780,2,1,3,"(7.927209,-72.507910)"
2021,Mayo,Marruecos,504,1,0,1,"(4.815061,-75.736532)"
2016,Marzo,Perú,604,111,317,428,"(0.814836,-77.662532)"
2022,Julio,Líbano,422,19,20,39,"(4.697144,-74.140516)"
2018,Diciembre,Bulgaria,100,1,0,1,"(10.408582,-75.538003)"
2015,Marzo,Serbia,688,0,1,1,"(6.171601,-75.427454)"
2017,Enero,México,484,26,47,73,"(0.814836,-77.662532)"
2016,Mayo,Vietnam,704,1,1,2,"(10.445761,-75.516429)"
2012,Agosto,Finlandia,246,0,2,2,"(10.886611,-74.776708)"
2020,Febrero,República de Corea,410,1,2,3,"(-4.197703,-69.941278)"
2022,Agosto,Emiratos Árabes,784,1,0,1,"(10.445761,-75.516429)"
2015,Marzo,Suiza,756,16,29,45,"(3.541112,-76.384584)"
2023,Junio,Bélgica,56,3,1,4,"(7.128456,-73.183637)"
2017,Enero,Bahamas,44,1,0,1,"(4.815061,-75.736532)"
2018,Agosto,Italia,380,3,5,8,"(0.25129,-76.875963)"
2016,Abril,Panamá,591,1,0,1,"(10.433609,-73.247863)"
2013,Febrero,Perú,604,3614,3529,7143,"(4.697144,-74.140516)"
2012,Noviembre,Curazao,99999,1,1,2,"(4.697144,-74.140516)"
2016,Diciembre,Alemania,276,14,14,28,"(8.635765,-77.346578)"
2015,Junio,Portugal,620,4,3,7,"(0.814836,-77.662532)"
2017,Febrero,India,356,0,1,1,"(0.25129,-76.875963)"
2021,Septiembre,Macedonia,807,1,1,2,"(6.171601,-75.427454)"
2016,Octubre,China,156,5,11,16,"(7.818934,-72.453226)"
2019,Julio,Canadá,124,10,5,15,"(8.635765,-77.346578)"
2021,Agosto,Italia,380,14,34,48,"(3.541112,-76.384584)"
2013,Febrero,España,724,3,4,7,"(-4.197703,-69.941278)"
2018,Marzo,Egipto,818,0,3,3,"(10.445761,-75.516429)"
2015,Junio,Nueva Zelanda,554,53,80,133,"(4.697144,-74.140516)"
2018,Octubre,Jamaica,388,0,1,1,"(8.36068,-72.409396)"
2020,Enero,Perú,604,1,0,1,"(8.635765,-77.346578)"
2017,Noviembre,Paraguay,600,2,3,5,"(0.814836,-77.662532)"
2014,Junio,Líbano,422,0,2,2,"(7.128456,-73.183637)"
2015,Noviembre,Dinamarca,208,9,9,18,"(10.445761,-75.516429)"
2023,Junio,Guatemala,320,0,1,1,"(10.408582,-75.538003)"
2017,Enero,República de Irlanda,372,2,0,2,"(-4.197703,-69.941278)"
2014,Julio,Alemania,276,25,17,42,"(10.886611,-74.776708)"
2016,Diciembre,Belice,84,0,1,1,"(0.814836,-77.662532)"
2021,Mayo,Uruguay,858,6,4,10,"(10.445761,-75.516429)"
2017,Julio,Eslovaquia,703,24,32,56,"(4.697144,-74.140516)"
2016,Mayo,Reino Unido de Gran Bretaña e Irlanda del Norte,826,29,36,65,"(-4.197703,-69.941278)"
2013,Diciembre,Hungría,348,2,2,4,"(0.814836,-77.662532)"
2021,Abril,Chile,152,144,283,427,"(4.697144,-74.140516)"
2016,Noviembre,Italia,380,1,2,3,"(4.815061,-75.736532)"
2017,Noviembre,Grecia,300,0,5,5,"(6.171601,-75.427454)"
2014,Julio,Dinamarca,208,3,10,13,"(3.541112,-76.384584)"
2022,Enero,Marruecos,504,3,3,6,"(6.171601,-75.427454)"
2019,Abril,Japón,392,13,26,39,"(3.541112,-76.384584)"
2014,Septiembre,Costa Rica,188,2,6,8,"(7.818934,-72.453226)"
2020,Marzo,Nepal,524,0,1,1,"(3.541112,-76.384584)"
2014,Diciembre,Panamá,591,278,341,619,"(10.408582,-75.538003)"
2017,Abril,Rumania,642,3,6,9,"(6.171601,-75.427454)"
2020,Noviembre,Bulgaria,100,0,1,1,"(3.541112,-76.384584)"
2019,Enero,Nicaragua,558,2,1,3,"(10.886611,-74.776708)"
2012,Octubre,Hungría,348,1,1,2,"(7.818934,-72.453226)"
2014,Junio,China,156,2,2,4,"(10.886611,-74.776708)"
2020,Mayo,Israel,376,0,1,1,"(4.697144,-74.140516)"
2023,Mayo,Alemania,276,1,0,1,"(10.971302,-74.765397)"
2016,Febrero,Islandia,352,1,0,1,"(0.814836,-77.662532)"
2012,Diciembre,Ecuador,218,12,67,79,"(1.813928,-78.763924)"
2022,Julio,República Árabe Siria,760,0,1,1,"(6.171601,-75.427454)"
2014,Enero,Francia,250,4,2,6,"(4.815061,-75.736532)"
2022,Enero,Hungría,348,1,1,2,"(0.814836,-77.662532)"
2015,Agosto,Costa Rica,188,66,73,139,"(12.586067,-81.702563)"
2021,Diciembre,Rumania,642,5,3,8,"(3.541112,-76.384584)"
2017,Junio,Venezuela,862,8,4,12,"(0.25129,-76.875963)"
2017,Diciembre,Ucrania,804,2,2,4,"(3.541112,-76.384584)"
2013,Septiembre,Australia,36,5,12,17,"(10.886611,-74.776708)"
2022,Abril,China,156,1,0,1,"(7.916725,-72.462544)"
2023,Junio,Uruguay,858,7,9,16,"(10.886611,-74.776708)"
2017,Noviembre,Rumania,642,0,1,1,"(11.247723,-74.213989)"
2022,Marzo,Estados Unidos de América,840,129,186,315,"(7.128456,-73.183637)"
2017,Enero,Guatemala,320,304,632,936,"(4.697144,-74.140516)"
2018,Agosto,República de Armenia,51,2,1,3,"(4.697144,-74.140516)"
2015,Marzo,Líbano,422,1,2,3,"(3.541112,-76.384584)"
2012,Noviembre,Suecia,752,0,1,1,"(7.818934,-72.453226)"
2014,Mayo,Guatemala,320,219,474,693,"(4.697144,-74.140516)"
2013,Abril,España,724,38,127,165,"(6.171601,-75.427454)"
2012,Julio,Trinidad y Tobago,780,0,2,2,"(10.886611,-74.776708)"
2014,Marzo,Uruguay,858,32,56,88,"(6.171601,-75.427454)"
2013,Diciembre,Ecuador,218,279,390,669,"(7.818934,-72.453226)"
2013,Febrero,Francia,250,954,1769,2723,"(4.697144,-74.140516)"
2022,Marzo,México,484,2,2,4,"(4.452882,-75.766298)"
2014,Octubre,Portugal,620,0,1,1,"(0.814836,-77.662532)"
2019,Abril,Reino Unido de Gran Bretaña e Irlanda del Norte,826,61,80,141,"(0.814836,-77.662532)"
2012,Febrero,Reino Unido de Gran Bretaña e Irlanda del Norte,826,0,2,2,"(11.247723,-74.213989)"
2014,Marzo,Honduras,340,0,1,1,"(8.635765,-77.346578)"
2017,Marzo,Eslovenia,705,2,2,4,"(3.541112,-76.384584)"
2013,Mayo,Italia,380,0,2,2,"(12.586067,-81.702563)"
2012,Abril,China,156,1,1,2,"(12.586067,-81.702563)"
2022,Julio,Islas Caimán/Territorio Británico de Ultramar,136,0,2,2,"(4.697144,-74.140516)"
2016,Agosto,Suecia,752,0,1,1,"(7.818934,-72.453226)"
2014,Agosto,Dinamarca,208,1,0,1,"(10.408582,-75.538003)"
2017,Diciembre,Hungría,348,0,3,3,"(-4.197703,-69.941278)"
2020,Noviembre,Argentina,32,1,1,2,"(7.128456,-73.183637)"
2013,Octubre,Brunei Darussalam,96,0,5,5,"(4.697144,-74.140516)"
2012,Octubre,Francia,250,11,38,49,"(10.445761,-75.516429)"
2014,Septiembre,Ecuador,218,1001,1754,2755,"(0.814836,-77.662532)"
2015,Marzo,España,724,18,46,64,"(7.818934,-72.453226)"
2012,Agosto,Reino Unido de Gran Bretaña e Irlanda del Norte,826,2,7,9,"(10.971302,-74.765397)"
2016,Julio,Perú,604,639,582,1221,"(0.814836,-77.662532)"
2018,Octubre,Chile,152,595,490,1085,"(10.445761,-75.516429)"
2016,Marzo,Canadá,124,5,12,17,"(-4.197703,-69.941278)"
2020,Diciembre,Ucrania,804,0,1,1,"(3.893038,-77.067921)"
2018,Diciembre,República Dominicana,214,15,16,31,"(0.814836,-77.662532)"
2021,Diciembre,Canadá,124,0,2,2,"(11.360009,-72.129330)"
2022,Abril,Serbia,688,1,1,2,"(0.814836,-77.662532)"
2016,Octubre,Argentina,32,98,130,228,"(3.541112,-76.384584)"
2016,Julio,Belice,84,12,14,26,"(4.697144,-74.140516)"
2017,Enero,Suiza,756,0,1,1,"(8.36068,-72.409396)"
2016,Octubre,Brasil,76,685,405,1090,"(10.408582,-75.538003)"
2018,Marzo,Kenia,404,4,3,7,"(6.171601,-75.427454)"
2022,Febrero,Portugal,620,2,0,2,"(12.586067,-81.702563)"
2016,Julio,Hong Kong,344,1,1,2,"(0.814836,-77.662532)"
2013,Febrero,Reino Unido de Gran Bretaña e Irlanda del Norte,826,307,654,961,"(4.697144,-74.140516)"
2013,Mayo,Guatemala,320,0,1,1,"(10.408582,-75.538003)"
2016,Febrero,Venezuela,862,2,4,6,"(0.25129,-76.875963)"
2016,Diciembre,Chile,152,88,78,166,"(10.445761,-75.516429)"
2019,Octubre,Australia,36,4,7,11,"(0.814836,-77.662532)"
2022,Diciembre,El Salvador,222,0,3,3,"(12.5744111,-81.703935)"
2015,Julio,Filipinas,608,3,4,7,"(6.171601,-75.427454)"
2019,Mayo,Grecia,300,1,1,2,"(7.818934,-72.453226)"
2018,Julio,Alemania,276,4,10,14,"(7.818934,-72.453226)"
2022,Marzo,Ecuador,218,0,1,1,"(8.36068,-72.409396)"
2018,Enero,Suecia,752,17,20,37,"(3.541112,-76.384584)"
2022,Mayo,Honduras,340,38,36,74,"(3.541112,-76.384584)"
2019,Octubre,Bolivia,68,32,38,70,"(6.171601,-75.427454)"
2013,Junio,Ecuador,218,1,5,6,"(10.886611,-74.776708)"
2021,Enero,Portugal,620,5,5,10,"(3.541112,-76.384584)"
2013,Noviembre,Federación de Rusia,643,3,9,12,"(11.360009,-72.129330)"
2020,Diciembre,Arabia Saudita,682,1,1,2,"(10.445761,-75.516429)"
2022,Febrero,España,724,2211,3905,6117,"(4.697144,-74.140516)"
2022,Enero,Guatemala,320,7,9,16,"(4.815061,-75.736532)"
2022,Mayo,Pakistán,586,0,1,1,"(3.541112,-76.384584)"
2012,Agosto,Bahamas,44,1,0,1,"(10.886611,-74.776708)"
2018,Junio,Hungría,348,1,3,4,"(10.445761,-75.516429)"
2023,Mayo,Rumania,642,0,7,7,"(10.971302,-74.765397)"
2023,Febrero,Ucrania,804,0,35,35,"(3.893038,-77.067921)"
2019,Julio,Nueva Zelanda,554,2,4,6,"(-4.223468,-69.945098)"
2019,Julio,Venezuela,862,9,49,58,"(11.117806,-74.232622)"
2019,Septiembre,Andorra,20,3,5,8,"(4.697144,-74.140516)"
2020,Marzo,El Salvador,222,1,2,3,"(10.408582,-75.538003)"
2018,Octubre,Jamaica,388,10,31,41,"(10.445761,-75.516429)"
2017,Octubre,Somalia,706,0,2,2,"(4.697144,-74.140516)"
2015,Agosto,Italia,380,5,5,10,"(8.635765,-77.346578)"
2016,Agosto,Finlandia,246,1,0,1,"(8.635765,-77.346578)"
2014,Junio,Argentina,32,49,82,131,"(0.814836,-77.662532)"
2017,Febrero,Guyana,328,4,11,15,"(4.697144,-74.140516)"
2019,Noviembre,Honduras,340,6,5,11,"(4.815061,-75.736532)"
2014,Enero,Sudáfrica,710,23,56,79,"(4.697144,-74.140516)"
2018,Marzo,Israel,376,2,2,4,"(-4.197703,-69.941278)"
2020,Diciembre,República Checa,203,0,1,1,"(10.886611,-74.776708)"
2021,Noviembre,Kiribati,296,0,1,1,"(4.697144,-74.140516)"
2016,Diciembre,República Dominicana,214,0,6,6,"(7.818934,-72.453226)"
2014,Julio,Mongolia,496,1,0,1,"(6.171601,-75.427454)"
2019,Enero,Venezuela,862,874,870,1744,"(6.171601,-75.427454)"
2019,Enero,Montenegro,499,0,6,6,"(6.171601,-75.427454)"
2016,Julio,Bélgica,56,19,17,36,"(0.814836,-77.662532)"
2015,Julio,Hong Kong,344,1,1,2,"(6.171601,-75.427454)"
2012,Marzo,Alemania,276,5,12,17,"(8.635765,-77.346578)"
2014,Febrero,Líbano,422,0,2,2,"(3.541112,-76.384584)"
2015,Diciembre,Taiwán,158,1,1,2,"(10.886611,-74.776708)"
2012,Noviembre,Ecuador,218,282,343,625,"(3.541112,-76.384584)"
2016,Agosto,Países Bajos,528,1,0,1,"(12.586067,-81.702563)"
2014,Noviembre,Argentina,32,277,234,511,"(12.586067,-81.702563)"
2021,Junio,República de Corea,410,29,58,87,"(4.697144,-74.140516)"
2021,Agosto,Canadá,124,0,1,1,"(11.117806,-74.232622)"
2015,Diciembre,Indonesia,360,1,0,1,"(6.171601,-75.427454)"
2015,Diciembre,México,484,86,181,267,"(3.541112,-76.384584)"
2015,Abril,República Checa,203,59,63,122,"(4.697144,-74.140516)"
2015,Julio,Suecia,752,174,242,416,"(4.697144,-74.140516)"
2012,Marzo,Canadá,124,1,0,1,"(7.927209,-72.507910)"
2023,Mayo,Islas Caimán/Territorio Británico de Ultramar,136,1,1,2,"(12.5744111,-81.703935)"
2016,Noviembre,Tanzania,834,1,16,17,"(4.697144,-74.140516)"
2023,Abril,Perú,604,61,142,203,"(0.814836,-77.662532)"
2016,Enero,Bolivia,68,15,16,31,"(10.408582,-75.538003)"
2017,Agosto,México,484,5,5,10,"(11.360009,-72.129330)"
2019,Agosto,Guatemala,320,107,145,252,"(10.445761,-75.516429)"
2015,Febrero,Albania,8,0,1,1,"(3.866713,-67.927521)"
2022,Noviembre,Namibia,516,0,1,1,"(3.541112,-76.384584)"
2017,Enero,Jamaica,388,0,3,3,"(13.3387613,-81.372937)"
2015,Junio,San  Vicente y las Granadinas,670,0,1,1,"(6.171601,-75.427454)"
2020,Noviembre,Ecuador,218,21,27,48,"(3.541112,-76.384584)"
2019,Agosto,Estados Unidos de América,840,4,4,8,"(-4.223468,-69.945098)"
2018,Julio,Bahamas,44,7,5,12,"(10.445761,-75.516429)"
2020,Marzo,Bahamas,44,1,8,9,"(6.171601,-75.427454)"
2015,Octubre,Federación de Rusia,643,0,1,1,"(3.893038,-77.067921)"
2017,Noviembre,Bangladesh,50,0,2,2,"(4.697144,-74.140516)"
2019,Agosto,Rumania,642,2,0,2,"(7.818934,-72.453226)"
2023,Marzo,Singapur,702,0,1,1,"(3.893038,-77.067921)"
2012,Mayo,República Checa,203,17,31,48,"(4.697144,-74.140516)"
2019,Febrero,Singapur,702,9,26,35,"(4.697144,-74.140516)"
2016,Marzo,España,724,61,81,142,"(0.814836,-77.662532)"
2012,Julio,Suecia,752,0,2,2,"(7.818934,-72.453226)"
2016,Junio,Estados Unidos de América,840,1923,2338,4261,"(3.541112,-76.384584)"
2018,Mayo,Ecuador,218,71,63,134,"(10.445761,-75.516429)"
2019,Julio,Letonia,428,3,0,3,"(6.171601,-75.427454)"
2020,Marzo,Hungría,348,1,0,1,"(0.814836,-77.662532)"
2015,Marzo,Taiwán,158,1,0,1,"(7.818934,-72.453226)"
2020,Enero,Granada,308,2,4,6,"(4.697144,-74.140516)"
2020,Enero,Tailandia,764,0,1,1,"(0.814836,-77.662532)"
2014,Noviembre,Ecuador,218,3,125,128,"(1.813928,-78.763924)"
2012,Marzo,Nicaragua,558,2,9,11,"(3.541112,-76.384584)"
2022,Junio,Japón,392,12,22,34,"(6.171601,-75.427454)"
2012,Agosto,República de Corea,410,3,2,5,"(10.445761,-75.516429)"
2016,Enero,Indonesia,360,0,2,2,"(10.971302,-74.765397)"
2020,Febrero,Federación de Rusia,643,2,2,4,"(7.128456,-73.183637)"
2015,Octubre,República Dominicana,214,0,1,1,"(7.927209,-72.507910)"
2019,Diciembre,Federación de Rusia,643,1,1,2,"(4.815061,-75.736532)"
2017,Marzo,El Salvador,222,691,901,1592,"(4.697144,-74.140516)"
2013,Octubre,Federación de Rusia,643,0,2,2,"(10.408582,-75.538003)"
2012,Octubre,Perú,604,26,41,67,"(10.886611,-74.776708)"
2015,Mayo,Costa Rica,188,2,2,4,"(8.635765,-77.346578)"
2014,Diciembre,Noruega,578,0,2,2,"(10.886611,-74.776708)"
2018,Febrero,República Dominicana,214,55,83,138,"(10.886611,-74.776708)"
2016,Noviembre,Indonesia,360,0,1,1,"(6.171601,-75.427454)"
2023,Marzo,Guatemala,320,0,2,2,"(-4.197703,-69.941278)"
2015,Marzo,Trinidad y Tobago,780,1,2,3,"(7.128456,-73.183637)"
2018,Enero,Canadá,124,0,2,2,"(13.3387613,-81.372937)"
2021,Diciembre,Panamá,591,0,3,3,"(11.247723,-74.213989)"
2022,Julio,Finlandia,246,2,1,3,"(11.117806,-74.232622)"
2021,Junio,Marruecos,504,2,7,9,"(4.697144,-74.140516)"
2014,Noviembre,Cuba,192,7,22,29,"(10.445761,-75.516429)"
2017,Octubre,Bahamas,44,0,1,1,"(7.818934,-72.453226)"
2012,Octubre,Israel,376,0,3,3,"(10.886611,-74.776708)"
2017,Abril,Zimbabue,716,0,2,2,"(3.541112,-76.384584)"
2017,Mayo,Hungría,348,1,2,3,"(0.814836,-77.662532)"
2015,Abril,Eslovaquia,703,2,0,2,"(-4.197703,-69.941278)"
2022,Abril,Italia,380,0,3,3,"(12.5744111,-81.703935)"
2013,Diciembre,Venezuela,862,165,271,436,"(7.088729,-70.740253)"
2017,Marzo,España,724,24,38,62,"(10.408582,-75.538003)"
2016,Agosto,Turquía,792,1,0,1,"(10.886611,-74.776708)"
2014,Julio,Islas Caimán/Territorio Británico de Ultramar,136,0,3,3,"(4.697144,-74.140516)"
2017,Noviembre,Perú,604,37,47,84,"(-4.223468,-69.945098)"
2014,Mayo,Arabia Saudita,682,0,2,2,"(3.541112,-76.384584)"
2023,Febrero,Canadá,124,60,86,146,"(3.541112,-76.384584)"
2016,Noviembre,Argentina,32,114,91,205,"(10.408582,-75.538003)"
2022,Diciembre,República de Irlanda,372,0,1,1,"(11.360009,-72.129330)"
2015,Junio,Federación de Rusia,643,1,3,4,"(10.886611,-74.776708)"
2022,Noviembre,Israel,376,2,7,9,"(10.886611,-74.776708)"
2018,Diciembre,Guatemala,320,68,116,184,"(6.171601,-75.427454)"
2016,Febrero,Reino Unido de Gran Bretaña e Irlanda del Norte,826,1,0,1,"(0.25129,-76.875963)"
2019,Junio,Malasia,458,1,2,3,"(6.171601,-75.427454)"
2019,Marzo,Finlandia,246,1,2,3,"(10.886611,-74.776708)"
2020,Noviembre,Canadá,124,0,3,3,"(11.117806,-74.232622)"
2013,Marzo,Trinidad y Tobago,780,2,2,4,"(3.541112,-76.384584)"
2018,Febrero,República de Irlanda,372,2,1,3,"(10.408582,-75.538003)"
2016,Julio,El Salvador,222,25,19,44,"(12.586067,-81.702563)"
2014,Enero,España,724,1,9,10,"(7.927209,-72.507910)"
2015,Marzo,Indonesia,360,0,1,1,"(3.541112,-76.384584)"
2017,Diciembre,Nicaragua,558,2,0,2,"(0.814836,-77.662532)"
2021,Agosto,Finlandia,246,2,5,7,"(6.171601,-75.427454)"
2016,Agosto,Grecia,300,1,2,3,"(3.541112,-76.384584)"
2016,Noviembre,Federación de Rusia,643,0,2,2,"(3.893038,-77.067921)"
2021,Mayo,Países Bajos,528,166,122,288,"(10.445761,-75.516429)"
2020,Diciembre,Jordania,400,0,2,2,"(6.171601,-75.427454)"
2012,Enero,Italia,380,0,1,1,"(7.088729,-70.740253)"
2022,Abril,Estados Unidos de América,840,53,74,127,"(12.586067,-81.702563)"
2021,Junio,Costa Rica,188,7,8,15,"(10.886611,-74.776708)"
2021,Mayo,Polonia,616,3,6,9,"(10.445761,-75.516429)"
2012,Febrero,República de Corea,410,2,3,5,"(10.886611,-74.776708)"
2022,Febrero,Uruguay,858,5,5,10,"(12.586067,-81.702563)"
2012,Febrero,Tailandia,764,4,1,5,"(4.697144,-74.140516)"
2014,Noviembre,Alemania,276,1470,2455,3925,"(4.697144,-74.140516)"
2018,Marzo,Panamá,591,0,14,14,"(10.408582,-75.538003)"
2022,Abril,Líbano,422,6,13,19,"(4.697144,-74.140516)"
2015,Noviembre,Líbano,422,8,14,22,"(4.697144,-74.140516)"
2014,Enero,Granada,308,0,1,1,"(4.697144,-74.140516)"
2017,Marzo,Reino Unido de Gran Bretaña e Irlanda del Norte,826,1146,2314,3460,"(4.697144,-74.140516)"
2018,Octubre,Taiwán,158,53,105,158,"(4.697144,-74.140516)"
2023,Marzo,Desconocido,99999,1,0,1,"(7.818934,-72.453226)"
2018,Abril,República de Irlanda,372,17,25,42,"(10.445761,-75.516429)"
2022,Diciembre,Australia,36,6,12,18,"(0.814836,-77.662532)"
2016,Octubre,Mauricio,480,1,5,6,"(4.697144,-74.140516)"
2018,Noviembre,Israel,376,0,1,1,"(8.635765,-77.346578)"
2023,Enero,Uzbekistán,860,0,1,1,"(10.445761,-75.516429)"
2019,Marzo,República Dominicana,214,8,6,14,"(4.815061,-75.736532)"
2020,Febrero,Federación de Rusia,643,0,1,1,"(10.971302,-74.765397)"
2016,Julio,Jamaica,388,3,7,10,"(10.445761,-75.516429)"
2019,Diciembre,Sudáfrica,710,29,40,69,"(4.697144,-74.140516)"
2017,Julio,Costa Rica,188,0,1,1,"(-4.223468,-69.945098)"
2020,Enero,Perú,604,0,1,1,"(6.17134,-75.427194)"
2019,Marzo,Bolivia,68,0,2,2,"(-4.197703,-69.941278)"
2021,Octubre,Chile,152,1,6,7,"(10.408582,-75.538003)"
2018,Julio,Ecuador,218,1,0,1,"(-0.193180,-74.784874)"
2022,Diciembre,Suecia,752,1,0,1,"(-4.197703,-69.941278)"
2018,Octubre,México,484,1,1,2,"(-4.223468,-69.945098)"
2015,Marzo,Estados Unidos de América,840,1594,3542,5136,"(6.171601,-75.427454)"
2019,Octubre,República de Irlanda,372,14,35,49,"(6.171601,-75.427454)"
2022,Junio,Hong Kong,344,1,0,1,"(0.814836,-77.662532)"
2016,Junio,Croacia,191,0,5,5,"(6.171601,-75.427454)"
2017,Octubre,Paraguay,600,2,0,2,"(4.815061,-75.736532)"
2016,Enero,China,156,0,3,3,"(10.408582,-75.538003)"
2013,Julio,Venezuela,862,31,53,84,"(7.088729,-70.740253)"
2017,Julio,Bélgica,56,1,0,1,"(12.586067,-81.702563)"
2021,Marzo,Venezuela,862,101,68,169,"(7.818934,-72.453226)"
2013,Octubre,Haití,332,0,3,3,"(10.445761,-75.516429)"
2017,Septiembre,Federación de Rusia,643,3,6,9,"(3.541112,-76.384584)"
2016,Abril,República Árabe Siria,760,0,1,1,"(3.541112,-76.384584)"
2020,Marzo,Guatemala,320,4,3,7,"(12.586067,-81.702563)"
2016,Abril,Polonia,616,0,2,2,"(-4.197703,-69.941278)"
2019,Noviembre,México,484,24,75,99,"(10.886611,-74.776708)"
2012,Diciembre,Canadá,124,0,1,1,"(0.25129,-76.875963)"
2016,Enero,Panamá,591,12,16,28,"(7.128456,-73.183637)"
2016,Agosto,Islandia,352,1,0,1,"(3.541112,-76.384584)"
2015,Julio,Bahréin,48,3,2,5,"(3.541112,-76.384584)"
2023,Abril,Guyana,328,1,5,6,"(6.171601,-75.427454)"
2019,Febrero,Estados Unidos de América,840,9719,16667,26387,"(4.697144,-74.140516)"
2021,Mayo,Jamaica,388,1,1,2,"(3.541112,-76.384584)"
2017,Septiembre,Finlandia,246,3,6,9,"(6.171601,-75.427454)"
2018,Diciembre,México,484,0,4,4,"(7.088729,-70.740253)"
2016,Diciembre,Nueva Zelanda,554,0,1,1,"(4.452882,-75.766298)"
2016,Octubre,Sudáfrica,710,0,3,3,"(10.445761,-75.516429)"
2012,Enero,Finlandia,246,0,4,4,"(11.360009,-72.129330)"
2015,Octubre,Brasil,76,3,6,9,"(7.818934,-72.453226)"
2013,Marzo,Guatemala,320,1,1,2,"(10.408582,-75.538003)"
2015,Diciembre,Suiza,756,37,97,134,"(6.171601,-75.427454)"
2021,Mayo,Federación de Rusia,643,96,133,229,"(4.697144,-74.140516)"
2018,Septiembre,Australia,36,303,504,807,"(4.697144,-74.140516)"
2023,Abril,Perú,604,45,51,96,"(-4.223468,-69.945098)"
2023,Abril,San Cristóbal y Nevis,659,0,1,1,"(10.886611,-74.776708)"
2018,Noviembre,México,484,585,1285,1870,"(6.171601,-75.427454)"
2017,Noviembre,Indonesia,360,0,4,4,"(10.971302,-74.765397)"
2019,Octubre,Nueva Zelanda,554,6,6,12,"(0.814836,-77.662532)"
2017,Septiembre,Honduras,340,0,5,5,"(10.408582,-75.538003)"
2012,Octubre,República de Irlanda,372,42,97,139,"(4.697144,-74.140516)"
2022,Diciembre,Macedonia,807,0,1,1,"(3.541112,-76.384584)"
2015,Noviembre,México,484,0,2,2,"(-4.197703,-69.941278)"
2014,Julio,Panamá,591,77,134,211,"(3.541112,-76.384584)"
2016,Noviembre,Nueva Zelanda,554,51,90,141,"(4.697144,-74.140516)"
2015,Junio,Taiwán,158,3,0,3,"(10.445761,-75.516429)"
2014,Agosto,Paraguay,600,122,132,254,"(4.697144,-74.140516)"
2018,Mayo,Perú,604,0,1,1,"(8.635765,-77.346578)"
2022,Noviembre,España,724,1,2,3,"(11.247723,-74.213989)"
2013,Junio,Japón,392,13,19,32,"(0.814836,-77.662532)"
2012,Agosto,Serbia,688,0,1,1,"(0.814836,-77.662532)"
2017,Agosto,Suecia,752,0,1,1,"(4.452882,-75.766298)"
2020,Enero,República Árabe Siria,760,0,1,1,"(10.408582,-75.538003)"
2018,Noviembre,Kazajistán,398,0,1,1,"(10.886611,-74.776708)"
2017,Marzo,Venezuela,862,7,11,18,"(7.128456,-73.183637)"
2015,Diciembre,Haití,332,8,15,23,"(4.697144,-74.140516)"
2022,Junio,Mozambique,508,3,3,6,"(4.697144,-74.140516)"
2015,Abril,Francia,250,1,3,4,"(0.25129,-76.875963)"
2019,Marzo,España,724,0,1,1,"(10.971302,-74.765397)"
2012,Junio,Líbano,422,10,27,37,"(4.697144,-74.140516)"
2022,Junio,Japón,392,2,16,18,"(3.541112,-76.384584)"
2013,Abril,Alemania,276,9,5,14,"(8.635765,-77.346578)"
2019,Septiembre,República de Corea,410,0,3,3,"(10.971302,-74.765397)"
2015,Octubre,Grecia,300,0,3,3,"(9.402978,-75.681599)"
2019,Diciembre,Brasil,76,7,5,12,"(4.815061,-75.736532)"
2018,Julio,Federación de Rusia,643,0,3,3,"(11.247723,-74.213989)"
2014,Mayo,Brasil,76,14,20,34,"(0.814836,-77.662532)"
2022,Junio,Venezuela,862,24,20,44,"(6.185799,-67.483929)"
2018,Octubre,Bélgica,56,5,6,11,"(0.814836,-77.662532)"
2017,Noviembre,Hong Kong,344,2,5,7,"(4.697144,-74.140516)"
2012,Octubre,Reino Unido de Gran Bretaña e Irlanda del Norte,826,4,7,11,"(4.697144,-74.140516)"
2016,Agosto,Ucrania,804,0,1,1,"(3.541112,-76.384584)"
2021,Junio,Italia,380,17,25,42,"(7.818934,-72.453226)"
2020,Diciembre,República de Irlanda,372,12,42,54,"(4.697144,-74.140516)"
2015,Agosto,Turquía,792,0,5,5,"(11.360009,-72.129330)"
2019,Noviembre,Estados Unidos de América,840,5175,6932,12107,"(10.445761,-75.516429)"
2016,Diciembre,Estados Unidos de América,840,0,6,6,"(12.5744111,-81.703935)"
2022,Enero,Noruega,578,61,108,169,"(4.697144,-74.140516)"
2018,Agosto,Panamá,591,0,2,2,"(8.066966,-76.735404)"
2016,Agosto,Eslovaquia,703,1,0,1,"(0.814836,-77.662532)"
2013,Enero,Canadá,124,1,0,1,"(0.25129,-76.875963)"
2012,Abril,Filipinas,608,0,26,26,"(10.408582,-75.538003)"
2020,Diciembre,Bahamas,44,0,2,2,"(10.886611,-74.776708)"
2016,Agosto,Camerún,120,0,2,2,"(4.697144,-74.140516)"
2022,Enero,Albania,8,0,3,3,"(10.445761,-75.516429)"
2013,Mayo,Bélgica,56,3,12,15,"(10.445761,-75.516429)"
2015,Abril,Italia,380,2,4,6,"(4.815061,-75.736532)"
2019,Agosto,Nicaragua,558,1,1,2,"(10.408582,-75.538003)"
2014,Septiembre,Portugal,620,0,3,3,"(8.635765,-77.346578)"
2023,Abril,Italia,380,10,19,29,"(0.814836,-77.662532)"
2019,Abril,Federación de Rusia,643,0,4,4,"(9.402978,-75.681599)"
2016,Febrero,Sudáfrica,710,1,3,4,"(6.171601,-75.427454)"
2016,Septiembre,Argentina,32,8,21,29,"(7.818934,-72.453226)"
2012,Abril,China,156,7,12,19,"(6.171601,-75.427454)"
2015,Abril,Venezuela,862,4,6,10,"(4.815061,-75.736532)"
2021,Agosto,Trinidad y Tobago,780,8,9,17,"(4.697144,-74.140516)"
2018,Enero,Países Bajos,528,0,2,2,"(-4.197703,-69.941278)"
2022,Septiembre,Honduras,340,64,56,120,"(3.541112,-76.384584)"
2018,Agosto,Malta,470,0,1,1,"(6.171601,-75.427454)"
2017,Mayo,República de Corea,410,1,1,2,"(10.408582,-75.538003)"
2016,Diciembre,Ghana,288,0,7,7,"(4.697144,-74.140516)"
2017,Marzo,Japón,392,4,3,7,"(-4.223468,-69.945098)"
2017,Diciembre,China,156,5,8,13,"(12.586067,-81.702563)"
2012,Diciembre,Uruguay,858,0,3,3,"(4.815061,-75.736532)"
2019,Abril,Alemania,276,179,253,432,"(6.171601,-75.427454)"
2018,Mayo,Austria,40,8,27,35,"(6.171601,-75.427454)"
2019,Enero,Argentina,32,186,156,343,"(10.408582,-75.538003)"
2015,Julio,Noruega,578,35,32,67,"(3.541112,-76.384584)"
2022,Octubre,Surinam,740,7,13,20,"(4.697144,-74.140516)"
2013,Diciembre,Canadá,124,0,3,3,"(11.360009,-72.129330)"
2012,Agosto,Filipinas,608,0,19,19,"(10.408582,-75.538003)"
2017,Diciembre,Italia,380,25,51,76,"(7.818934,-72.453226)"
2014,Marzo,República Dominicana,214,2,7,9,"(0.814836,-77.662532)"
2019,Marzo,Israel,376,3,0,3,"(12.586067,-81.702563)"
2014,Junio,Haití,332,0,3,3,"(3.541112,-76.384584)"
2013,Marzo,República Dominicana,214,14,20,34,"(10.445761,-75.516429)"
2013,Marzo,Austria,40,6,14,20,"(10.445761,-75.516429)"
2014,Junio,China,156,1,1,2,"(7.927209,-72.507910)"
2019,Julio,Hong Kong,344,0,1,1,"(10.886611,-74.776708)"
2022,Mayo,Sri Lanka,144,0,1,1,"(10.886611,-74.776708)"
2021,Agosto,Líbano,422,19,10,29,"(4.697144,-74.140516)"
2022,Noviembre,China,156,0,2,2,"(7.916725,-72.462544)"
2013,Mayo,Costa Rica,188,453,839,1292,"(4.697144,-74.140516)"
2017,Febrero,Francia,250,2,6,8,"(4.815061,-75.736532)"
2019,Diciembre,Cabo Verde,132,1,0,1,"(3.541112,-76.384584)"
2014,Enero,Ecuador,218,19,77,96,"(0.25129,-76.875963)"
2014,Junio,Chile,152,1,3,4,"(11.247723,-74.213989)"
2023,Abril,Iraq,368,0,1,1,"(3.541112,-76.384584)"
2014,Diciembre,Bahamas,44,2,1,3,"(6.171601,-75.427454)"
2022,Diciembre,Polonia,616,0,2,2,"(10.971302,-74.765397)"
2018,Febrero,Estonia,233,4,4,8,"(10.445761,-75.516429)"
2018,Febrero,Estados Unidos de América,840,88,144,232,"(4.452882,-75.766298)"
2016,Mayo,Estonia,233,1,0,1,"(-4.197703,-69.941278)"
2013,Octubre,Austria,40,74,186,260,"(4.697144,-74.140516)"
2016,Enero,Suiza,756,1,2,3,"(12.5744111,-81.703935)"
2023,Mayo,Senegal,686,0,3,3,"(4.697144,-74.140516)"
2021,Enero,Letonia,428,0,1,1,"(10.408582,-75.538003)"
2021,Diciembre,Honduras,340,0,4,4,"(10.408582,-75.538003)"
2018,Diciembre,Venezuela,862,17,39,56,"(7.128456,-73.183637)"
2012,Mayo,Estados Unidos de América,840,21,46,67,"(10.408582,-75.538003)"
2020,Marzo,Líbano,422,1,2,3,"(6.171601,-75.427454)"
2022,Febrero,Honduras,340,0,2,2,"(10.971302,-74.765397)"
2022,Mayo,Estonia,233,9,7,16,"(4.697144,-74.140516)"
2013,Julio,Noruega,578,3,2,5,"(-4.197703,-69.941278)"
2019,Diciembre,Bulgaria,100,57,44,101,"(4.697144,-74.140516)"
2012,Marzo,Ecuador,218,1775,2908,4683,"(4.697144,-74.140516)"
2016,Enero,República Checa,203,0,1,1,"(7.128456,-73.183637)"
2016,Marzo,Sri Lanka,144,0,1,1,"(4.697144,-74.140516)"
2016,Diciembre,Argentina,32,86,170,256,"(0.814836,-77.662532)"
2016,Junio,Honduras,340,39,58,97,"(6.171601,-75.427454)"
2013,Abril,Alemania,276,28,53,81,"(3.541112,-76.384584)"
2016,Julio,India,356,0,10,10,"(10.408582,-75.538003)"
2014,Junio,Austria,40,8,5,13,"(0.814836,-77.662532)"
2016,Enero,Vietnam,704,0,7,7,"(4.697144,-74.140516)"
2019,Marzo,Suecia,752,0,1,1,"(4.815061,-75.736532)"
2014,Julio,Polonia,616,4,0,4,"(3.541112,-76.384584)"
2015,Junio,Portugal,620,0,2,2,"(7.927209,-72.507910)"
2013,Junio,Serbia,688,1,1,2,"(6.171601,-75.427454)"
2018,Marzo,Venezuela,862,2,1,3,"(0.812436,-77.847006)"
2019,Junio,Perú,604,203,292,495,"(3.541112,-76.384584)"
2016,Enero,Haití,332,0,2,2,"(10.445761,-75.516429)"
2019,Octubre,Portugal,620,11,20,32,"(3.541112,-76.384584)"
2017,Julio,Costa Rica,188,2,1,3,"(10.408582,-75.538003)"
2018,Abril,Paraguay,600,26,27,53,"(6.171601,-75.427454)"
2018,Julio,Egipto,818,1,2,3,"(6.171601,-75.427454)"
2014,Diciembre,Bolivia,68,20,37,57,"(6.171601,-75.427454)"
2019,Enero,Reino Unido de Gran Bretaña e Irlanda del Norte,826,4,6,10,"(4.815061,-75.736532)"
2013,Diciembre,España,724,9,15,24,"(11.360009,-72.129330)"
2015,Agosto,Reino Unido de Gran Bretaña e Irlanda del Norte,826,8,16,24,"(-4.197703,-69.941278)"
2012,Abril,Bahamas,44,0,2,2,"(3.541112,-76.384584)"
2017,Mayo,Panamá,591,0,1,1,"(6.228046,-77.404104)"
2016,Mayo,Sudán,736,0,1,1,"(6.171601,-75.427454)"
2012,Diciembre,Ucrania,804,3,1,4,"(3.541112,-76.384584)"
2016,Febrero,Malta,470,9,20,29,"(4.697144,-74.140516)"
2015,Enero,Reino Unido de Gran Bretaña e Irlanda del Norte,826,0,1,1,"(7.088729,-70.740253)"
2019,Marzo,Brasil,76,1118,753,1871,"(10.445761,-75.516429)"
2019,Abril,Italia,380,86,167,253,"(10.445761,-75.516429)"
2016,Septiembre,Noruega,578,6,12,18,"(6.171601,-75.427454)"
2018,Diciembre,República Dominicana,214,2,0,2,"(10.971302,-74.765397)"
2021,Diciembre,India,356,37,157,195,"(4.697144,-74.140516)"
2017,Noviembre,Federación de Rusia,643,0,1,1,"(-4.223468,-69.945098)"
2023,Mayo,Filipinas,608,0,48,48,"(11.247723,-74.213989)"
2022,Abril,Granada,308,2,0,2,"(4.697144,-74.140516)"
2023,Junio,México,484,3,8,11,"(8.36068,-72.409396)"
2023,Abril,Australia,36,46,140,186,"(6.171601,-75.427454)"
2015,Junio,Argentina,32,127,271,398,"(6.171601,-75.427454)"
2016,Junio,San Cristóbal y Nevis,659,0,1,1,"(4.697144,-74.140516)"
2014,Junio,Albania,8,0,1,1,"(3.541112,-76.384584)"
2019,Junio,Japón,392,0,1,1,"(10.408582,-75.538003)"
2013,Julio,Lituania,440,0,1,1,"(10.408582,-75.538003)"
2015,Enero,Costa Rica,188,1,4,5,"(7.818934,-72.453226)"
2013,Abril,Dinamarca,208,42,91,133,"(4.697144,-74.140516)"
2017,Agosto,Venezuela,862,1,0,1,"(1.813928,-78.763924)"
2019,Agosto,Santa Lucia,662,0,2,2,"(3.541112,-76.384584)"
2017,Noviembre,Australia,36,0,4,4,"(7.128456,-73.183637)"
2019,Enero,Polonia,616,0,2,2,"(3.893038,-77.067921)"
2018,Febrero,Brasil,76,24,35,59,"(0.814836,-77.662532)"
2019,Enero,Suiza,756,84,147,231,"(6.171601,-75.427454)"
2017,Marzo,Federación de Rusia,643,0,1,1,"(10.971302,-74.765397)"
2022,Mayo,Nueva Zelanda,554,2,1,3,"(11.247723,-74.213989)"
2018,Junio,Federación de Rusia,643,2,0,2,"(7.818934,-72.453226)"
2021,Diciembre,México,484,35,91,126,"(10.886611,-74.776708)"
2012,Febrero,Francia,250,0,3,3,"(7.088729,-70.740253)"
2022,Enero,Kenia,404,6,6,12,"(4.697144,-74.140516)"
2018,Septiembre,Estados Unidos de América,840,20,36,56,"(7.128456,-73.183637)"
2022,Agosto,Islas Fiji,242,1,0,1,"(10.445761,-75.516429)"
2018,Octubre,Bélgica,56,1,1,2,"(-4.223468,-69.945098)"
2015,Diciembre,Camerún,120,1,0,1,"(4.697144,-74.140516)"
2019,Marzo,Zambia,894,1,0,1,"(4.697144,-74.140516)"
2013,Noviembre,Islas Fiji,242,0,1,1,"(10.886611,-74.776708)"
2019,Noviembre,Barbados,52,0,1,1,"(10.886611,-74.776708)"
2019,Noviembre,Australia,36,1,5,6,"(-4.223468,-69.945098)"
2023,Enero,Polonia,616,0,2,2,"(10.971302,-74.765397)"
2018,Junio,Nicaragua,558,3,1,4,"(12.586067,-81.702563)"
2016,Julio,Antigua y Barbuda,28,0,1,1,"(11.360009,-72.129330)"
2015,Abril,Trinidad y Tobago,780,0,2,2,"(7.818934,-72.453226)"
2020,Febrero,Santa Lucia,662,1,0,1,"(3.541112,-76.384584)"
2020,Marzo,Chile,152,16,19,35,"(10.886611,-74.776708)"
2022,Junio,Suiza,756,1,0,1,"(12.586067,-81.702563)"
2021,Abril,México,484,1,4,5,"(4.452882,-75.766298)"
2015,Junio,Venezuela,862,2681,3336,6017,"(7.818934,-72.453226)"
2023,Febrero,República Árabe Siria,760,1,1,2,"(4.697144,-74.140516)"
2022,Diciembre,Croacia,191,0,1,1,"(10.886611,-74.776708)"
2022,Julio,Argentina,32,116,86,202,"(11.117806,-74.232622)"
2022,Julio,Suiza,756,1,0,1,"(8.635765,-77.346578)"
2013,Julio,Suecia,752,2,2,4,"(-4.197703,-69.941278)"
2020,Diciembre,Italia,380,192,483,675,"(4.697144,-74.140516)"
2023,Mayo,Italia,380,0,1,1,"(6.18189,-67.47535)"
2014,Septiembre,Suiza,756,222,435,657,"(4.697144,-74.140516)"
2021,Abril,Reino Unido de Gran Bretaña e Irlanda del Norte,826,23,41,64,"(10.445761,-75.516429)"
2013,Enero,Portugal,620,7,20,27,"(3.541112,-76.384584)"
2019,Junio,Polonia,616,3,8,11,"(0.814836,-77.662532)"
2019,Febrero,Estados Unidos de América,840,31,46,77,"(11.117806,-74.232622)"
2012,Marzo,Cuba,192,3,9,12,"(10.886611,-74.776708)"
2013,Septiembre,República Dominicana,214,1,4,5,"(7.818934,-72.453226)"
2017,Mayo,Nueva Zelanda,554,1,1,2,"(8.635765,-77.346578)"
2018,Noviembre,Barbados,52,1,2,3,"(6.171601,-75.427454)"
2014,Mayo,Rumania,642,2,0,2,"(10.886611,-74.776708)"
2018,Septiembre,Líbano,422,1,0,1,"(7.128456,-73.183637)"
2022,Mayo,Argentina,32,7,10,17,"(7.818934,-72.453226)"
2019,Diciembre,Estados Unidos de América,840,8,19,27,"(-4.197703,-69.941278)"
2015,Diciembre,Israel,376,119,407,526,"(4.697144,-74.140516)"
2023,Junio,España,724,3751,5499,9251,"(4.697144,-74.140516)"
2021,Agosto,Países Bajos,528,18,47,65,"(10.886611,-74.776708)"
2012,Mayo,Lesoto,426,1,0,1,"(4.697144,-74.140516)"
2016,Enero,Chipre,196,1,3,4,"(4.697144,-74.140516)"
2012,Noviembre,Taiwán,158,0,4,4,"(3.541112,-76.384584)"
2014,Octubre,República Árabe Siria,760,2,1,3,"(4.697144,-74.140516)"
2022,Diciembre,Antigua y Barbuda,28,1,0,1,"(6.171601,-75.427454)"
2022,Abril,Taiwán,158,1,0,1,"(10.886611,-74.776708)"
2016,Mayo,Liechtenstein,438,1,0,1,"(0.814836,-77.662532)"
2022,Febrero,Belice,84,0,1,1,"(3.541112,-76.384584)"
2018,Noviembre,Pakistán,586,7,19,26,"(4.697144,-74.140516)"
2023,Mayo,Italia,380,38,41,79,"(8.364293,-72.405710)"
2017,Julio,República Dominicana,214,0,1,1,"(11.247723,-74.213989)"
2022,Octubre,España,724,14,25,39,"(4.815061,-75.736532)"
2014,Marzo,Singapur,702,0,1,1,"(10.886611,-74.776708)"
2012,Diciembre,Canadá,124,0,5,5,"(7.927209,-72.507910)"
2019,Julio,Ucrania,804,0,3,3,"(9.402978,-75.681599)"
2021,Diciembre,España,724,0,1,1,"(11.247723,-74.213989)"
2015,Septiembre,Bulgaria,100,1,4,5,"(10.445761,-75.516429)"
2012,Abril,Tailandia,764,1,0,1,"(3.541112,-76.384584)"
2019,Diciembre,República de Armenia,51,3,2,5,"(4.697144,-74.140516)"
2012,Noviembre,Croacia,191,2,23,25,"(4.697144,-74.140516)"
2016,Abril,Cuba,192,19,36,55,"(6.171601,-75.427454)"
2012,Enero,Italia,380,6,20,26,"(10.408582,-75.538003)"
2019,Octubre,México,484,58,124,182,"(3.541112,-76.384584)"
2015,Marzo,Suecia,752,1,2,3,"(7.818934,-72.453226)"
2019,Enero,Chile,152,2,2,4,"(4.452882,-75.766298)"
2016,Octubre,Italia,380,0,3,3,"(11.360009,-72.129330)"
2015,Marzo,Benín,204,2,0,2,"(4.697144,-74.140516)"
2017,Agosto,Panamá,591,5,13,18,"(7.102626,-77.762647)"
2017,Febrero,Indonesia,360,0,15,15,"(3.893038,-77.067921)"
2013,Enero,Estados Unidos de América,840,2,2,4,"(13.3387613,-81.372937)"
2012,Noviembre,Francia,250,2,5,7,"(10.886611,-74.776708)"
2020,Enero,Jordania,400,0,1,1,"(0.814836,-77.662532)"
2012,Febrero,Bolivia,68,0,3,3,"(4.815061,-75.736532)"
2014,Diciembre,Portugal,620,0,1,1,"(7.128456,-73.183637)"
2023,Junio,Argentina,32,1,4,5,"(-4.223468,-69.945098)"
2012,Septiembre,Benín,204,0,4,4,"(4.697144,-74.140516)"
2022,Junio,Argentina,32,22,35,57,"(0.814836,-77.662532)"
2014,Septiembre,Bélgica,56,4,17,21,"(6.171601,-75.427454)"
2014,Agosto,El Salvador,222,73,82,155,"(3.541112,-76.384584)"
2013,Febrero,Guatemala,320,0,4,4,"(7.818934,-72.453226)"
2019,Febrero,República Árabe Siria,760,0,1,1,"(11.247723,-74.213989)"
2022,Octubre,Guatemala,320,513,761,1274,"(4.697144,-74.140516)"
2019,Diciembre,Suiza,756,13,27,40,"(0.814836,-77.662532)"
2018,Diciembre,Países Bajos,528,297,362,659,"(10.445761,-75.516429)"
2016,Abril,Países Bajos,528,1083,1559,2642,"(4.697144,-74.140516)"
2020,Noviembre,Perú,604,6,6,12,"(4.815061,-75.736532)"
2017,Julio,Eslovenia,705,1,1,2,"(0.814836,-77.662532)"
2021,Octubre,Serbia,688,2,1,3,"(10.445761,-75.516429)"
2022,Febrero,Brasil,76,4,2,6,"(7.128456,-73.183637)"
2022,Febrero,Nueva Zelanda,554,2,14,16,"(6.171601,-75.427454)"
2012,Septiembre,México,484,128,387,515,"(6.171601,-75.427454)"
2018,Febrero,República Dominicana,214,0,1,1,"(10.408582,-75.538003)"
2018,Octubre,Guatemala,320,0,3,3,"(0.814836,-77.662532)"
2023,Mayo,Chile,152,26,13,39,"(11.117806,-74.232622)"
2012,Marzo,Países Bajos,528,1,3,4,"(11.360009,-72.129330)"
2015,Junio,El Salvador,222,0,2,2,"(4.815061,-75.736532)"
2023,Mayo,Portugal,620,18,21,39,"(7.818934,-72.453226)"
2012,Noviembre,Palestina,99999,0,1,1,"(6.171601,-75.427454)"
2013,Julio,Taiwán,158,1,3,4,"(3.541112,-76.384584)"
2016,Octubre,República Dominicana,214,1,2,3,"(12.586067,-81.702563)"
2022,Abril,Israel,376,670,950,1620,"(4.697144,-74.140516)"
2018,Octubre,Panamá,591,0,2,2,"(7.818934,-72.453226)"
2015,Enero,Italia,380,33,108,141,"(3.541112,-76.384584)"
2014,Marzo,Nueva Zelanda,554,3,3,6,"(3.541112,-76.384584)"
2022,Mayo,Argentina,32,2,2,4,"(7.916725,-72.462544)"
2013,Octubre,Haití,332,2,14,16,"(4.697144,-74.140516)"
2018,Agosto,Argentina,32,61,121,182,"(0.814836,-77.662532)"
2022,Mayo,Irán,364,3,2,5,"(10.445761,-75.516429)"
2013,Febrero,Uruguay,858,31,29,60,"(12.586067,-81.702563)"
2014,Marzo,Nicaragua,558,0,1,1,"(0.814836,-77.662532)"
2012,Octubre,Portugal,620,0,2,2,"(10.408582,-75.538003)"
2017,Febrero,Cuba,192,28,22,50,"(6.171601,-75.427454)"
2019,Marzo,Uzbekistán,860,2,0,2,"(4.697144,-74.140516)"
2018,Diciembre,España,724,6,9,15,"(8.36068,-72.409396)"
2019,Mayo,España,724,8,18,26,"(10.408582,-75.538003)"
2018,Julio,Francia,250,8,19,27,"(-4.223468,-69.945098)"
2022,Diciembre,Francia,250,1,1,2,"(10.971302,-74.765397)"
2022,Abril,Vietnam,704,4,1,5,"(4.697144,-74.140516)"
2021,Diciembre,Bélgica,56,1,0,1,"(7.927209,-72.507910)"
2017,Septiembre,Nueva Zelanda,554,0,1,1,"(13.3387613,-81.372937)"
2022,Octubre,España,724,6,4,10,"(-4.223468,-69.945098)"
2012,Octubre,Japón,392,3,5,8,"(7.818934,-72.453226)"
2017,Mayo,Jamaica,388,17,24,41,"(4.697144,-74.140516)"
2022,Enero,Panamá,591,1,1,2,"(7.916725,-72.462544)"
2015,Noviembre,España,724,19,59,78,"(10.886611,-74.776708)"
2019,Noviembre,Croacia,191,0,3,3,"(10.408582,-75.538003)"
2013,Enero,Federación de Rusia,643,2,2,4,"(3.541112,-76.384584)"
2021,Abril,Francia,250,3,1,4,"(12.5744111,-81.703935)"
2016,Abril,Jordania,400,2,4,6,"(4.697144,-74.140516)"
2021,Octubre,Austria,40,2,3,5,"(3.541112,-76.384584)"
2023,Abril,San Cristóbal y Nevis,659,2,0,2,"(10.445761,-75.516429)"
2016,Agosto,Barbados,52,1,0,1,"(3.541112,-76.384584)"
2019,Septiembre,Australia,36,2,10,12,"(10.886611,-74.776708)"
2014,Noviembre,Austria,40,1,3,4,"(8.635765,-77.346578)"
2023,Marzo,Argentina,32,2,1,3,"(-4.223468,-69.945098)"
2015,Julio,Suecia,752,5,3,8,"(10.408582,-75.538003)"
2016,Junio,Rumania,642,1,0,1,"(-4.197703,-69.941278)"
2017,Julio,Jordania,400,0,1,1,"(4.815061,-75.736532)"
2018,Marzo,San Cristóbal y Nevis,659,0,1,1,"(6.171601,-75.427454)"
2021,Octubre,Honduras,340,2,3,5,"(4.815061,-75.736532)"
2022,Julio,Madagascar,450,1,1,2,"(10.445761,-75.516429)"
2022,Agosto,Sudáfrica,710,0,1,1,"(10.886611,-74.776708)"
2022,Abril,Estados Unidos de América,840,69,90,159,"(10.408582,-75.538003)"
2016,Marzo,Bolivia,68,1,0,1,"(0.25129,-76.875963)"
2015,Junio,Dinamarca,208,0,1,1,"(7.818934,-72.453226)"
2014,Julio,Estados Unidos de América,840,496,669,1165,"(10.886611,-74.776708)"
2022,Abril,República de Armenia,51,1,1,2,"(4.697144,-74.140516)"
2018,Julio,Alemania,276,1,2,3,"(11.360009,-72.129330)"
2022,Septiembre,Ecuador,218,6985,6868,13855,"(4.697144,-74.140516)"
2017,Febrero,Portugal,620,0,1,1,"(11.247723,-74.213989)"
2020,Octubre,Estados Unidos de América,840,276,556,832,"(10.886611,-74.776708)"
2019,Diciembre,Países Bajos,528,401,377,778,"(10.445761,-75.516429)"
2020,Noviembre,Cuba,192,0,1,1,"(10.408582,-75.538003)"
2021,Junio,Estados Unidos de América,840,12,5,17,"(7.818934,-72.453226)"
2019,Julio,Gibraltar/Territorio Británico de Ultramar,292,0,1,1,"(4.697144,-74.140516)"
2014,Mayo,Francia,250,1,2,3,"(7.102626,-77.762647)"
2019,Abril,España,724,9,13,22,"(11.360009,-72.129330)"
2014,Febrero,Israel,376,0,2,2,"(10.408582,-75.538003)"
2019,Septiembre,Estados Unidos de América,840,0,1,1,"(0.25129,-76.875963)"
2012,Enero,Suiza,756,14,18,32,"(10.445761,-75.516429)"
2013,Diciembre,Albania,8,0,1,1,"(0.814836,-77.662532)"
2013,Abril,Panamá,591,46,79,125,"(10.886611,-74.776708)"
2016,Agosto,República de Corea,410,1,0,1,"(12.586067,-81.702563)"
2015,Septiembre,Mauricio,480,0,1,1,"(6.171601,-75.427454)"
2015,Marzo,Grecia,300,0,3,3,"(3.541112,-76.384584)"
2016,Septiembre,Italia,380,38,107,145,"(10.445761,-75.516429)"
2015,Septiembre,Ghana,288,0,1,1,"(10.445761,-75.516429)"
2018,Octubre,Turquía,792,1,2,3,"(0.814836,-77.662532)"
2022,Abril,Etiopia,231,0,1,1,"(10.971302,-74.765397)"
2018,Febrero,Australia,36,3,18,21,"(10.886611,-74.776708)"
2022,Abril,Honduras,340,14,6,20,"(4.815061,-75.736532)"
2016,Julio,República de Irlanda,372,100,187,287,"(4.697144,-74.140516)"
2019,Noviembre,Qatar,634,0,2,2,"(10.445761,-75.516429)"
2018,Septiembre,Noruega,578,6,5,11,"(10.408582,-75.538003)"
2021,Mayo,Cuba,192,9,19,28,"(6.171601,-75.427454)"
2018,Febrero,Alemania,276,1,0,1,"(4.452882,-75.766298)"
2016,Enero,Barbados,52,1,0,1,"(3.541112,-76.384584)"
2012,Agosto,Eslovaquia,703,29,12,41,"(4.697144,-74.140516)"
2012,Septiembre,Portugal,620,1,6,7,"(7.818934,-72.453226)"
2015,Abril,Venezuela,862,18,41,59,"(10.408582,-75.538003)"
2018,Febrero,Jamaica,388,27,28,55,"(4.697144,-74.140516)"
2022,Marzo,Kazajistán,398,1,0,1,"(3.541112,-76.384584)"
2018,Noviembre,Países Bajos,528,16,13,29,"(8.635765,-77.346578)"
2018,Enero,Alemania,276,109,128,237,"(0.814836,-77.662532)"
2017,Julio,Rumania,642,53,46,99,"(4.697144,-74.140516)"
2016,Mayo,Croacia,191,0,1,1,"(10.408582,-75.538003)"
2017,Enero,Eslovenia,705,0,2,2,"(0.814836,-77.662532)"
2016,Enero,Países Bajos,528,4,6,10,"(-4.197703,-69.941278)"
2013,Septiembre,Filipinas,608,3,3,6,"(6.171601,-75.427454)"
2022,Marzo,Alemania,276,1,4,5,"(11.247723,-74.213989)"
2019,Diciembre,Rumania,642,0,1,1,"(0.814836,-77.662532)"
2015,Agosto,Islas Vírgenes Británicas/Territorio Británico de Ultramar,92,0,1,1,"(4.697144,-74.140516)"
2014,Agosto,Alemania,276,27,37,64,"(10.408582,-75.538003)"
2017,Junio,Taiwán,158,4,1,5,"(10.445761,-75.516429)"
2012,Abril,San Marino,674,0,1,1,"(6.171601,-75.427454)"
2015,Abril,Aruba,533,1,1,2,"(4.697144,-74.140516)"
2012,Octubre,Italia,380,13,96,109,"(6.171601,-75.427454)"
2015,Febrero,Panamá,591,7,13,20,"(7.128456,-73.183637)"
2022,Febrero,Guatemala,320,0,4,4,"(7.128456,-73.183637)"
2013,Octubre,Argentina,32,37,71,108,"(3.541112,-76.384584)"
2013,Diciembre,Australia,36,4,1,5,"(12.586067,-81.702563)"
2012,Septiembre,República de Corea,410,2,16,18,"(6.171601,-75.427454)"
2014,Diciembre,Bélgica,56,0,1,1,"(11.360009,-72.129330)"
2013,Abril,Perú,604,151,339,490,"(6.171601,-75.427454)"
2015,Junio,Taiwán,158,1,0,1,"(8.635765,-77.346578)"
2017,Junio,Pakistán,586,2,1,3,"(6.171601,-75.427454)"
2022,Enero,Suiza,756,0,1,1,"(7.927209,-72.507910)"
2021,Diciembre,Trinidad y Tobago,780,3,8,11,"(10.445761,-75.516429)"
2017,Marzo,Ucrania,804,0,1,1,"(9.402978,-75.681599)"
2020,Febrero,Australia,36,12,24,36,"(0.814836,-77.662532)"
2016,Septiembre,Marruecos,504,8,40,48,"(4.697144,-74.140516)"
2018,Octubre,Singapur,702,1,5,6,"(10.445761,-75.516429)"
2022,Octubre,Brasil,76,67,58,125,"(12.586067,-81.702563)"
2018,Agosto,Costa Rica,188,161,108,270,"(10.445761,-75.516429)"
2020,Marzo,Estados Unidos de América,840,7,13,20,"(-4.223468,-69.945098)"
2022,Julio,Chad,148,0,1,1,"(6.171601,-75.427454)"
2022,Agosto,Nueva Zelanda,554,1,1,2,"(8.635765,-77.346578)"
2016,Noviembre,Lituania,440,1,0,1,"(0.814836,-77.662532)"
2017,Mayo,Barbados,52,0,1,1,"(6.171601,-75.427454)"
2016,Junio,Honduras,340,0,2,2,"(10.408582,-75.538003)"
2021,Agosto,Filipinas,608,26,96,122,"(4.697144,-74.140516)"
2020,Mayo,Venezuela,862,2,4,6,"(7.818934,-72.453226)"
2016,Octubre,Burundi,108,1,2,3,"(4.697144,-74.140516)"
2018,Agosto,República de Corea,410,0,2,2,"(-4.197703,-69.941278)"
2022,Junio,Islas Caimán/Territorio Británico de Ultramar,136,0,1,2,"(3.541112,-76.384584)"
2012,Julio,Rumania,642,1,4,5,"(3.541112,-76.384584)"
2013,Marzo,Venezuela,862,0,2,2,"(4.452882,-75.766298)"
2015,Febrero,Bermudas/Territorio Británico de Ultramar,60,0,1,1,"(4.697144,-74.140516)"
2014,Agosto,San  Vicente y las Granadinas,670,0,4,4,"(6.171601,-75.427454)"
2018,Diciembre,China,156,1,1,2,"(8.36068,-72.409396)"
2012,Noviembre,Panamá,591,92,180,272,"(3.541112,-76.384584)"
2016,Mayo,Guyana,328,1,1,2,"(10.886611,-74.776708)"
2017,Noviembre,Georgia,268,2,0,2,"(10.445761,-75.516429)"
2012,Mayo,Argentina,32,4,5,9,"(-4.197703,-69.941278)"
2020,Abril,México,484,0,7,7,"(4.697144,-74.140516)"
2022,Diciembre,Venezuela,862,4,5,9,"(12.586067,-81.702563)"
2016,Junio,Honduras,340,191,257,448,"(4.697144,-74.140516)"
2018,Marzo,Ecuador,218,3322,4072,7394,"(4.697144,-74.140516)"
2013,Abril,Chile,152,5,6,11,"(10.408582,-75.538003)"
2019,Abril,República Dominicana,214,1,3,4,"(-4.197703,-69.941278)"
2020,Enero,Guyana,328,0,1,1,"(10.886611,-74.776708)"
2022,Junio,Iraq,368,1,0,1,"(4.697144,-74.140516)"
2015,Febrero,Rumania,642,2,0,2,"(0.814836,-77.662532)"
2021,Noviembre,Bélgica,56,2,0,2,"(-4.197703,-69.941278)"
2022,Septiembre,Francia,250,6,7,13,"(-4.223468,-69.945098)"
2017,Enero,Federación de Rusia,643,0,1,1,"(10.971302,-74.765397)"
2017,Mayo,Guyana,328,2,2,4,"(6.171601,-75.427454)"
2012,Julio,Bélgica,56,8,8,16,"(10.445761,-75.516429)"
2018,Febrero,Suecia,752,2,1,3,"(7.818934,-72.453226)"
2013,Febrero,Estados Unidos de América,840,907,2474,3381,"(6.171601,-75.427454)"
2018,Mayo,Turquía,792,0,4,4,"(7.818934,-72.453226)"
2022,Noviembre,Honduras,340,44,32,76,"(3.541112,-76.384584)"
2022,Febrero,Países Bajos,528,3,0,3,"(7.128456,-73.183637)"
2014,Agosto,Federación de Rusia,643,1,0,1,"(7.128456,-73.183637)"
2016,Agosto,Nicaragua,558,13,10,23,"(6.171601,-75.427454)"
2019,Febrero,Bulgaria,100,68,81,149,"(4.697144,-74.140516)"
2021,Mayo,Surinam,740,0,2,2,"(6.171601,-75.427454)"
2014,Julio,Dinamarca,208,10,13,23,"(6.171601,-75.427454)"
2019,Diciembre,Uzbekistán,860,1,0,1,"(3.541112,-76.384584)"
2016,Octubre,México,484,2,1,3,"(8.635765,-77.346578)"
2017,Junio,Brasil,76,1,1,2,"(12.5744111,-81.703935)"
2022,Agosto,Portugal,620,6,8,14,"(7.916725,-72.462544)"
2013,Diciembre,Austria,40,5,6,11,"(0.814836,-77.662532)"
2015,Enero,Bangladesh,50,0,1,1,"(10.445761,-75.516429)"
2022,Marzo,Estados Unidos de América,840,1406,2088,3494,"(10.886611,-74.776708)"
2021,Septiembre,Suiza,756,3,2,5,"(10.408582,-75.538003)"
2012,Mayo,Polonia,616,0,4,4,"(10.445761,-75.516429)"
2012,Julio,Países Bajos,528,337,390,727,"(4.697144,-74.140516)"
2023,Marzo,Filipinas,608,14,14,28,"(6.171601,-75.427454)"
2014,Agosto,Suiza,756,2,1,3,"(12.586067,-81.702563)"
2013,Noviembre,Costa Rica,188,0,1,1,"(7.927209,-72.507910)"
2013,Agosto,Estados Unidos de América,840,6695,12117,18812,"(4.697144,-74.140516)"
2016,Mayo,Trinidad y Tobago,780,4,5,9,"(10.445761,-75.516429)"
2019,Noviembre,México,484,20,29,50,"(0.814836,-77.662532)"
2012,Noviembre,Austria,40,0,1,1,"(10.886611,-74.776708)"
2016,Enero,República Democrática del Congo,180,1,0,1,"(3.541112,-76.384584)"
2015,Agosto,Reino Unido de Gran Bretaña e Irlanda del Norte,826,40,74,114,"(3.541112,-76.384584)"
2021,Mayo,Nueva Zelanda,554,2,2,4,"(10.886611,-74.776708)"
2023,Enero,Irán,364,7,15,22,"(4.697144,-74.140516)"
2017,Febrero,Estados Unidos de América,840,11,8,19,"(7.818934,-72.453226)"
2022,Agosto,Dinamarca,208,2,3,5,"(10.886611,-74.776708)"
2023,Junio,Venezuela,862,1,24,25,"(3.893038,-77.067921)"
2022,Junio,Australia,36,0,1,1,"(11.247723,-74.213989)"
2015,Abril,Nueva Zelanda,554,0,1,1,"(11.247723,-74.213989)"
2015,Diciembre,Jamaica,388,1,2,3,"(10.886611,-74.776708)"
2021,Noviembre,Serbia,688,0,1,1,"(7.128456,-73.183637)"
2018,Septiembre,México,484,2,2,4,"(6.185799,-67.483929)"
2012,Febrero,Canadá,124,1170,1142,2312,"(10.445761,-75.516429)"
2014,Enero,Ecuador,218,1,2,3,"(7.088729,-70.740253)"
2023,Marzo,Noruega,578,9,6,15,"(3.541112,-76.384584)"
2021,Mayo,Argentina,32,537,827,1364,"(4.697144,-74.140516)"
2018,Junio,Japón,392,1,0,1,"(12.586067,-81.702563)"
2015,Noviembre,Santa Lucia,662,0,1,1,"(7.128456,-73.183637)"
2019,Junio,Islandia,352,2,1,3,"(7.128456,-73.183637)"
2022,Marzo,Jamaica,388,5,5,10,"(10.886611,-74.776708)"
2017,Diciembre,Brasil,76,74,74,148,"(3.541112,-76.384584)"
2018,Abril,Venezuela,862,8,19,27,"(11.117806,-74.232622)"
2016,Marzo,Italia,380,5,9,14,"(-4.197703,-69.941278)"
2012,Mayo,Argentina,32,4,3,7,"(0.25129,-76.875963)"
2015,Febrero,Dinamarca,208,0,1,1,"(11.247723,-74.213989)"
2023,Abril,San  Vicente y las Granadinas,670,0,1,1,"(13.3387613,-81.372937)"
2020,Marzo,Israel,376,1,2,3,"(-4.197703,-69.941278)"
2019,Septiembre,Israel,376,0,2,2,"(11.360009,-72.129330)"
2012,Agosto,México,484,0,2,2,"(1.813928,-78.763924)"
2017,Julio,Cuba,192,277,423,700,"(4.697144,-74.140516)"
2014,Abril,Brasil,76,3,3,6,"(7.927209,-72.507910)"
2013,Enero,Francia,250,2,6,8,"(10.886611,-74.776708)"
2012,Abril,Estados Unidos de América,840,3,18,21,"(12.5744111,-81.703935)"
2014,Octubre,Nicaragua,558,2,9,11,"(3.541112,-76.384584)"
2013,Julio,Estados Unidos de América,840,361,591,952,"(10.886611,-74.776708)"
2022,Julio,Polonia,616,0,1,1,"(11.117806,-74.232622)"
2018,Mayo,Zimbabue,716,0,1,1,"(10.445761,-75.516429)"
2022,Marzo,Venezuela,862,0,7,7,"(3.893038,-77.067921)"
2014,Diciembre,Cuba,192,1,1,2,"(12.586067,-81.702563)"
2014,Junio,Brasil,76,8,10,18,"(7.818934,-72.453226)"
2015,Febrero,Alemania,276,3,2,5,"(11.247723,-74.213989)"
2017,Abril,Austria,40,4,2,6,"(-4.223468,-69.945098)"
2016,Septiembre,Cuba,192,0,5,5,"(10.408582,-75.538003)"
2017,Mayo,Perú,604,215,145,360,"(12.586067,-81.702563)"
2018,Marzo,Suecia,752,9,10,19,"(0.814836,-77.662532)"
2019,Enero,Brasil,76,2,4,6,"(11.360009,-72.129330)"
2022,Marzo,Suiza,756,4,6,10,"(10.886611,-74.776708)"
2016,Septiembre,Estados Unidos de América,840,0,1,1,"(8.36068,-72.409396)"
2019,Junio,Argentina,32,345,202,547,"(10.408582,-75.538003)"
2012,Mayo,Argentina,32,5,22,27,"(10.886611,-74.776708)"
2021,Marzo,Costa Rica,188,1,1,2,"(7.128456,-73.183637)"
2016,Octubre,Jamaica,388,3,10,13,"(10.445761,-75.516429)"
2014,Octubre,Suecia,752,5,4,9,"(10.408582,-75.538003)"
2020,Febrero,Reino Unido de Gran Bretaña e Irlanda del Norte,826,1494,2422,3917,"(4.697144,-74.140516)"
2013,Agosto,España,724,7,16,23,"(11.360009,-72.129330)"
2016,Noviembre,Bolivia,68,60,96,156,"(6.171601,-75.427454)"
2021,Mayo,España,724,0,1,1,"(1.813928,-78.763924)"
2023,Enero,Reino Unido de Gran Bretaña e Irlanda del Norte,826,3,5,8,"(-4.197703,-69.941278)"
2021,Septiembre,Israel,376,2,8,10,"(0.814836,-77.662532)"
2023,Febrero,Australia,36,1,2,3,"(-4.197703,-69.941278)"
2013,Febrero,Croacia,191,1,2,3,"(0.814836,-77.662532)"
2012,Enero,Perú,604,2,1,3,"(7.927209,-72.507910)"
2020,Marzo,Myanmar,104,1,0,1,"(4.697144,-74.140516)"
2020,Marzo,Eslovenia,705,0,1,1,"(6.171601,-75.427454)"
2014,Junio,Alemania,276,5,5,10,"(11.360009,-72.129330)"
2013,Mayo,Ecuador,218,2,8,10,"(10.886611,-74.776708)"
2012,Agosto,Reino Unido de Gran Bretaña e Irlanda del Norte,826,13,24,37,"(10.408582,-75.538003)"
2021,Diciembre,Panamá,591,5,16,21,"(8.635765,-77.346578)"
2022,Mayo,Nueva Zelanda,554,1,2,3,"(0.814836,-77.662532)"
2020,Julio,Paraguay,600,0,3,3,"(-4.197703,-69.941278)"
2016,Septiembre,Venezuela,862,4554,5509,10063,"(11.360009,-72.129330)"
2018,Noviembre,Trinidad y Tobago,780,1,2,3,"(10.886611,-74.776708)"
2022,Mayo,Sri Lanka,144,0,7,7,"(3.893038,-77.067921)"
2016,Mayo,República Checa,203,0,2,2,"(8.635765,-77.346578)"
2018,Junio,Haití,332,0,3,3,"(10.408582,-75.538003)"
2018,Febrero,Croacia,191,22,46,68,"(4.697144,-74.140516)"
2019,Septiembre,Argentina,32,253,192,445,"(12.586067,-81.702563)"
2022,Julio,Venezuela,862,0,1,1,"(11.247723,-74.213989)"
2017,Diciembre,Bahamas,44,1,2,3,"(10.445761,-75.516429)"
2017,Octubre,Venezuela,862,6608,7247,13855,"(11.360009,-72.129330)"
2014,Octubre,Mauricio,480,0,1,1,"(4.697144,-74.140516)"
2016,Abril,Alemania,276,5,4,9,"(0.25129,-76.875963)"
2023,Enero,Islas Caimán/Territorio Británico de Ultramar,136,2,0,2,"(10.445761,-75.516429)"
2021,Agosto,China,156,0,4,4,"(10.971302,-74.765397)"
2017,Mayo,Brasil,76,172,249,421,"(6.171601,-75.427454)"
2017,Mayo,Bahamas,44,7,8,15,"(4.697144,-74.140516)"
2012,Julio,Francia,250,1483,2272,3755,"(4.697144,-74.140516)"
2018,Marzo,España,724,3,7,10,"(4.815061,-75.736532)"
2020,Noviembre,San  Vicente y las Granadinas,670,0,1,1,"(10.445761,-75.516429)"
2019,Julio,Madagascar,450,1,1,2,"(4.697144,-74.140516)"
2017,Noviembre,Países Bajos,528,3,4,7,"(-4.197703,-69.941278)"
2019,Mayo,Granada,308,0,1,1,"(10.445761,-75.516429)"
2020,Octubre,Perú,604,7,9,16,"(3.541112,-76.384584)"
2023,Abril,Israel,376,2,3,5,"(4.452882,-75.766298)"
2012,Marzo,Guyana,328,0,7,7,"(10.971302,-74.765397)"
2021,Noviembre,Tanzania,834,0,1,1,"(6.171601,-75.427454)"
2015,Mayo,Suecia,752,1,1,2,"(12.586067,-81.702563)"
2023,Abril,Uruguay,858,10,17,27,"(3.541112,-76.384584)"
2017,Febrero,Cuba,192,0,4,4,"(0.814836,-77.662532)"
2023,Abril,India,356,0,53,53,"(11.247723,-74.213989)"
2022,Febrero,Sudán,736,0,1,1,"(4.697144,-74.140516)"
2013,Septiembre,India,356,0,1,1,"(4.815061,-75.736532)"
2022,Agosto,Bulgaria,100,1,0,1,"(4.815061,-75.736532)"
2019,Julio,Portugal,620,7,7,14,"(11.360009,-72.129330)"
2013,Febrero,Venezuela,862,6,25,31,"(4.815061,-75.736532)"
2018,Enero,Filipinas,608,0,8,8,"(9.402978,-75.681599)"
2016,Enero,Cuba,192,0,1,1,"(0.25129,-76.875963)"
2022,Marzo,Suecia,752,0,1,1,"(4.452882,-75.766298)"
2017,Agosto,Bulgaria,100,1,0,1,"(4.452882,-75.766298)"
2022,Febrero,Países Bajos,528,1,0,1,"(7.927209,-72.507910)"
2019,Junio,Perú,604,54,70,124,"(7.818934,-72.453226)"
2018,Mayo,Croacia,191,0,1,1,"(3.541112,-76.384584)"
2017,Marzo,Sudáfrica,710,1,1,2,"(3.541112,-76.384584)"
2014,Noviembre,Paraguay,600,2,0,2,"(0.814836,-77.662532)"
2015,Abril,Suiza,756,2,9,11,"(10.886611,-74.776708)"
2015,Agosto,Brasil,76,25,37,62,"(7.818934,-72.453226)"
2021,Septiembre,Serbia,688,14,28,42,"(4.697144,-74.140516)"
2015,Marzo,Hong Kong,344,0,1,1,"(4.697144,-74.140516)"
2019,Enero,República Democrática Popular  Lao,418,1,0,1,"(4.697144,-74.140516)"
2023,Mayo,Rumania,642,1,2,3,"(11.360009,-72.129330)"
2018,Junio,Ecuador,218,17,11,28,"(12.586067,-81.702563)"
2018,Enero,Dinamarca,208,2,0,2,"(-4.223468,-69.945098)"
2014,Octubre,República de Kosovo,901,1,1,2,"(4.697144,-74.140516)"
2020,Julio,Polonia,616,1,0,1,"(4.697144,-74.140516)"
2022,Junio,Antigua y Barbuda,28,2,4,6,"(4.697144,-74.140516)"
2015,Mayo,Bélgica,56,0,1,1,"(10.886611,-74.776708)"
2014,Junio,Brasil,76,1,1,2,"(11.247723,-74.213989)"
2022,Mayo,Grecia,300,0,1,1,"(7.818934,-72.453226)"
2020,Febrero,República de Corea,410,0,4,4,"(7.818934,-72.453226)"
2014,Diciembre,Austria,40,4,11,15,"(3.541112,-76.384584)"
2023,Enero,Turquía,792,1,0,1,"(10.886611,-74.776708)"
2016,Noviembre,Belice,84,4,19,23,"(4.697144,-74.140516)"
2013,Agosto,Australia,36,26,27,53,"(0.814836,-77.662532)"
2017,Diciembre,Chile,152,110,162,272,"(0.814836,-77.662532)"
2021,Abril,Sudáfrica,710,0,1,1,"(10.886611,-74.776708)"
2017,Mayo,República Dominicana,214,0,1,1,"(4.452882,-75.766298)"
2022,Abril,Dinamarca,208,25,24,49,"(10.445761,-75.516429)"
2018,Septiembre,Canadá,124,18,30,48,"(4.815061,-75.736532)"
2013,Septiembre,Italia,380,3,0,3,"(7.927209,-72.507910)"
2019,Enero,Polonia,616,1,0,1,"(11.117806,-74.232622)"
2018,Octubre,Eslovenia,705,1,0,1,"(0.25129,-76.875963)"
2019,Abril,Francia,250,237,336,573,"(6.171601,-75.427454)"
2016,Agosto,Argentina,32,9,26,35,"(7.818934,-72.453226)"
2019,Marzo,Brasil,76,2,2,4,"(11.360009,-72.129330)"
2017,Marzo,Alemania,276,32,22,54,"(8.635765,-77.346578)"
2015,Noviembre,Irán,364,0,1,1,"(10.445761,-75.516429)"
2013,Septiembre,Estados Unidos de América,840,0,4,4,"(11.247723,-74.213989)"
2013,Noviembre,Canadá,124,5,7,12,"(4.815061,-75.736532)"
2019,Enero,España,724,3,12,15,"(11.360009,-72.129330)"
2013,Julio,Dominica,212,0,4,4,"(4.697144,-74.140516)"
2017,Noviembre,Lituania,440,18,22,40,"(4.697144,-74.140516)"
2018,Marzo,Filipinas,608,0,13,13,"(9.402978,-75.681599)"
2015,Diciembre,Uruguay,858,9,2,11,"(10.408582,-75.538003)"
2014,Diciembre,Venezuela,862,0,6,6,"(11.117806,-74.232622)"
2017,Enero,Egipto,818,0,1,1,"(8.635765,-77.346578)"
2014,Julio,Polonia,616,1,0,1,"(13.3387613,-81.372937)"
2013,Noviembre,Senegal,686,0,2,2,"(4.697144,-74.140516)"
2019,Marzo,Brasil,76,0,1,1,"(7.818934,-72.453226)"
2014,Abril,Taiwán,158,1,0,1,"(7.128456,-73.183637)"
2022,Marzo,Trinidad y Tobago,780,0,1,1,"(10.408582,-75.538003)"
2019,Diciembre,Filipinas,608,1,9,10,"(3.541112,-76.384584)"
2022,Marzo,Bosnia y Herzegovina,70,3,2,5,"(6.171601,-75.427454)"
2017,Diciembre,República Checa,203,5,9,14,"(6.171601,-75.427454)"
2019,Octubre,Bélgica,56,0,8,8,"(10.886611,-74.776708)"
2021,Diciembre,Vietnam,704,5,4,9,"(4.697144,-74.140516)"
2018,Julio,Chile,152,0,3,3,"(10.971302,-74.765397)"
2016,Junio,Noruega,578,1,1,2,"(11.247723,-74.213989)"
2020,Febrero,México,484,3,13,16,"(4.815061,-75.736532)"
2015,Junio,Costa Rica,188,3,2,5,"(10.408582,-75.538003)"
2014,Agosto,Santa Lucia,662,3,7,10,"(4.697144,-74.140516)"
2012,Abril,Países Bajos,528,14,6,20,"(0.814836,-77.662532)"
2016,Mayo,Reino Unido de Gran Bretaña e Irlanda del Norte,826,122,258,380,"(6.171601,-75.427454)"
2020,Enero,Eslovaquia,703,0,1,1,"(-4.223468,-69.945098)"
2013,Diciembre,Israel,376,0,5,5,"(10.886611,-74.776708)"
2016,Septiembre,Nicaragua,558,1,0,1,"(4.815061,-75.736532)"
2015,Noviembre,República Dominicana,214,0,1,1,"(8.635765,-77.346578)"
2017,Mayo,Argentina,32,2,2,4,"(4.815061,-75.736532)"
2021,Julio,México,484,0,1,1,"(0.814836,-77.662532)"
2018,Agosto,México,484,9,9,18,"(7.128456,-73.183637)"
2023,Marzo,Azerbaiyán,31,1,0,1,"(0.814836,-77.662532)"
2018,Octubre,México,484,13,34,47,"(7.818934,-72.453226)"
2012,Septiembre,Israel,376,0,1,1,"(11.247723,-74.213989)"
2016,Marzo,Reino Unido de Gran Bretaña e Irlanda del Norte,826,233,207,440,"(10.408582,-75.538003)"
2017,Octubre,México,484,1,1,2,"(6.185799,-67.483929)"
2021,Abril,Alemania,276,275,510,785,"(4.697144,-74.140516)"
2014,Agosto,Malí,466,0,4,4,"(4.697144,-74.140516)"
2022,Mayo,Suecia,752,1,2,3,"(10.886611,-74.776708)"
2019,Junio,Mongolia,496,0,2,2,"(10.445761,-75.516429)"
2022,Diciembre,República Dominicana,214,1,3,4,"(7.818934,-72.453226)"
2020,Marzo,Costa Rica,188,4,9,13,"(10.886611,-74.776708)"
2012,Noviembre,Suiza,756,11,43,54,"(6.171601,-75.427454)"
2023,Mayo,Panamá,591,42,32,74,"(11.117806,-74.232622)"
2018,Diciembre,Argentina,32,1335,1148,2483,"(10.445761,-75.516429)"
2022,Noviembre,El Salvador,222,1,30,31,"(10.886611,-74.776708)"
2016,Septiembre,Bélgica,56,5,15,20,"(10.445761,-75.516429)"
2018,Diciembre,Panamá,591,4,13,17,"(8.635765,-77.346578)"
2021,Septiembre,Austria,40,0,1,1,"(4.815061,-75.736532)"
2016,Junio,Portugal,620,3,1,4,"(0.814836,-77.662532)"
2019,Julio,Dinamarca,208,3,0,3,"(10.408582,-75.538003)"
2022,Marzo,Reino Unido de Gran Bretaña e Irlanda del Norte,826,2,5,7,"(4.815061,-75.736532)"
2021,Junio,Grecia,300,1,0,1,"(7.916725,-72.462544)"
2012,Agosto,República Checa,203,0,2,2,"(11.360009,-72.129330)"
2021,Noviembre,Brasil,76,8,73,81,"(10.408582,-75.538003)"
2022,Septiembre,Reino Unido de Gran Bretaña e Irlanda del Norte,826,2,6,8,"(-4.197703,-69.941278)"
2016,Abril,Venezuela,862,0,1,1,"(8.635765,-77.346578)"
2022,Febrero,Países Bajos,528,1238,1706,2944,"(4.697144,-74.140516)"
2023,Febrero,Vietnam,704,0,7,7,"(3.893038,-77.067921)"
2022,Noviembre,Ecuador,218,479,432,911,"(6.171601,-75.427454)"
2015,Octubre,Nicaragua,558,10,9,19,"(10.445761,-75.516429)"
2022,Abril,Eslovaquia,703,2,6,8,"(10.445761,-75.516429)"
2016,Julio,Cuba,192,172,296,468,"(4.697144,-74.140516)"
2017,Mayo,Chile,152,2,2,4,"(-4.197703,-69.941278)"
2022,Abril,Trinidad y Tobago,780,0,32,32,"(11.247723,-74.213989)"
2013,Mayo,Cuba,192,3,8,11,"(10.445761,-75.516429)"
2019,Noviembre,Países Bajos,528,0,1,1,"(4.697144,-74.140516)"
2018,Septiembre,Santa Lucia,662,1,2,3,"(6.171601,-75.427454)"
2022,Octubre,República Checa,203,2,1,3,"(3.541112,-76.384584)"
2016,Noviembre,Madagascar,450,3,0,3,"(4.697144,-74.140516)"
2015,Noviembre,Austria,40,7,15,22,"(6.171601,-75.427454)"
2013,Febrero,Reino Unido de Gran Bretaña e Irlanda del Norte,826,0,1,1,"(7.818934,-72.453226)"
2015,Febrero,República de Irlanda,372,0,2,2,"(11.360009,-72.129330)"
2015,Mayo,Croacia,191,0,1,1,"(6.171601,-75.427454)"
2019,Noviembre,Estados Unidos de América,840,0,1,1,"(11.528919,-72.919681)"
2018,Diciembre,Federación de Rusia,643,1,7,8,"(10.408582,-75.538003)"
2012,Julio,Costa Rica,188,0,1,1,"(8.635765,-77.346578)"
2013,Abril,Isla de Man,833,2,0,2,"(4.452882,-75.766298)"
2019,Agosto,Dinamarca,208,67,141,208,"(4.697144,-74.140516)"
2012,Agosto,España,724,10,10,20,"(-4.197703,-69.941278)"
2013,Junio,Perú,604,2126,3122,5248,"(4.697144,-74.140516)"
2018,Noviembre,Croacia,191,0,4,4,"(3.541112,-76.384584)"
2019,Abril,Bélgica,56,0,3,3,"(12.586067,-81.702563)"
2016,Marzo,Panamá,591,1737,1892,3629,"(4.697144,-74.140516)"
2017,Septiembre,Lesoto,426,1,0,1,"(6.171601,-75.427454)"
2012,Abril,Reino Unido de Gran Bretaña e Irlanda del Norte,826,1,1,2,"(4.697144,-74.140516)"
2023,Mayo,España,724,2,3,5,"(4.452882,-75.766298)"
2013,Septiembre,Lituania,440,2,1,3,"(6.171601,-75.427454)"
2012,Septiembre,Finlandia,246,1,4,5,"(10.445761,-75.516429)"
2016,Mayo,Ecuador,218,2,2,4,"(4.815061,-75.736532)"
2013,Diciembre,Sri Lanka,144,1,0,1,"(3.541112,-76.384584)"
2022,Diciembre,España,724,0,1,1,"(3.866713,-67.927521)"
2014,Marzo,México,484,2,1,3,"(11.360009,-72.129330)"
2019,Octubre,Sudán,736,0,2,2,"(6.171601,-75.427454)"
2015,Febrero,Reino Unido de Gran Bretaña e Irlanda del Norte,826,1,1,2,"(0.25129,-76.875963)"
2015,Mayo,Australia,36,5,18,23,"(3.541112,-76.384584)"
2022,Mayo,Andorra,20,1,2,3,"(3.541112,-76.384584)"
2019,Noviembre,Israel,376,1,9,10,"(0.814836,-77.662532)"
2015,Julio,Perú,604,5,6,11,"(7.927209,-72.507910)"
2013,Julio,Portugal,620,4,18,22,"(3.541112,-76.384584)"
2018,Febrero,Kuwait,414,0,6,6,"(4.697144,-74.140516)"
2019,Febrero,Suecia,752,2,12,14,"(10.886611,-74.776708)"
2020,Marzo,Australia,36,2,1,3,"(4.815061,-75.736532)"
2019,Diciembre,Cuba,192,0,1,1,"(12.5744111,-81.703935)"
2015,Junio,Noruega,578,2,2,4,"(0.814836,-77.662532)"
2014,Junio,Iraq,368,0,1,1,"(4.697144,-74.140516)"
2013,Marzo,Bélgica,56,1,2,3,"(7.818934,-72.453226)"
2012,Marzo,Serbia,688,1,1,2,"(3.541112,-76.384584)"
2019,Enero,Ucrania,804,0,5,5,"(11.247723,-74.213989)"
2018,Octubre,México,484,3,3,6,"(12.586067,-81.702563)"
2022,Marzo,Letonia,428,6,4,10,"(10.445761,-75.516429)"
2019,Octubre,Nicaragua,558,0,1,1,"(11.360009,-72.129330)"
2012,Octubre,Grecia,300,0,1,1,"(8.635765,-77.346578)"
2014,Octubre,Bulgaria,100,0,2,2,"(7.818934,-72.453226)"
2014,Junio,Sudáfrica,710,0,1,1,"(3.541112,-76.384584)"
2018,Diciembre,Venezuela,862,5,4,9,"(12.586067,-81.702563)"
2022,Septiembre,Estados Unidos de América,840,4666,7575,12243,"(10.445761,-75.516429)"
2018,Junio,Uganda,800,0,1,1,"(1.813928,-78.763924)"
2017,Julio,Italia,380,1,0,1,"(6.185799,-67.483929)"
2016,Marzo,Sudáfrica,710,1,3,4,"(0.814836,-77.662532)"
2017,Julio,Suecia,752,1,1,2,"(-4.197703,-69.941278)"
2018,Abril,Portugal,620,32,38,70,"(3.541112,-76.384584)"
2017,Diciembre,España,724,11,39,50,"(10.886611,-74.776708)"
2017,Julio,Líbano,422,0,1,1,"(4.815061,-75.736532)"
2019,Agosto,Italia,380,16,30,46,"(0.814836,-77.662532)"
2013,Noviembre,Serbia,688,2,11,13,"(4.697144,-74.140516)"
2022,Junio,Guyana,328,0,1,1,"(12.586067,-81.702563)"
2019,Junio,Liberia,430,0,1,1,"(4.697144,-74.140516)"
2013,Diciembre,República Dominicana,214,0,1,1,"(4.452882,-75.766298)"
2023,Marzo,Granada,308,0,1,1,"(3.541112,-76.384584)"
2023,Mayo,Noruega,578,0,1,1,"(11.247723,-74.213989)"
2015,Agosto,China,156,0,4,4,"(0.814836,-77.662532)"
2019,Septiembre,Georgia,268,1,0,1,"(6.171601,-75.427454)"
2013,Septiembre,Brasil,76,1,0,1,"(7.128456,-73.183637)"
2022,Noviembre,Italia,380,46,57,103,"(7.818934,-72.453226)"
2012,Abril,República de Irlanda,372,7,7,14,"(10.445761,-75.516429)"
2022,Junio,Argentina,32,1,4,5,"(11.360009,-72.129330)"
2021,Diciembre,Estados Unidos de América,840,73,89,162,"(12.586067,-81.702563)"
2012,Octubre,Países Bajos,528,132,251,383,"(4.697144,-74.140516)"
2023,Enero,Argentina,32,0,1,1,"(8.36068,-72.409396)"
2016,Julio,Vietnam,704,1,1,2,"(6.171601,-75.427454)"
2019,Enero,Finlandia,246,2,14,16,"(3.541112,-76.384584)"
2012,Noviembre,Cuba,192,1,1,2,"(7.927209,-72.507910)"
2018,Enero,Italia,380,2,11,13,"(0.25129,-76.875963)"
2019,Junio,Federación de Rusia,643,0,1,1,"(11.360009,-72.129330)"
2019,Marzo,Austria,40,5,6,11,"(10.408582,-75.538003)"
2022,Mayo,México,484,0,2,2,"(12.586067,-81.702563)"
2018,Febrero,Polonia,616,0,2,2,"(10.886611,-74.776708)"
2022,Noviembre,Perú,604,97,58,155,"(-4.223468,-69.945098)"
2015,Octubre,Suecia,752,0,1,1,"(0.25129,-76.875963)"
2014,Junio,Brasil,76,242,197,439,"(12.586067,-81.702563)"
2018,Marzo,Nueva Zelanda,554,8,14,22,"(10.445761,-75.516429)"
2013,Diciembre,Argentina,32,108,210,318,"(6.171601,-75.427454)"
2020,Septiembre,Honduras,340,0,1,1,"(3.541112,-76.384584)"
2012,Abril,Federación de Rusia,643,1,2,3,"(0.814836,-77.662532)"
2016,Agosto,India,356,0,1,1,"(4.452882,-75.766298)"
2021,Febrero,Guatemala,320,4,10,15,"(3.541112,-76.384584)"
2012,Mayo,Austria,40,0,1,1,"(12.5744111,-81.703935)"
2013,Junio,Isla de Man,833,18,37,55,"(6.171601,-75.427454)"
2015,Noviembre,Turquía,792,0,5,5,"(10.408582,-75.538003)"
2016,Septiembre,Argentina,32,1,2,3,"(4.452882,-75.766298)"
2015,Agosto,Países Bajos,528,8,11,19,"(10.408582,-75.538003)"
2016,Abril,Guatemala,320,308,673,981,"(4.697144,-74.140516)"
2013,Julio,Alemania,276,4,3,7,"(7.128456,-73.183637)"
2021,Noviembre,Sri Lanka,144,0,3,3,"(10.886611,-74.776708)"
2019,Septiembre,Bélgica,56,8,18,26,"(3.541112,-76.384584)"
2022,Noviembre,Antigua y Barbuda,28,4,2,6,"(6.171601,-75.427454)"
2013,Junio,Polonia,616,1,2,3,"(7.818934,-72.453226)"
2016,Abril,Hungría,348,2,2,4,"(10.445761,-75.516429)"
2014,Marzo,Países Bajos,528,21,21,42,"(0.814836,-77.662532)"
2019,Noviembre,Serbia,688,0,1,1,"(0.814836,-77.662532)"
2019,Marzo,Polonia,616,19,24,43,"(6.171601,-75.427454)"
2019,Febrero,Polonia,616,7,7,14,"(4.815061,-75.736532)"
2017,Mayo,Eslovenia,705,1,1,2,"(10.408582,-75.538003)"
2023,Abril,Georgia,268,0,1,1,"(10.971302,-74.765397)"
2015,Marzo,Italia,380,0,1,1,"(0.25129,-76.875963)"
2012,Abril,Turquía,792,0,2,2,"(0.814836,-77.662532)"
2014,Febrero,Cuba,192,1,1,2,"(7.128456,-73.183637)"
2019,Enero,Finlandia,246,15,21,36,"(10.445761,-75.516429)"
2012,Abril,Ucrania,804,0,1,1,"(0.814836,-77.662532)"
2017,Noviembre,Costa Rica,188,68,43,111,"(12.586067,-81.702563)"
2015,Mayo,Sudáfrica,710,3,7,10,"(10.445761,-75.516429)"
2016,Marzo,México,484,9,21,30,"(10.408582,-75.538003)"
2016,Agosto,Uruguay,858,47,79,126,"(6.171601,-75.427454)"
2015,Agosto,Perú,604,0,2,2,"(6.185799,-67.483929)"
2014,Junio,Nicaragua,558,0,4,4,"(10.886611,-74.776708)"
2017,Febrero,Perú,604,3,3,6,"(7.128456,-73.183637)"
2018,Junio,Ucrania,804,4,4,8,"(6.171601,-75.427454)"
2019,Noviembre,Argentina,32,0,6,6,"(11.360009,-72.129330)"
2012,Octubre,República Árabe Siria,760,0,1,1,"(11.360009,-72.129330)"
2017,Enero,Países Bajos,528,1189,1618,2807,"(4.697144,-74.140516)"
2023,Junio,Rumania,642,11,20,31,"(6.171601,-75.427454)"
2016,Marzo,Vietnam,704,0,1,1,"(0.814836,-77.662532)"
2014,Diciembre,República Dominicana,214,2,5,7,"(7.128456,-73.183637)"
2012,Agosto,Ecuador,218,0,1,1,"(4.815061,-75.736532)"
2015,Julio,Portugal,620,7,22,29,"(3.541112,-76.384584)"
2016,Noviembre,Alemania,276,1,6,7,"(4.815061,-75.736532)"
2018,Enero,Federación de Rusia,643,1,1,2,"(13.3387613,-81.372937)"
2017,Julio,Ucrania,804,1,0,1,"(0.814836,-77.662532)"
2013,Diciembre,Japón,392,0,1,1,"(11.360009,-72.129330)"
2019,Noviembre,Bulgaria,100,1,0,1,"(4.815061,-75.736532)"
2017,Enero,Líbano,422,0,1,1,"(8.36068,-72.409396)"
2013,Febrero,Nigeria,566,0,1,1,"(10.445761,-75.516429)"
2022,Diciembre,Uruguay,858,52,96,148,"(6.171601,-75.427454)"
2017,Febrero,Hungría,348,1,0,1,"(11.360009,-72.129330)"
2018,Enero,Canadá,124,0,5,5,"(12.5744111,-81.703935)"
2016,Enero,República de Irlanda,372,4,2,6,"(10.886611,-74.776708)"
2017,Abril,Italia,380,141,195,336,"(10.445761,-75.516429)"
2013,Noviembre,Canadá,124,1,5,6,"(4.452882,-75.766298)"
2017,Enero,Turquía,792,0,1,1,"(11.360009,-72.129330)"
2014,Enero,Estados Unidos de América,840,0,1,1,"(10.971302,-74.765397)"
2022,Septiembre,Australia,36,22,30,52,"(10.445761,-75.516429)"
2021,Septiembre,San Cristóbal y Nevis,659,1,2,3,"(3.541112,-76.384584)"
2013,Noviembre,Países Bajos,528,1,2,3,"(10.445761,-75.516429)"
2023,Enero,Irán,364,0,1,1,"(4.815061,-75.736532)"
2022,Febrero,Venezuela,862,6,3,9,"(3.866713,-67.927521)"
2014,Julio,Tailandia,764,7,6,13,"(4.697144,-74.140516)"
2017,Abril,Argentina,32,183,129,312,"(12.586067,-81.702563)"
2014,Septiembre,Rumania,642,2,2,4,"(11.360009,-72.129330)"
2017,Noviembre,República Dominicana,214,142,180,322,"(6.171601,-75.427454)"
2015,Marzo,Japón,392,6,12,18,"(10.445761,-75.516429)"
2016,Mayo,República Checa,203,54,74,128,"(4.697144,-74.140516)"
2017,Abril,España,724,2853,5279,8132,"(4.697144,-74.140516)"
2017,Mayo,Surinam,740,8,40,48,"(4.697144,-74.140516)"
2016,Febrero,Ecuador,218,30,21,51,"(12.586067,-81.702563)"
2018,Abril,Bolivia,68,1,0,1,"(0.812436,-77.847006)"
2023,Enero,Alemania,276,0,3,3,"(10.971302,-74.765397)"
2013,Enero,Guatemala,320,0,1,1,"(10.408582,-75.538003)"
2014,Marzo,Kuwait,414,0,1,1,"(4.697144,-74.140516)"
2018,Marzo,Reino Unido de Gran Bretaña e Irlanda del Norte,826,1,0,1,"(6.185799,-67.483929)"
2015,Abril,Croacia,191,1,1,2,"(6.171601,-75.427454)"
2016,Noviembre,Francia,250,2,4,6,"(12.586067,-81.702563)"
2016,Noviembre,Polonia,616,0,1,1,"(10.971302,-74.765397)"
2016,Enero,Polonia,616,2,1,3,"(10.886611,-74.776708)"
2019,Agosto,República Dominicana,214,0,1,1,"(-4.197703,-69.941278)"
2022,Octubre,Mauritania,478,0,1,1,"(3.541112,-76.384584)"
2012,Septiembre,Camerún,120,1,0,1,"(0.814836,-77.662532)"
2016,Junio,Tanzania,834,1,2,3,"(4.697144,-74.140516)"
2023,Febrero,Barbados,52,8,11,19,"(4.697144,-74.140516)"
2018,Agosto,Finlandia,246,33,48,81,"(4.697144,-74.140516)"
2022,Junio,Alemania,276,0,3,3,"(12.586067,-81.702563)"
2022,Julio,China,156,0,1,1,"(10.408582,-75.538003)"
2016,Mayo,Bangladesh,50,1,1,2,"(4.697144,-74.140516)"
2019,Mayo,Suecia,752,0,1,1,"(8.635765,-77.346578)"
2012,Abril,Cuba,192,13,31,44,"(6.171601,-75.427454)"
2020,Enero,Finlandia,246,1,2,3,"(12.586067,-81.702563)"
2021,Noviembre,República de Irlanda,372,0,2,2,"(4.815061,-75.736532)"
2012,Junio,Camerún,120,1,0,1,"(10.445761,-75.516429)"
2012,Abril,Rumania,642,2,0,2,"(0.814836,-77.662532)"
2022,Marzo,Noruega,578,0,1,1,"(4.452882,-75.766298)"
2017,Diciembre,Italia,380,1,2,3,"(8.635765,-77.346578)"
2017,Septiembre,Federación de Rusia,643,3,2,5,"(10.886611,-74.776708)"
2016,Marzo,Portugal,620,5,4,9,"(0.814836,-77.662532)"
2017,Marzo,República de Corea,410,4,33,37,"(6.171601,-75.427454)"
2018,Febrero,República de Corea,410,0,1,1,"(11.247723,-74.213989)"
2015,Septiembre,Costa Rica,188,4,15,19,"(10.886611,-74.776708)"
2022,Agosto,Sierra Leona,694,1,1,2,"(4.697144,-74.140516)"
2022,Mayo,Portugal,620,3,5,8,"(11.360009,-72.129330)"
2012,Enero,Cuba,192,0,1,1,"(4.452882,-75.766298)"
2022,Diciembre,México,484,2,0,2,"(0.25129,-76.875963)"
2012,Enero,Guatemala,320,0,1,1,"(0.814836,-77.662532)"
2019,Septiembre,Polonia,616,6,5,11,"(0.814836,-77.662532)"
2014,Noviembre,República de Irlanda,372,12,16,28,"(0.814836,-77.662532)"
2021,Diciembre,Belice,84,2,5,7,"(6.171601,-75.427454)"
2022,Julio,Turquía,792,1,5,6,"(3.541112,-76.384584)"
2021,Noviembre,Luxemburgo,442,1,0,1,"(4.815061,-75.736532)"
2015,Marzo,El Salvador,222,69,92,161,"(3.541112,-76.384584)"
2013,Noviembre,Argentina,32,11,23,34,"(11.360009,-72.129330)"
2012,Mayo,Reino Unido de Gran Bretaña e Irlanda del Norte,826,159,476,635,"(4.697144,-74.140516)"
2014,Abril,Emiratos Árabes,784,2,8,10,"(4.697144,-74.140516)"
2014,Marzo,Nicaragua,558,1,2,3,"(10.886611,-74.776708)"
2022,Diciembre,Cuba,192,5,13,18,"(10.445761,-75.516429)"
2017,Noviembre,Antigua y Barbuda,28,2,5,7,"(4.697144,-74.140516)"
2021,Junio,Honduras,340,30,31,61,"(3.541112,-76.384584)"
2022,Enero,Australia,36,61,209,270,"(4.697144,-74.140516)"
2012,Abril,Países Bajos,528,1,1,2,"(7.927209,-72.507910)"
2019,Mayo,Bolivia,68,1,0,1,"(8.36068,-72.409396)"
2016,Enero,Reino Unido de Gran Bretaña e Irlanda del Norte,826,3,3,6,"(0.25129,-76.875963)"
2012,Abril,Bulgaria,100,0,1,1,"(10.445761,-75.516429)"
2019,Febrero,Trinidad y Tobago,780,1,7,8,"(6.171601,-75.427454)"
2012,Julio,Nicaragua,558,0,1,1,"(12.5744111,-81.703935)"
2016,Marzo,República de Corea,410,3,1,4,"(4.815061,-75.736532)"
2014,Febrero,Lituania,440,0,1,1,"(11.360009,-72.129330)"
2013,Julio,India,356,1,10,11,"(10.445761,-75.516429)"
2021,Enero,Israel,376,4,50,54,"(6.171601,-75.427454)"
2013,Septiembre,Perú,604,15,9,24,"(10.408582,-75.538003)"
2012,Abril,Dinamarca,208,1,0,1,"(10.886611,-74.776708)"
2022,Abril,República Dominicana,214,0,3,3,"(4.452882,-75.766298)"
2020,Marzo,Alemania,276,1,1,2,"(12.586067,-81.702563)"
2014,Diciembre,Sudáfrica,710,30,48,78,"(4.697144,-74.140516)"
2015,Junio,Turquía,792,0,1,1,"(10.408582,-75.538003)"
2013,Septiembre,España,724,4,25,29,"(7.818934,-72.453226)"
2019,Abril,Cuba,192,22,25,47,"(6.171601,-75.427454)"
2017,Agosto,República de Irlanda,372,10,8,18,"(0.814836,-77.662532)"
2016,Junio,Cuba,192,2,3,5,"(0.814836,-77.662532)"
2015,Noviembre,Austria,40,126,276,402,"(4.697144,-74.140516)"
2013,Diciembre,Australia,36,4,12,16,"(10.886611,-74.776708)"
2022,Febrero,República Dominicana,214,75,82,157,"(3.541112,-76.384584)"
2019,Noviembre,Canadá,124,0,2,2,"(11.360009,-72.129330)"
2023,Abril,Estados Unidos de América,840,7636,9893,17529,"(10.445761,-75.516429)"
2022,Julio,Bélgica,56,0,1,1,"(11.360009,-72.129330)"
2020,Enero,El Salvador,222,21,41,63,"(6.171601,-75.427454)"
2017,Mayo,Australia,36,1,2,3,"(0.25129,-76.875963)"
2014,Junio,Italia,380,8,16,24,"(7.818934,-72.453226)"
2013,Noviembre,China,156,1,0,1,"(11.360009,-72.129330)"
2018,Junio,Federación de Rusia,643,0,1,1,"(-4.223468,-69.945098)"
2022,Abril,Islandia,352,2,2,4,"(10.445761,-75.516429)"
2017,Marzo,El Salvador,222,0,2,2,"(7.088729,-70.740253)"
2016,Marzo,Venezuela,862,9,13,22,"(7.128456,-73.183637)"
2012,Octubre,República Dominicana,214,0,1,1,"(12.586067,-81.702563)"
2017,Febrero,Canadá,124,1,2,3,"(13.3387613,-81.372937)"
2019,Septiembre,Bulgaria,100,2,0,2,"(3.541112,-76.384584)"
2013,Septiembre,Chile,152,1,2,3,"(7.128456,-73.183637)"
2013,Noviembre,Dinamarca,208,5,10,15,"(6.171601,-75.427454)"
2022,Febrero,Paraguay,600,1,3,4,"(7.927209,-72.507910)"
2018,Marzo,Dominica,212,1,1,2,"(10.445761,-75.516429)"
2021,Junio,Bulgaria,100,0,4,4,"(6.171601,-75.427454)"
2016,Agosto,Alemania,276,2,4,6,"(0.25129,-76.875963)"
2022,Noviembre,Reino Unido de Gran Bretaña e Irlanda del Norte,826,4,12,16,"(-4.197703,-69.941278)"
2012,Diciembre,Finlandia,246,55,90,145,"(4.697144,-74.140516)"
2022,Septiembre,Argentina,32,5,11,16,"(4.815061,-75.736532)"
2016,Octubre,Estados Unidos de América,840,5,9,14,"(11.247723,-74.213989)"
2017,Junio,Panamá,591,1498,1625,3123,"(4.697144,-74.140516)"
2022,Diciembre,República de Irlanda,372,2,5,7,"(10.886611,-74.776708)"
2022,Junio,Polonia,616,4,1,5,"(0.814836,-77.662532)"
2016,Febrero,Pakistán,586,0,1,1,"(0.814836,-77.662532)"
2016,Febrero,Francia,250,1,1,2,"(10.971302,-74.765397)"
2019,Noviembre,Nicaragua,558,2,1,3,"(7.128456,-73.183637)"
2012,Octubre,Honduras,340,1,2,3,"(4.815061,-75.736532)"
2014,Octubre,Panamá,591,4,7,11,"(7.927209,-72.507910)"
2012,Marzo,Argentina,32,14,49,63,"(7.818934,-72.453226)"
2016,Enero,Filipinas,608,1,5,6,"(6.171601,-75.427454)"
2019,Febrero,Chipre,196,0,1,1,"(6.171601,-75.427454)"
2013,Diciembre,Noruega,578,0,2,2,"(10.971302,-74.765397)"
2021,Junio,Montenegro,499,1,0,1,"(4.697144,-74.140516)"
2019,Junio,Costa Rica,188,0,2,2,"(11.117806,-74.232622)"
2012,Agosto,Sudáfrica,710,0,5,5,"(8.635765,-77.346578)"
2018,Septiembre,Uruguay,858,3,8,11,"(7.818934,-72.453226)"
2018,Septiembre,Venezuela,862,11,16,27,"(7.128456,-73.183637)"
2017,Agosto,Trinidad y Tobago,780,6,15,21,"(6.171601,-75.427454)"
2019,Octubre,Panamá,591,7,8,15,"(7.102626,-77.762647)"
2012,Octubre,Suecia,752,115,229,344,"(4.697144,-74.140516)"
2015,Abril,Francia,250,1,2,3,"(8.635765,-77.346578)"
2019,Noviembre,Bulgaria,100,0,1,1,"(8.635765,-77.346578)"
2023,Junio,México,484,138,135,273,"(10.886611,-74.776708)"
2017,Septiembre,Malasia,458,1,1,2,"(3.541112,-76.384584)"
2014,Mayo,Suiza,756,5,19,24,"(3.541112,-76.384584)"
2016,Mayo,Ucrania,804,0,1,1,"(10.971302,-74.765397)"
2023,Junio,China,156,1,2,3,"(11.360009,-72.129330)"
2013,Julio,Suiza,756,3,5,8,"(10.886611,-74.776708)"
2019,Enero,Egipto,818,1,1,2,"(6.171601,-75.427454)"
2015,Enero,Alemania,276,9,10,19,"(11.360009,-72.129330)"
2021,Abril,Perú,604,1,5,6,"(-4.223468,-69.945098)"
2022,Marzo,Uganda,800,1,0,1,"(4.697144,-74.140516)"
2019,Febrero,México,484,3765,6950,10715,"(4.697144,-74.140516)"
2016,Agosto,Nicaragua,558,20,14,34,"(10.445761,-75.516429)"
2020,Febrero,Singapur,702,0,1,1,"(6.171601,-75.427454)"
2019,Junio,El Salvador,222,7,3,10,"(12.586067,-81.702563)"
2014,Diciembre,Perú,604,36,26,62,"(-4.197703,-69.941278)"
2014,Abril,Santa Sede/Ciudad del Vaticano,336,0,1,1,"(4.697144,-74.140516)"
2018,Agosto,Chile,152,550,366,916,"(10.445761,-75.516429)"
2019,Septiembre,Bermudas/Territorio Británico de Ultramar,60,0,1,1,"(3.541112,-76.384584)"
2017,Marzo,Grecia,300,0,1,1,"(0.25129,-76.875963)"
2023,Mayo,Filipinas,608,7,91,98,"(10.445761,-75.516429)"
2016,Diciembre,Grecia,300,1,5,6,"(10.445761,-75.516429)"
2017,Junio,Brasil,76,0,1,1,"(0.25129,-76.875963)"
2019,Marzo,Bahamas,44,5,6,11,"(6.171601,-75.427454)"
2018,Septiembre,Tailandia,764,0,2,2,"(10.445761,-75.516429)"
2015,Marzo,Finlandia,246,5,1,6,"(0.814836,-77.662532)"
2013,Julio,Venezuela,862,0,1,1,"(0.25129,-76.875963)"
2019,Marzo,Perú,604,8,34,42,"(10.886611,-74.776708)"
2023,Marzo,Luxemburgo,442,3,1,4,"(6.171601,-75.427454)"
2022,Abril,Ecuador,218,11,20,31,"(7.818934,-72.453226)"
2017,Noviembre,Federación de Rusia,643,3,1,4,"(0.814836,-77.662532)"
2014,Julio,Barbados,52,0,1,1,"(6.171601,-75.427454)"
2018,Abril,Guatemala,320,14,10,24,"(12.586067,-81.702563)"
2012,Agosto,Costa Rica,188,0,1,1,"(11.360009,-72.129330)"
2019,Junio,Jordania,400,3,6,9,"(4.697144,-74.140516)"
2016,Mayo,Guatemala,320,24,35,59,"(12.586067,-81.702563)"
2018,Enero,Reino Unido de Gran Bretaña e Irlanda del Norte,826,4,1,5,"(11.360009,-72.129330)"
2015,Julio,Federación de Rusia,643,0,2,2,"(4.815061,-75.736532)"
2022,Enero,Ecuador,218,1,1,2,"(8.36068,-72.409396)"
2020,Enero,Australia,36,0,2,2,"(11.360009,-72.129330)"
2018,Enero,Suiza,756,31,51,82,"(3.541112,-76.384584)"
2015,Mayo,Países Bajos,528,1,1,2,"(-4.197703,-69.941278)"
2012,Noviembre,Territorio Antártico Británico/Territorio Británico de Ultramar,260,0,4,4,"(4.697144,-74.140516)"
2013,Octubre,Argentina,32,0,3,3,"(0.25129,-76.875963)"
2014,Enero,Argentina,32,1,5,6,"(0.25129,-76.875963)"
2018,Febrero,Federación de Rusia,643,2,0,2,"(8.635765,-77.346578)"
2016,Septiembre,Perú,604,0,2,2,"(8.635765,-77.346578)"
2020,Marzo,Israel,376,69,169,238,"(4.697144,-74.140516)"
2018,Febrero,Brasil,76,145,119,264,"(-4.197703,-69.941278)"
2017,Julio,Marruecos,504,0,1,1,"(3.541112,-76.384584)"
2016,Junio,Kazajistán,398,21,11,32,"(4.697144,-74.140516)"
2014,Diciembre,Trinidad y Tobago,780,0,2,2,"(7.927209,-72.507910)"
2013,Julio,Tíbet/Región Autónoma de China,99999,2,1,3,"(4.697144,-74.140516)"
2017,Septiembre,Venezuela,862,6568,6624,13192,"(4.697144,-74.140516)"
2014,Marzo,Panamá,591,3,11,14,"(7.128456,-73.183637)"
2018,Abril,Taiwán,158,3,0,3,"(0.814836,-77.662532)"
2017,Febrero,República Dominicana,214,0,1,1,"(4.452882,-75.766298)"
2018,Marzo,Bélgica,56,1,1,2,"(-4.197703,-69.941278)"
2020,Febrero,Dinamarca,208,2,6,8,"(10.886611,-74.776708)"
2019,Diciembre,Guyana,328,3,4,7,"(3.541112,-76.384584)"
2015,Mayo,Islas Caimán/Territorio Británico de Ultramar,136,1,0,1,"(10.886611,-74.776708)"
2015,Abril,Ucrania,804,0,8,8,"(10.408582,-75.538003)"
2012,Diciembre,Costa Rica,188,40,55,95,"(3.541112,-76.384584)"
2014,Octubre,Egipto,818,1,4,5,"(10.445761,-75.516429)"
2017,Septiembre,Ecuador,218,64,64,128,"(10.408582,-75.538003)"
2016,Enero,Brasil,76,150,182,332,"(3.541112,-76.384584)"
2013,Julio,Ucrania,804,1,1,2,"(6.171601,-75.427454)"
2019,Febrero,Argentina,32,1,8,9,"(8.635765,-77.346578)"
2022,Octubre,San  Vicente y las Granadinas,670,1,4,5,"(4.697144,-74.140516)"
2017,Febrero,Indonesia,360,0,2,2,"(10.445761,-75.516429)"
2013,Agosto,Bélgica,56,126,266,392,"(4.697144,-74.140516)"
2014,Abril,Bangladesh,50,1,8,9,"(6.171601,-75.427454)"
2016,Mayo,Venezuela,862,189,204,393,"(7.927209,-72.507910)"
2013,Noviembre,Desconocido,99999,0,3,3,"(10.886611,-74.776708)"
2017,Julio,Italia,380,1,2,3,"(4.452882,-75.766298)"
2016,Marzo,Ghana,288,1,0,1,"(10.445761,-75.516429)"
2013,Agosto,República de Irlanda,372,2,1,3,"(3.541112,-76.384584)"
2015,Septiembre,Filipinas,608,2,50,52,"(10.408582,-75.538003)"
2021,Julio,Costa Rica,188,23,21,44,"(10.445761,-75.516429)"
2017,Septiembre,Polonia,616,8,16,24,"(10.445761,-75.516429)"
2016,Mayo,Canadá,124,2,6,8,"(-4.197703,-69.941278)"
2017,Enero,Eslovenia,705,0,2,2,"(6.171601,-75.427454)"
2022,Abril,Noruega,578,0,1,1,"(11.360009,-72.129330)"
2019,Febrero,Francia,250,4,7,11,"(0.25129,-76.875963)"
2012,Mayo,Panamá,591,37,87,124,"(10.886611,-74.776708)"
2017,Diciembre,Myanmar,104,2,0,2,"(6.171601,-75.427454)"
2015,Diciembre,Bolivia,68,49,40,89,"(10.445761,-75.516429)"
2022,Septiembre,Brasil,76,2,7,9,"(7.916725,-72.462544)"
2015,Mayo,Luxemburgo,442,4,8,12,"(4.697144,-74.140516)"
2019,Enero,India,356,15,3,18,"(0.814836,-77.662532)"
2013,Junio,Suecia,752,0,1,1,"(7.128456,-73.183637)"
2016,Julio,República Dominicana,214,26,32,58,"(3.541112,-76.384584)"
2015,Julio,Nueva Zelanda,554,8,6,14,"(10.408582,-75.538003)"
2015,Marzo,Portugal,620,9,11,20,"(10.445761,-75.516429)"
2021,Mayo,Costa Rica,188,166,236,402,"(4.697144,-74.140516)"
2013,Agosto,Japón,392,6,14,20,"(0.814836,-77.662532)"
2012,Octubre,Haití,332,0,1,1,"(10.886611,-74.776708)"
2018,Junio,Guatemala,320,12,16,28,"(10.886611,-74.776708)"
2017,Mayo,Australia,36,1,2,3,"(12.586067,-81.702563)"
2018,Julio,República de Irlanda,372,0,1,1,"(7.818934,-72.453226)"
2013,Febrero,Uruguay,858,5,12,17,"(0.814836,-77.662532)"
2020,Marzo,Israel,376,7,12,19,"(3.541112,-76.384584)"
2021,Agosto,Venezuela,862,269,258,527,"(10.886611,-74.776708)"
2016,Mayo,Reino Unido de Gran Bretaña e Irlanda del Norte,826,1,4,5,"(7.818934,-72.453226)"
2017,Septiembre,Polonia,616,0,1,1,"(11.247723,-74.213989)"
2019,Marzo,Croacia,191,1,1,2,"(8.635765,-77.346578)"
2018,Noviembre,Italia,380,0,1,1,"(4.16909,-73.612469)"
2022,Julio,República Dominicana,214,1,3,4,"(7.818934,-72.453226)"
2013,Junio,Uruguay,858,13,17,30,"(3.541112,-76.384584)"
2012,Septiembre,Japón,392,1,1,2,"(12.586067,-81.702563)"
2023,Marzo,Venezuela,862,7061,6632,13697,"(4.697144,-74.140516)"
2014,Julio,Costa Rica,188,0,1,1,"(-4.197703,-69.941278)"
2016,Agosto,Suecia,752,10,22,32,"(10.445761,-75.516429)"
2015,Octubre,Honduras,340,0,2,2,"(10.971302,-74.765397)"
2022,Mayo,Suecia,752,2,3,5,"(0.814836,-77.662532)"
2022,Agosto,Líbano,422,0,2,2,"(12.586067,-81.702563)"
2021,Agosto,Federación de Rusia,643,187,161,348,"(4.697144,-74.140516)"
2022,Abril,Islas Caimán/Territorio Británico de Ultramar,136,2,2,4,"(4.697144,-74.140516)"
2016,Noviembre,República de Kosovo,901,0,1,1,"(12.586067,-81.702563)"
2017,Septiembre,Malasia,458,0,4,4,"(10.408582,-75.538003)"
2012,Enero,Perú,604,1672,2545,4217,"(4.697144,-74.140516)"
2017,Agosto,Chile,152,2,3,5,"(0.25129,-76.875963)"
2022,Mayo,Ecuador,218,304,375,679,"(6.171601,-75.427454)"
2013,Diciembre,Bolivia,68,24,17,41,"(12.586067,-81.702563)"
2020,Junio,Alemania,276,0,1,1,"(10.408582,-75.538003)"
2013,Noviembre,Italia,380,5,6,11,"(10.408582,-75.538003)"
2018,Mayo,Francia,250,12,10,22,"(7.818934,-72.453226)"
2013,Noviembre,México,484,2656,5610,8266,"(4.697144,-74.140516)"
2015,Marzo,Bolivia,68,16,13,29,"(0.814836,-77.662532)"
2019,Marzo,Guatemala,320,2,1,3,"(0.814836,-77.662532)"
2019,Enero,Jamaica,388,1,4,5,"(10.886611,-74.776708)"
2022,Diciembre,San Cristóbal y Nevis,659,1,5,6,"(4.697144,-74.140516)"
2019,Noviembre,Singapur,702,21,49,70,"(4.697144,-74.140516)"
2023,Mayo,Bolivia,68,540,601,1141,"(4.697144,-74.140516)"
2019,Abril,Egipto,818,0,1,1,"(6.171601,-75.427454)"
2020,Octubre,Alemania,276,79,187,266,"(4.697144,-74.140516)"
2018,Junio,Rumania,642,9,9,18,"(6.171601,-75.427454)"
2018,Febrero,Argentina,32,1551,1181,2732,"(10.445761,-75.516429)"
2015,Enero,Pakistán,586,0,7,7,"(6.171601,-75.427454)"
2021,Diciembre,Antigua y Barbuda,28,0,3,3,"(3.541112,-76.384584)"
2023,Marzo,Nueva Zelanda,554,3,3,6,"(0.814836,-77.662532)"
2012,Septiembre,Venezuela,862,2,0,2,"(6.228046,-77.404104)"
2020,Diciembre,Brasil,76,22,28,50,"(-4.197703,-69.941278)"
2016,Febrero,Marruecos,504,1,0,1,"(10.408582,-75.538003)"
2015,Diciembre,Brasil,76,2,0,2,"(7.927209,-72.507910)"
2018,Agosto,Grecia,300,1,4,5,"(3.541112,-76.384584)"
2012,Enero,México,484,55,95,150,"(10.445761,-75.516429)"
2016,Noviembre,Brasil,76,1,2,3,"(8.635765,-77.346578)"
2019,Octubre,Chile,152,10,13,23,"(10.886611,-74.776708)"
2020,Marzo,Omán,512,0,1,1,"(6.171601,-75.427454)"
2017,Octubre,Indonesia,360,0,1,1,"(6.171601,-75.427454)"
2015,Diciembre,España,724,7,6,13,"(-4.197703,-69.941278)"
2016,Abril,Eslovaquia,703,0,1,1,"(11.247723,-74.213989)"
2020,Febrero,Mozambique,508,0,2,2,"(4.697144,-74.140516)"
2020,Noviembre,Perú,604,4,12,16,"(10.886611,-74.776708)"
2015,Febrero,Líbano,422,0,1,1,"(6.171601,-75.427454)"
2023,Enero,Ecuador,218,29,23,52,"(12.586067,-81.702563)"
2021,Marzo,Italia,380,1,0,1,"(11.117806,-74.232622)"
2013,Abril,Georgia,268,1,0,1,"(10.445761,-75.516429)"
2017,Agosto,Ecuador,218,3864,4228,8092,"(0.814836,-77.662532)"
2018,Febrero,Estados Unidos de América,840,52,95,147,"(0.814836,-77.662532)"
2014,Febrero,Alemania,276,5,9,14,"(11.360009,-72.129330)"
2016,Diciembre,Francia,250,0,2,2,"(7.128456,-73.183637)"
2016,Febrero,Malasia,458,0,1,1,"(3.541112,-76.384584)"
2019,Septiembre,Eslovaquia,703,0,1,1,"(4.815061,-75.736532)"
2016,Noviembre,San  Vicente y las Granadinas,670,1,0,1,"(10.408582,-75.538003)"
2018,Octubre,Filipinas,608,0,2,2,"(0.814836,-77.662532)"
2018,Enero,Aruba,533,1,0,1,"(7.128456,-73.183637)"
2019,Noviembre,República de Irlanda,372,3,6,9,"(8.635765,-77.346578)"
2018,Abril,Belice,84,0,1,1,"(10.445761,-75.516429)"
2023,Abril,Países Bajos,528,2,4,6,"(8.364293,-72.405710)"
2012,Septiembre,Bahamas,44,0,1,1,"(10.445761,-75.516429)"
2012,Julio,Francia,250,12,12,24,"(-4.197703,-69.941278)"
2021,Junio,República Árabe Siria,760,0,3,3,"(4.697144,-74.140516)"
2023,Junio,Ecuador,218,972,921,1893,"(6.171601,-75.427454)"
2022,Septiembre,Georgia,268,1,0,1,"(10.445761,-75.516429)"
2015,Diciembre,Chile,152,55,69,124,"(10.445761,-75.516429)"
2019,Junio,Canadá,124,236,492,728,"(6.171601,-75.427454)"
2013,Septiembre,República de Irlanda,372,5,5,10,"(0.814836,-77.662532)"
2019,Mayo,Panamá,591,1,1,2,"(7.102626,-77.762647)"
2023,Abril,México,484,8,26,34,"(0.814836,-77.662532)"
2018,Febrero,España,724,2,3,5,"(0.25129,-76.875963)"
2020,Marzo,Jamaica,388,0,1,1,"(12.586067,-81.702563)"
2019,Marzo,República Dominicana,214,5,2,7,"(7.128456,-73.183637)"
2017,Octubre,El Salvador,222,32,33,65,"(10.445761,-75.516429)"
2014,Marzo,Tanzania,834,1,0,1,"(6.171601,-75.427454)"
2022,Julio,Perú,604,1,5,6,"(8.36068,-72.409396)"
2012,Enero,Estados Unidos de América,840,0,1,1,"(6.228046,-77.404104)"
2012,Julio,China,156,2,0,2,"(10.445761,-75.516429)"
2015,Octubre,Cuba,192,3,5,8,"(0.814836,-77.662532)"
2017,Diciembre,Venezuela,862,25,28,53,"(6.185799,-67.483929)"
2017,Abril,República de Corea,410,0,1,1,"(7.818934,-72.453226)"
2014,Julio,Indonesia,360,0,4,4,"(10.408582,-75.538003)"
2022,Octubre,Barbados,52,6,5,11,"(6.171601,-75.427454)"
2015,Febrero,Estados Unidos de América,840,0,1,1,"(1.813928,-78.763924)"
2016,Noviembre,Países Bajos,528,2,7,9,"(8.635765,-77.346578)"
2014,Febrero,San Cristóbal y Nevis,659,0,1,1,"(6.171601,-75.427454)"
2016,Marzo,Canadá,124,362,355,717,"(10.445761,-75.516429)"
2022,Mayo,Reino Unido de Gran Bretaña e Irlanda del Norte,826,1,6,7,"(7.128456,-73.183637)"
2012,Mayo,Islas Vírgenes Británicas/Territorio Británico de Ultramar,92,0,1,1,"(4.697144,-74.140516)"
2023,Abril,Ecuador,218,22,25,47,"(8.364293,-72.405710)"
2013,Octubre,Francia,250,2,4,6,"(11.360009,-72.129330)"
2018,Abril,Italia,380,0,1,1,"(7.102626,-77.762647)"
2016,Noviembre,Zambia,894,1,3,4,"(4.697144,-74.140516)"
2015,Mayo,Panamá,591,104,187,291,"(10.445761,-75.516429)"
2014,Abril,Costa de Marfil,384,1,4,5,"(4.697144,-74.140516)"
2020,Enero,Malasia,458,0,1,1,"(0.814836,-77.662532)"
2022,Mayo,República de Irlanda,372,94,161,255,"(4.697144,-74.140516)"
2018,Enero,Alemania,276,19,15,34,"(-4.223468,-69.945098)"
2019,Marzo,Alemania,276,23,44,67,"(10.886611,-74.776708)"
2021,Abril,Malta,470,1,0,1,"(10.445761,-75.516429)"
2015,Julio,Nicaragua,558,40,78,118,"(4.697144,-74.140516)"
2015,Octubre,Ucrania,804,0,2,2,"(3.893038,-77.067921)"
2019,Abril,Lituania,440,0,2,2,"(3.541112,-76.384584)"
2012,Junio,Panamá,591,39,79,118,"(10.886611,-74.776708)"
2012,Agosto,Alemania,276,30,45,75,"(10.445761,-75.516429)"
2015,Julio,Micronesia,583,0,1,1,"(3.541112,-76.384584)"
2017,Mayo,Bosnia y Herzegovina,70,3,3,6,"(4.697144,-74.140516)"
2022,Octubre,Filipinas,608,13,8,21,"(6.171601,-75.427454)"
2021,Noviembre,Ucrania,804,0,6,6,"(10.971302,-74.765397)"
2017,Marzo,Nueva Zelanda,554,0,2,2,"(-4.223468,-69.945098)"
2012,Febrero,España,724,137,296,433,"(3.541112,-76.384584)"
2021,Mayo,Chipre,196,1,2,3,"(6.171601,-75.427454)"
2022,Agosto,Liechtenstein,438,0,4,4,"(4.697144,-74.140516)"
2013,Mayo,Suecia,752,0,1,1,"(7.128456,-73.183637)"
2019,Abril,Reino Unido de Gran Bretaña e Irlanda del Norte,826,0,3,3,"(11.117806,-74.232622)"
2015,Diciembre,Albania,8,0,1,1,"(3.541112,-76.384584)"
2023,Junio,Singapur,702,2,5,7,"(10.445761,-75.516429)"
2015,Agosto,Canadá,124,61,59,120,"(3.541112,-76.384584)"
2021,Diciembre,Irán,364,1,6,7,"(6.171601,-75.427454)"
2014,Abril,Cuba,192,28,65,93,"(3.541112,-76.384584)"
2016,Octubre,Malasia,458,1,1,2,"(10.445761,-75.516429)"
2018,Mayo,Lituania,440,16,15,31,"(4.697144,-74.140516)"
2021,Abril,Alemania,276,1,1,2,"(10.971302,-74.765397)"
2015,Octubre,Estados Unidos de América,840,24,27,51,"(12.586067,-81.702563)"
2019,Octubre,Tailandia,764,1,1,2,"(10.408582,-75.538003)"
2013,Marzo,Eslovaquia,703,2,0,2,"(13.3387613,-81.372937)"
2013,Febrero,Kenia,404,2,0,2,"(3.541112,-76.384584)"
2019,Diciembre,Belice,84,1,0,1,"(10.445761,-75.516429)"
2013,Marzo,Kazajistán,398,0,2,2,"(10.445761,-75.516429)"
2015,Noviembre,Países Bajos,528,0,1,1,"(7.927209,-72.507910)"
2019,Octubre,Ecuador,218,8,11,19,"(12.586067,-81.702563)"
2018,Enero,Canadá,124,1362,2136,3498,"(4.697144,-74.140516)"
2012,Septiembre,Filipinas,608,0,8,8,"(10.886611,-74.776708)"
2016,Agosto,Croacia,191,1,3,4,"(10.445761,-75.516429)"
2012,Agosto,Brasil,76,4,19,23,"(11.360009,-72.129330)"
2014,Enero,Senegal,686,1,0,1,"(4.697144,-74.140516)"
2017,Septiembre,Argentina,32,6,12,18,"(-4.197703,-69.941278)"
2014,Junio,Trinidad y Tobago,780,4,9,13,"(6.171601,-75.427454)"
2014,Agosto,Panamá,591,9,31,40,"(7.128456,-73.183637)"
2012,Octubre,República de Irlanda,372,10,9,19,"(0.814836,-77.662532)"
2013,Julio,Ecuador,218,6,119,125,"(1.813928,-78.763924)"
2022,Enero,Italia,380,0,2,2,"(11.247723,-74.213989)"
2015,Julio,República Democrática del Congo,180,0,2,2,"(7.818934,-72.453226)"
2012,Julio,Bahamas,44,2,1,3,"(6.171601,-75.427454)"
2017,Marzo,República Checa,203,39,54,93,"(10.445761,-75.516429)"
2015,Diciembre,Bolivia,68,49,42,91,"(3.541112,-76.384584)"
2014,Agosto,El Salvador,222,1,1,2,"(7.818934,-72.453226)"
2013,Mayo,Paraguay,600,8,15,23,"(6.171601,-75.427454)"
2018,Agosto,España,724,733,1044,1777,"(6.171601,-75.427454)"
2013,Junio,Bolivia,68,11,7,18,"(10.445761,-75.516429)"
2022,Septiembre,Albania,8,0,1,1,"(0.814836,-77.662532)"
2012,Abril,Países Bajos,528,381,708,1089,"(4.697144,-74.140516)"
2021,Septiembre,Letonia,428,1,1,2,"(10.886611,-74.776708)"
2012,Abril,Suiza,756,3,3,6,"(10.886611,-74.776708)"
2017,Noviembre,Estados Unidos de América,840,2,5,7,"(11.360009,-72.129330)"
2014,Julio,Estados Unidos de América,840,9,16,25,"(11.360009,-72.129330)"
2013,Marzo,Japón,392,6,26,32,"(6.171601,-75.427454)"
2013,Enero,Reino Unido de Gran Bretaña e Irlanda del Norte,826,15,50,65,"(6.171601,-75.427454)"
2016,Noviembre,El Salvador,222,0,2,2,"(7.088729,-70.740253)"
2016,Octubre,República de Irlanda,372,89,164,253,"(4.697144,-74.140516)"
2013,Agosto,Italia,380,10,21,31,"(0.814836,-77.662532)"
2023,Enero,Jordania,400,0,1,1,"(10.445761,-75.516429)"
2017,Junio,Finlandia,246,43,51,94,"(4.697144,-74.140516)"
2017,Mayo,México,484,0,2,2,"(11.247723,-74.213989)"
2019,Abril,Venezuela,862,1,0,1,"(4.452882,-75.766298)"
2022,Marzo,Líbano,422,1,2,3,"(10.445761,-75.516429)"
2012,Diciembre,Grecia,300,0,6,6,"(10.445761,-75.516429)"
2022,Junio,Federación de Rusia,643,0,20,20,"(3.893038,-77.067921)"
2023,Marzo,Italia,380,0,1,1,"(12.5744111,-81.703935)"
2016,Agosto,España,724,0,1,1,"(11.247723,-74.213989)"
2015,Enero,Camerún,120,2,0,2,"(4.697144,-74.140516)"
2014,Agosto,San  Vicente y las Granadinas,670,0,1,1,"(4.697144,-74.140516)"
2023,Mayo,Camerún,120,0,1,1,"(10.445761,-75.516429)"
2012,Noviembre,España,724,20,50,70,"(7.818934,-72.453226)"
2013,Abril,República Democrática del Congo,180,0,2,2,"(4.697144,-74.140516)"
2022,Septiembre,China,156,194,571,765,"(4.697144,-74.140516)"
2014,Marzo,Lituania,440,3,2,5,"(10.445761,-75.516429)"
2014,Mayo,Argentina,32,8,13,21,"(8.635765,-77.346578)"
2015,Agosto,Trinidad y Tobago,780,26,43,69,"(4.697144,-74.140516)"
2019,Octubre,México,484,1,4,5,"(4.452882,-75.766298)"
2017,Junio,Canadá,124,1,0,1,"(11.360009,-72.129330)"
2015,Enero,Turquía,792,0,1,1,"(7.818934,-72.453226)"
2015,Octubre,España,724,358,561,919,"(3.541112,-76.384584)"
2023,Junio,El Salvador,222,172,120,292,"(10.445761,-75.516429)"
2018,Marzo,Malawi,454,0,1,1,"(4.697144,-74.140516)"
2018,Diciembre,Países Bajos,528,3,4,7,"(0.25129,-76.875963)"
2022,Marzo,Francia,250,1752,2720,4473,"(4.697144,-74.140516)"
2013,Enero,Bolivia,68,38,34,72,"(0.814836,-77.662532)"
2019,Octubre,Turquía,792,0,5,5,"(3.541112,-76.384584)"
2013,Febrero,Estonia,233,0,1,1,"(3.541112,-76.384584)"
2018,Julio,República Dominicana,214,4,0,4,"(4.452882,-75.766298)"
2021,Abril,Panamá,591,134,141,275,"(10.445761,-75.516429)"
2012,Agosto,Bolivia,68,3,0,3,"(10.886611,-74.776708)"
2016,Noviembre,Costa Rica,188,25,55,80,"(3.541112,-76.384584)"
2023,Junio,Kenia,404,0,1,1,"(10.445761,-75.516429)"
2013,Marzo,República Dominicana,214,4,7,11,"(0.814836,-77.662532)"
2022,Noviembre,Cuba,192,1,0,1,"(0.25129,-76.875963)"
2015,Marzo,República Árabe de Yemen,887,1,3,4,"(4.697144,-74.140516)"
2015,Noviembre,Reino Unido de Gran Bretaña e Irlanda del Norte,826,1,1,2,"(-4.223468,-69.945098)"
2022,Julio,Bolivia,68,1,1,2,"(12.586067,-81.702563)"
2023,Abril,Hungría,348,0,1,1,"(11.360009,-72.129330)"
2021,Abril,Cuba,192,4,15,19,"(10.445761,-75.516429)"
2013,Febrero,Chipre,196,0,5,5,"(4.697144,-74.140516)"
2022,Junio,Países Bajos,528,1,5,6,"(4.815061,-75.736532)"
2022,Septiembre,Nueva Zelanda,554,3,3,6,"(3.541112,-76.384584)"
2016,Junio,Guatemala,320,4,4,8,"(4.815061,-75.736532)"
2018,Agosto,Bolivia,68,144,121,267,"(10.445761,-75.516429)"
2022,Febrero,Brasil,76,1,0,1,"(7.916725,-72.462544)"
2019,Marzo,Venezuela,862,2,2,4,"(-4.197703,-69.941278)"
2018,Marzo,Paraguay,600,0,1,1,"(7.818934,-72.453226)"
2021,Agosto,Ecuador,218,0,50,50,"(10.408582,-75.538003)"
2021,Febrero,Costa Rica,188,207,272,479,"(4.697144,-74.140516)"
2017,Agosto,Honduras,340,4,2,6,"(0.814836,-77.662532)"
2015,Septiembre,Israel,376,0,1,1,"(7.818934,-72.453226)"
2021,Noviembre,Estonia,233,2,0,2,"(10.445761,-75.516429)"
2016,Marzo,Israel,376,1,21,22,"(-4.197703,-69.941278)"
2015,Noviembre,Argentina,32,9,25,34,"(7.818934,-72.453226)"
2015,Febrero,Portugal,620,1,3,4,"(11.360009,-72.129330)"
2012,Enero,Jordania,400,1,0,1,"(4.697144,-74.140516)"
2015,Noviembre,Bahréin,48,2,0,2,"(4.697144,-74.140516)"
2016,Julio,Filipinas,608,1,1,2,"(-4.197703,-69.941278)"
2018,Junio,Australia,36,1,1,2,"(12.586067,-81.702563)"
2022,Febrero,Honduras,340,0,9,9,"(12.5744111,-81.703935)"
2014,Agosto,Honduras,340,1,2,3,"(0.814836,-77.662532)"
2017,Mayo,Suecia,752,15,12,27,"(0.814836,-77.662532)"
2017,Marzo,Federación de Rusia,643,154,187,341,"(4.697144,-74.140516)"
2018,Enero,Croacia,191,1,1,2,"(0.814836,-77.662532)"
2018,Diciembre,Chile,152,116,90,206,"(12.586067,-81.702563)"
2019,Enero,Venezuela,862,24,23,47,"(4.815061,-75.736532)"
2013,Enero,Costa Rica,188,57,119,176,"(6.171601,-75.427454)"
2012,Junio,Austria,40,2,6,8,"(6.171601,-75.427454)"
2015,Septiembre,Afganistán,4,1,0,1,"(4.697144,-74.140516)"
2015,Julio,Argentina,32,151,256,407,"(6.171601,-75.427454)"
2015,Agosto,Dinamarca,208,1,1,2,"(7.818934,-72.453226)"
2018,Diciembre,Países Bajos,528,14,20,34,"(10.886611,-74.776708)"
2021,Febrero,Brasil,76,8,2,10,"(3.541112,-76.384584)"
2016,Junio,Panamá,591,0,4,4,"(0.814836,-77.662532)"
2012,Octubre,Rwanda,646,0,1,1,"(6.171601,-75.427454)"
2015,Octubre,Reino Unido de Gran Bretaña e Irlanda del Norte,826,43,43,86,"(0.814836,-77.662532)"
2020,Octubre,México,484,15,27,42,"(3.541112,-76.384584)"
2016,Mayo,Haití,332,2,0,2,"(3.541112,-76.384584)"
2020,Febrero,España,724,3,5,8,"(-4.197703,-69.941278)"
2018,Octubre,Lituania,440,32,29,61,"(4.697144,-74.140516)"
2016,Enero,Belice,84,0,1,1,"(8.635765,-77.346578)"
2018,Agosto,Uruguay,858,0,2,2,"(4.815061,-75.736532)"
2015,Junio,Chile,152,27,55,82,"(0.814836,-77.662532)"
2017,Febrero,Brasil,76,463,328,791,"(10.408582,-75.538003)"
2015,Abril,Italia,380,445,1510,1955,"(4.697144,-74.140516)"
2017,Junio,Irán,364,0,1,1,"(4.815061,-75.736532)"
2016,Agosto,Alemania,276,3,3,6,"(11.247723,-74.213989)"
2015,Octubre,Dinamarca,208,4,2,6,"(0.814836,-77.662532)"
2022,Abril,Croacia,191,3,8,11,"(10.445761,-75.516429)"
2012,Abril,Estados Unidos de América,840,20,55,75,"(10.408582,-75.538003)"
2015,Junio,India,356,1,1,2,"(4.815061,-75.736532)"
2012,Marzo,Brasil,76,3,3,6,"(4.815061,-75.736532)"
2017,Enero,Argentina,32,0,2,2,"(1.813928,-78.763924)"
2016,Septiembre,República Árabe Siria,760,0,1,1,"(11.360009,-72.129330)"
2021,Diciembre,Estados Unidos de América,840,36,76,112,"(7.927209,-72.507910)"
2016,Septiembre,Georgia,268,0,1,1,"(9.402978,-75.681599)"
2023,Enero,Honduras,340,3,4,7,"(4.815061,-75.736532)"
2016,Agosto,Hungría,348,2,3,5,"(10.445761,-75.516429)"
2017,Agosto,Francia,250,3,3,6,"(12.586067,-81.702563)"
2021,Mayo,Australia,36,2,2,4,"(10.445761,-75.516429)"
2014,Junio,Portugal,620,0,2,2,"(10.408582,-75.538003)"
2021,Abril,Seychelles,690,0,1,1,"(6.171601,-75.427454)"
2021,Marzo,Estados Unidos de América,840,170,267,437,"(4.815061,-75.736532)"
2013,Junio,México,484,3,3,6,"(7.128456,-73.183637)"
2015,Octubre,Guatemala,320,2,6,8,"(4.815061,-75.736532)"
2019,Septiembre,Chile,152,1,5,6,"(11.360009,-72.129330)"
2022,Enero,Panamá,591,111,125,236,"(10.886611,-74.776708)"
2017,Mayo,República Checa,203,24,61,85,"(4.697144,-74.140516)"
2017,Febrero,Alemania,276,115,172,287,"(3.541112,-76.384584)"
2015,Julio,El Salvador,222,1,1,2,"(0.814836,-77.662532)"
2015,Noviembre,Ecuador,218,0,2,2,"(8.635765,-77.346578)"
2014,Marzo,Irán,364,6,17,23,"(4.697144,-74.140516)"
2018,Mayo,República Checa,203,2,5,7,"(6.171601,-75.427454)"
2019,Marzo,Ecuador,218,0,1,1,"(0.812436,-77.847006)"
2017,Septiembre,Venezuela,862,5,17,22,"(7.128456,-73.183637)"
2014,Julio,Grecia,300,0,1,1,"(3.893038,-77.067921)"
2013,Abril,Venezuela,862,119,132,251,"(7.927209,-72.507910)"
2012,Julio,Territorio Antártico Británico/Territorio Británico de Ultramar,260,0,1,1,"(6.171601,-75.427454)"
2017,Noviembre,Kenia,404,0,1,1,"(0.25129,-76.875963)"
2018,Mayo,Kenia,404,2,9,11,"(4.697144,-74.140516)"
2019,Septiembre,España,724,0,1,1,"(4.452882,-75.766298)"
2016,Marzo,España,724,2,1,3,"(10.971302,-74.765397)"
2021,Enero,República Checa,203,3,6,9,"(6.171601,-75.427454)"
2012,Octubre,Gabón,266,1,0,1,"(3.541112,-76.384584)"
2015,Agosto,Desconocido,99999,1,3,4,"(6.171601,-75.427454)"
2016,Octubre,Guatemala,320,187,196,383,"(10.445761,-75.516429)"
2017,Noviembre,Canadá,124,0,2,2,"(7.927209,-72.507910)"
2013,Mayo,Guatemala,320,27,33,60,"(10.445761,-75.516429)"
2019,Noviembre,Honduras,340,0,54,54,"(10.408582,-75.538003)"
2018,Junio,Cuba,192,2,0,2,"(7.128456,-73.183637)"
2019,Febrero,Maldivas,462,0,1,1,"(3.541112,-76.384584)"
2015,Julio,Venezuela,862,0,3,3,"(12.5744111,-81.703935)"
2020,Octubre,Jordania,400,1,0,1,"(0.814836,-77.662532)"
2023,Febrero,Reino Unido de Gran Bretaña e Irlanda del Norte,826,1,1,2,"(13.3387613,-81.372937)"
2017,Abril,Sudáfrica,710,0,1,1,"(3.541112,-76.384584)"
2015,Enero,Austria,40,0,1,1,"(0.25129,-76.875963)"
2016,Abril,Bélgica,56,1,0,1,"(0.25129,-76.875963)"
2020,Noviembre,Nicaragua,558,7,11,18,"(6.171601,-75.427454)"
2016,Diciembre,Bahréin,48,0,1,1,"(6.171601,-75.427454)"
2019,Junio,Perú,604,0,1,1,"(7.102626,-77.762647)"
2023,Junio,Guatemala,320,1,0,1,"(0.814836,-77.662532)"
2022,Noviembre,Francia,250,7,12,19,"(4.815061,-75.736532)"
2016,Noviembre,Reino Unido de Gran Bretaña e Irlanda del Norte,826,0,1,1,"(7.102626,-77.762647)"
2016,Diciembre,Reino Unido de Gran Bretaña e Irlanda del Norte,826,0,1,1,"(11.360009,-72.129330)"
2014,Junio,Panamá,591,0,7,7,"(7.818934,-72.453226)"
2015,Septiembre,Ecuador,218,1,1,2,"(6.228046,-77.404104)"
2019,Diciembre,Costa Rica,188,1885,1957,3842,"(4.697144,-74.140516)"
2016,Febrero,Filipinas,608,0,15,15,"(11.247723,-74.213989)"
2019,Marzo,Hungría,348,0,1,1,"(-4.197703,-69.941278)"
2012,Marzo,República de Belarús,112,2,0,2,"(4.697144,-74.140516)"
2022,Julio,Portugal,620,9,6,15,"(11.360009,-72.129330)"
2014,Abril,Finlandia,246,0,1,1,"(11.360009,-72.129330)"
2019,Noviembre,Uruguay,858,0,1,1,"(12.5744111,-81.703935)"
2018,Septiembre,Desconocido,99999,1,0,1,"(7.128456,-73.183637)"
2019,Febrero,España,724,0,2,2,"(7.088729,-70.740253)"
2015,Marzo,Japón,392,3,14,17,"(3.541112,-76.384584)"
2022,Noviembre,Países Bajos,528,7,3,10,"(-4.223468,-69.945098)"
2014,Noviembre,Finlandia,246,0,1,1,"(11.360009,-72.129330)"
2019,Mayo,Portugal,620,208,465,673,"(4.697144,-74.140516)"
2019,Marzo,Indonesia,360,0,2,2,"(10.886611,-74.776708)"
2018,Diciembre,Reino Unido de Gran Bretaña e Irlanda del Norte,826,1,9,10,"(4.815061,-75.736532)"
2014,Abril,Nigeria,566,10,41,51,"(4.697144,-74.140516)"
2018,Abril,Croacia,191,1,5,6,"(6.171601,-75.427454)"
2014,Enero,México,484,27,66,93,"(7.818934,-72.453226)"
2016,Agosto,Italia,380,0,1,1,"(10.971302,-74.765397)"
2017,Junio,Bélgica,56,0,1,1,"(8.635765,-77.346578)"
2017,Agosto,Vietnam,704,3,2,5,"(4.697144,-74.140516)"
2019,Marzo,Francia,250,3,2,5,"(12.5744111,-81.703935)"
2018,Octubre,Turquía,792,1,7,8,"(3.541112,-76.384584)"
2020,Enero,Lituania,440,1,1,2,"(10.886611,-74.776708)"
2016,Febrero,República de Belarús,112,2,0,2,"(10.445761,-75.516429)"
2019,Abril,Andorra,20,0,1,1,"(6.171601,-75.427454)"
2014,Abril,Ghana,288,8,31,39,"(4.697144,-74.140516)"
2022,Agosto,Argentina,32,535,483,1018,"(10.445761,-75.516429)"
2017,Diciembre,Panamá,591,245,303,548,"(3.541112,-76.384584)"
2020,Enero,Nicaragua,558,0,1,1,"(0.25129,-76.875963)"
2012,Diciembre,Brasil,76,2320,3022,5342,"(4.697144,-74.140516)"
2013,Julio,República Dominicana,214,212,414,626,"(4.697144,-74.140516)"
2021,Enero,Venezuela,862,38,20,58,"(7.128456,-73.183637)"
2017,Octubre,Alemania,276,57,54,111,"(0.814836,-77.662532)"
2022,Marzo,Bolivia,68,1,0,1,"(4.815061,-75.736532)"
2015,Abril,Francia,250,3,5,8,"(4.815061,-75.736532)"
2017,Agosto,Bolivia,68,9,12,21,"(0.814836,-77.662532)"
2017,Febrero,India,356,0,1,1,"(4.815061,-75.736532)"
2012,Septiembre,Bélgica,56,103,224,327,"(4.697144,-74.140516)"
2013,Julio,Uruguay,858,72,43,115,"(10.445761,-75.516429)"
2013,Octubre,Hungría,348,2,2,4,"(0.814836,-77.662532)"
2017,Mayo,Nueva Zelanda,554,3,7,10,"(6.171601,-75.427454)"
2017,Abril,México,484,2,2,4,"(12.586067,-81.702563)"
2017,Agosto,Países Bajos,528,0,1,1,"(11.360009,-72.129330)"
2022,Julio,Hungría,348,47,58,105,"(4.697144,-74.140516)"
2013,Marzo,España,724,0,1,1,"(6.185799,-67.483929)"
2014,Junio,Panamá,591,116,93,209,"(12.586067,-81.702563)"
2021,Abril,Belice,84,1,2,3,"(6.171601,-75.427454)"
2018,Agosto,Eslovenia,705,1,1,2,"(0.814836,-77.662532)"
2012,Enero,Gabón,266,0,1,1,"(4.697144,-74.140516)"
2013,Mayo,Uruguay,858,159,84,243,"(10.445761,-75.516429)"
2021,Septiembre,El Salvador,222,0,1,1,"(1.813928,-78.763924)"
2012,Febrero,Reino Unido de Gran Bretaña e Irlanda del Norte,826,2,1,3,"(10.886611,-74.776708)"
2016,Septiembre,Santa Lucia,662,1,0,1,"(10.445761,-75.516429)"
2021,Junio,Venezuela,862,113,98,211,"(7.088729,-70.740253)"
2023,Febrero,República Dominicana,214,4,9,13,"(0.814836,-77.662532)"
2018,Junio,Perú,604,0,2,2,"(1.813928,-78.763924)"
2021,Abril,Honduras,340,2,4,6,"(10.886611,-74.776708)"
2020,Marzo,Alemania,276,1,2,3,"(7.916725,-72.462544)"
2013,Enero,Sudáfrica,710,1,2,3,"(10.886611,-74.776708)"
2013,Marzo,Portugal,620,0,1,1,"(-4.197703,-69.941278)"
2017,Marzo,Federación de Rusia,643,0,3,3,"(7.818934,-72.453226)"
2015,Enero,República de Corea,410,1,1,2,"(11.360009,-72.129330)"
2015,Junio,Filipinas,608,28,75,103,"(4.697144,-74.140516)"
2023,Mayo,República de Belarús,112,1,0,1,"(4.815061,-75.736532)"
2020,Noviembre,Argentina,32,207,393,600,"(4.697144,-74.140516)"
2012,Julio,Italia,380,36,88,124,"(6.171601,-75.427454)"
2021,Febrero,Alemania,276,0,1,1,"(11.247723,-74.213989)"
2021,Octubre,Federación de Rusia,643,2,2,4,"(10.886611,-74.776708)"
2015,Febrero,Cuba,192,0,1,1,"(4.815061,-75.736532)"
2021,Noviembre,Polonia,616,242,316,558,"(4.697144,-74.140516)"
2016,Julio,Sudáfrica,710,45,67,112,"(4.697144,-74.140516)"
2012,Noviembre,Sudáfrica,710,0,1,1,"(0.814836,-77.662532)"
2017,Julio,Portugal,620,23,55,78,"(6.171601,-75.427454)"
2022,Marzo,Cuba,192,140,223,363,"(4.697144,-74.140516)"
2019,Abril,Senegal,686,0,1,1,"(4.697144,-74.140516)"
2014,Diciembre,Alemania,276,1,0,1,"(0.25129,-76.875963)"
2013,Agosto,Guinea,324,0,1,1,"(4.697144,-74.140516)"
2015,Agosto,Letonia,428,1,0,1,"(8.635765,-77.346578)"
2022,Septiembre,Países Bajos,528,6,8,14,"(0.814836,-77.662532)"
2016,Abril,México,484,0,1,1,"(3.893038,-77.067921)"
2019,Abril,Guyana,328,15,15,30,"(4.697144,-74.140516)"
2012,Julio,Belice,84,1,1,2,"(10.445761,-75.516429)"
2013,Agosto,Austria,40,3,0,3,"(11.360009,-72.129330)"
2012,Mayo,Panamá,591,4,3,7,"(7.818934,-72.453226)"
2013,Febrero,Japón,392,0,2,2,"(-4.197703,-69.941278)"
2017,Octubre,Paraguay,600,1,0,1,"(0.814836,-77.662532)"
2018,Julio,Estados Unidos de América,840,19,24,43,"(-4.197703,-69.941278)"
2016,Septiembre,Portugal,620,1,2,3,"(12.586067,-81.702563)"
2018,Agosto,Refugiado,99999,0,1,1,"(6.171601,-75.427454)"
2017,Marzo,Paraguay,600,71,60,131,"(12.586067,-81.702563)"
2012,Febrero,Honduras,340,2,3,5,"(0.814836,-77.662532)"
2016,Agosto,República de Corea,410,11,35,46,"(6.171601,-75.427454)"
2018,Febrero,República de Irlanda,372,1,4,5,"(10.886611,-74.776708)"
2014,Junio,Estados Unidos de América,840,2544,4117,6661,"(6.171601,-75.427454)"
2013,Enero,España,724,0,6,6,"(7.818934,-72.453226)"
2022,Junio,Portugal,620,0,2,2,"(-4.197703,-69.941278)"
2015,Marzo,Reino Unido de Gran Bretaña e Irlanda del Norte,826,1,2,3,"(-4.223468,-69.945098)"
2019,Junio,Chile,152,0,1,1,"(7.128456,-73.183637)"
2021,Mayo,Japón,392,0,1,1,"(4.452882,-75.766298)"
2012,Agosto,Eslovenia,705,2,0,2,"(11.360009,-72.129330)"
2015,Enero,Canadá,124,1,0,1,"(-4.197703,-69.941278)"
2013,Octubre,Rumania,642,9,9,18,"(6.171601,-75.427454)"
2018,Agosto,Alemania,276,4,2,6,"(12.586067,-81.702563)"
2023,Abril,Alemania,276,0,1,1,"(7.916725,-72.462544)"
2022,Diciembre,Costa Rica,188,0,11,11,"(3.893038,-77.067921)"
2015,Julio,República de Irlanda,372,1,2,3,"(-4.197703,-69.941278)"
2015,Septiembre,Mongolia,496,6,4,10,"(4.697144,-74.140516)"
2012,Mayo,Macedonia,807,1,1,2,"(4.697144,-74.140516)"
2017,Marzo,República Dominicana,214,0,5,5,"(11.117806,-74.232622)"
2012,Mayo,Honduras,340,10,19,29,"(10.445761,-75.516429)"
2018,Abril,Argentina,32,7,19,26,"(4.815061,-75.736532)"
2018,Diciembre,República de Corea,410,3,1,4,"(-4.197703,-69.941278)"
2016,Septiembre,Cuba,192,1,3,4,"(12.586067,-81.702563)"
2016,Octubre,República de Irlanda,372,2,1,3,"(8.635765,-77.346578)"
2022,Enero,Reino Unido de Gran Bretaña e Irlanda del Norte,826,56,116,172,"(10.445761,-75.516429)"
2022,Enero,Nicaragua,558,4,2,6,"(10.445761,-75.516429)"
2022,Abril,Reino Unido de Gran Bretaña e Irlanda del Norte,826,10,13,23,"(10.886611,-74.776708)"
2018,Noviembre,Egipto,818,0,1,1,"(0.814836,-77.662532)"
2012,Octubre,Santa Sede/Ciudad del Vaticano,336,0,1,1,"(4.697144,-74.140516)"
2018,Julio,Bangladesh,50,0,6,6,"(4.697144,-74.140516)"
2015,Marzo,Japón,392,19,21,40,"(0.814836,-77.662532)"
2019,Julio,República de Corea,410,11,11,22,"(0.814836,-77.662532)"
2019,Mayo,Japón,392,1,2,3,"(4.815061,-75.736532)"
2022,Octubre,Belice,84,3,3,6,"(10.445761,-75.516429)"
2020,Febrero,Noruega,578,9,14,23,"(6.171601,-75.427454)"
2022,Diciembre,República Checa,203,1,2,3,"(10.408582,-75.538003)"
2022,Diciembre,Túnez,788,1,0,1,"(6.171601,-75.427454)"
2023,Enero,Federación de Rusia,643,2,3,5,"(11.360009,-72.129330)"
2023,Marzo,Reino Unido de Gran Bretaña e Irlanda del Norte,826,29,44,73,"(0.814836,-77.662532)"
2018,Octubre,Sudáfrica,710,0,1,1,"(3.541112,-76.384584)"
2016,Agosto,Ecuador,218,1,1,2,"(4.815061,-75.736532)"
2023,Mayo,El Salvador,222,154,186,340,"(6.171601,-75.427454)"
2019,Agosto,Kenia,404,0,1,1,"(6.171601,-75.427454)"
2012,Junio,Bulgaria,100,1,0,1,"(6.171601,-75.427454)"
2017,Julio,Rumania,642,0,1,1,"(11.247723,-74.213989)"
2019,Noviembre,Bangladesh,50,0,1,1,"(6.171601,-75.427454)"
2012,Octubre,Alemania,276,0,2,2,"(7.088729,-70.740253)"
2017,Noviembre,Turquía,792,164,271,435,"(4.697144,-74.140516)"
2013,Junio,Austria,40,0,1,1,"(7.927209,-72.507910)"
2022,Enero,Perú,604,18,16,34,"(7.128456,-73.183637)"
2015,Junio,Reino Unido de Gran Bretaña e Irlanda del Norte,826,39,90,129,"(10.445761,-75.516429)"
2018,Noviembre,Finlandia,246,0,1,1,"(4.815061,-75.736532)"
2019,Septiembre,Bélgica,56,27,80,107,"(6.171601,-75.427454)"
2023,Junio,Lituania,440,19,23,42,"(4.697144,-74.140516)"
2015,Abril,Venezuela,862,3,5,8,"(12.586067,-81.702563)"
2021,Diciembre,Perú,604,8,7,15,"(7.128456,-73.183637)"
2018,Abril,Portugal,620,2,4,6,"(10.886611,-74.776708)"
2014,Septiembre,Hungría,348,3,1,4,"(6.171601,-75.427454)"
2015,Febrero,Turquía,792,3,4,7,"(6.171601,-75.427454)"
2015,Octubre,Austria,40,5,9,14,"(3.541112,-76.384584)"
2021,Diciembre,Puerto Rico/Territorio de Estados Unidos,630,0,1,1,"(4.697144,-74.140516)"
2016,Mayo,Grecia,300,0,3,3,"(11.247723,-74.213989)"
2016,Junio,España,724,0,1,1,"(3.893038,-77.067921)"
2017,Agosto,Uruguay,858,13,9,22,"(10.408582,-75.538003)"
2018,Octubre,Guatemala,320,4,4,8,"(4.815061,-75.736532)"
2022,Abril,Líbano,422,0,3,3,"(10.445761,-75.516429)"
2020,Enero,Israel,376,14,48,62,"(10.445761,-75.516429)"
2013,Enero,Arabia Saudita,682,0,1,1,"(6.171601,-75.427454)"
2015,Diciembre,España,724,10,23,33,"(4.815061,-75.736532)"
2018,Febrero,Perú,604,158,341,499,"(0.814836,-77.662532)"
2013,Diciembre,Países Bajos,528,0,1,1,"(7.088729,-70.740253)"
2015,Abril,Costa Rica,188,4,2,6,"(0.814836,-77.662532)"
2023,Febrero,República Checa,203,4,4,8,"(10.886611,-74.776708)"
2018,Diciembre,Emiratos Árabes,784,0,1,1,"(10.445761,-75.516429)"
2018,Mayo,Guyana,328,4,12,16,"(4.697144,-74.140516)"
2022,Octubre,Líbano,422,0,4,4,"(10.408582,-75.538003)"
2012,Marzo,Cuba,192,12,19,31,"(10.445761,-75.516429)"
2012,Noviembre,Barbados,52,0,1,1,"(6.171601,-75.427454)"
2022,Noviembre,Venezuela,862,10,9,19,"(4.452882,-75.766298)"
2013,Enero,Portugal,620,0,1,1,"(4.815061,-75.736532)"
2017,Marzo,Bermudas/Territorio Británico de Ultramar,60,0,1,1,"(10.445761,-75.516429)"
2022,Julio,Albania,8,0,2,2,"(3.541112,-76.384584)"
2018,Noviembre,Canadá,124,6,5,11,"(12.586067,-81.702563)"
2012,Febrero,Ecuador,218,1853,2907,4760,"(4.697144,-74.140516)"
2023,Abril,Sudáfrica,710,0,1,1,"(10.886611,-74.776708)"
2016,Julio,Perú,604,54,84,138,"(7.818934,-72.453226)"
2018,Enero,México,484,4,1,5,"(7.088729,-70.740253)"
2023,Mayo,México,484,2308,3422,5730,"(6.171601,-75.427454)"
2022,Agosto,Alemania,276,2,2,4,"(7.916725,-72.462544)"
2021,Septiembre,República Árabe Siria,760,0,3,3,"(4.697144,-74.140516)"
2021,Febrero,Panamá,591,6,26,32,"(4.815061,-75.736532)"
2021,Diciembre,Trinidad y Tobago,780,1,0,1,"(4.815061,-75.736532)"
2012,Noviembre,Islas Midway/Territorio no incorporado de Estados Unidos,99999,0,1,1,"(6.171601,-75.427454)"
2013,Febrero,Mauricio,480,0,1,1,"(6.171601,-75.427454)"
2015,Noviembre,Paraguay,600,1,0,1,"(4.815061,-75.736532)"
2020,Enero,México,484,4444,6616,11061,"(4.697144,-74.140516)"
2017,Abril,Ucrania,804,0,5,5,"(10.971302,-74.765397)"
2017,Abril,Alemania,276,1,2,3,"(0.25129,-76.875963)"
2015,Junio,Nicaragua,558,9,10,19,"(3.541112,-76.384584)"
2019,Abril,Polonia,616,0,1,1,"(8.635765,-77.346578)"
2016,Noviembre,Surinam,740,15,14,29,"(4.697144,-74.140516)"
2016,Febrero,India,356,3,10,13,"(10.408582,-75.538003)"
2017,Junio,República de Corea,410,5,11,16,"(10.445761,-75.516429)"
2017,Febrero,Sudáfrica,710,0,1,1,"(-4.197703,-69.941278)"
2015,Marzo,Canadá,124,40,66,106,"(3.541112,-76.384584)"
2014,Septiembre,Chile,152,27,57,84,"(3.541112,-76.384584)"
2017,Octubre,Brasil,76,0,1,1,"(0.25129,-76.875963)"
2023,Abril,Polonia,616,4,7,11,"(10.886611,-74.776708)"
2022,Diciembre,Uruguay,858,1,2,3,"(7.927209,-72.507910)"
2023,Junio,Finlandia,246,0,1,1,"(8.635765,-77.346578)"
2014,Mayo,Panamá,591,83,148,231,"(10.445761,-75.516429)"
2022,Marzo,Federación de Rusia,643,6,6,12,"(10.445761,-75.516429)"
2023,Febrero,Perú,604,24,21,45,"(8.364293,-72.405710)"
2012,Septiembre,Estados Unidos de América,840,43,45,88,"(4.815061,-75.736532)"
2014,Septiembre,Guatemala,320,1,1,2,"(7.818934,-72.453226)"
2018,Mayo,Eslovaquia,703,17,32,49,"(4.697144,-74.140516)"
2022,Noviembre,Bélgica,56,28,43,71,"(10.445761,-75.516429)"
2022,Agosto,China,156,0,1,1,"(4.452882,-75.766298)"
2023,Abril,Cuba,192,125,168,293,"(4.697144,-74.140516)"
2022,Abril,Venezuela,862,0,12,12,"(3.893038,-77.067921)"
2013,Noviembre,Bolivia,68,34,29,63,"(6.171601,-75.427454)"
2016,Febrero,Ghana,288,0,1,1,"(3.541112,-76.384584)"
2017,Enero,República de Belarús,112,10,15,25,"(4.697144,-74.140516)"
2019,Abril,El Salvador,222,97,122,220,"(3.541112,-76.384584)"
2017,Agosto,Italia,380,1,2,3,"(8.36068,-72.409396)"
2014,Septiembre,Perú,604,124,348,472,"(0.814836,-77.662532)"
2017,Diciembre,Uzbekistán,860,1,0,1,"(3.541112,-76.384584)"
2017,Octubre,Mauricio,480,0,5,5,"(10.445761,-75.516429)"
2021,Septiembre,Trinidad y Tobago,780,2,8,10,"(6.171601,-75.427454)"
2012,Octubre,Estados Unidos de América,840,3,13,16,"(8.635765,-77.346578)"
2014,Junio,Costa Rica,188,0,1,1,"(0.814836,-77.662532)"
2022,Noviembre,Uganda,800,0,3,3,"(4.697144,-74.140516)"
2019,Octubre,España,724,520,895,1415,"(6.171601,-75.427454)"
2018,Abril,Bélgica,56,0,6,6,"(10.886611,-74.776708)"
2014,Mayo,México,484,32,129,161,"(3.541112,-76.384584)"
2015,Octubre,Panamá,591,0,2,2,"(7.818934,-72.453226)"
2019,Agosto,Brasil,76,10,16,26,"(7.818934,-72.453226)"
2014,Julio,Guyana,328,1,1,2,"(6.171601,-75.427454)"
2019,Enero,República de Corea,410,1,0,1,"(8.635765,-77.346578)"
2019,Febrero,Desconocido,99999,0,1,1,"(4.697144,-74.140516)"
2018,Septiembre,Uruguay,858,11,13,24,"(0.814836,-77.662532)"
2020,Diciembre,México,484,1326,2232,3558,"(4.697144,-74.140516)"
2014,Octubre,Brasil,76,0,2,2,"(-4.223468,-69.945098)"
2016,Septiembre,Alemania,276,0,1,1,"(1.813928,-78.763924)"
2017,Febrero,Reino Unido de Gran Bretaña e Irlanda del Norte,826,2,5,7,"(7.818934,-72.453226)"
2023,Enero,República Democrática del Congo,180,1,3,4,"(4.697144,-74.140516)"
2015,Mayo,Dinamarca,208,1,4,5,"(3.541112,-76.384584)"
2017,Diciembre,Cuba,192,1,1,2,"(12.586067,-81.702563)"
2013,Julio,Portugal,620,4,5,9,"(0.814836,-77.662532)"
2020,Febrero,Argelia,12,0,1,1,"(10.886611,-74.776708)"
2022,Noviembre,Ecuador,218,28,40,68,"(7.818934,-72.453226)"
2023,Marzo,Cuba,192,1,1,2,"(7.128456,-73.183637)"
2013,Marzo,Luxemburgo,442,0,1,1,"(10.445761,-75.516429)"
2012,Enero,Isla de Man,833,40,111,151,"(4.697144,-74.140516)"
2012,Abril,Sudáfrica,710,0,1,1,"(11.360009,-72.129330)"
2015,Febrero,Cuba,192,0,2,2,"(11.360009,-72.129330)"
2012,Noviembre,Chipre,196,0,2,2,"(4.697144,-74.140516)"
2015,Diciembre,Perú,604,2,4,6,"(0.25129,-76.875963)"
2012,Agosto,Nueva Zelanda,554,0,4,4,"(4.697144,-74.140516)"
2012,Agosto,Alemania,276,1,3,4,"(12.5744111,-81.703935)"
2016,Julio,Costa Rica,188,0,4,4,"(8.635765,-77.346578)"
2013,Octubre,Trinidad y Tobago,780,5,7,12,"(7.128456,-73.183637)"
2012,Agosto,República Dominicana,214,2,4,6,"(7.128456,-73.183637)"
2013,Febrero,Suecia,752,8,30,38,"(6.171601,-75.427454)"
2013,Diciembre,República de Irlanda,372,70,131,201,"(4.697144,-74.140516)"
2016,Enero,Australia,36,0,2,2,"(4.815061,-75.736532)"
2018,Enero,Portugal,620,1,2,3,"(12.586067,-81.702563)"
2020,Marzo,India,356,0,1,1,"(4.815061,-75.736532)"
2013,Octubre,Noruega,578,2,3,5,"(10.408582,-75.538003)"
2017,Septiembre,Cuba,192,0,3,3,"(10.408582,-75.538003)"
2017,Abril,Singapur,702,0,2,2,"(11.528919,-72.919681)"
2022,Febrero,Senegal,686,1,0,1,"(4.697144,-74.140516)"
2020,Junio,Panamá,591,0,2,2,"(10.886611,-74.776708)"
2015,Noviembre,Pakistán,586,0,2,2,"(6.171601,-75.427454)"
2023,Marzo,Indonesia,360,1,1,2,"(10.886611,-74.776708)"
2015,Enero,Panamá,591,154,175,329,"(10.408582,-75.538003)"
2014,Diciembre,Suiza,756,2,1,3,"(-4.197703,-69.941278)"
2017,Julio,Bélgica,56,48,83,131,"(6.171601,-75.427454)"
2022,Octubre,Panamá,591,17,11,28,"(12.586067,-81.702563)"
2022,Diciembre,Bangladesh,50,0,1,1,"(10.408582,-75.538003)"
2012,Marzo,Reino Unido de Gran Bretaña e Irlanda del Norte,826,1,2,3,"(11.360009,-72.129330)"
2016,Mayo,Noruega,578,6,7,13,"(3.541112,-76.384584)"
2018,Julio,Filipinas,608,0,5,5,"(11.247723,-74.213989)"
2015,Marzo,Nueva Zelanda,554,41,64,105,"(4.697144,-74.140516)"
2013,Septiembre,Azerbaiyán,31,1,0,1,"(4.697144,-74.140516)"
2014,Octubre,Brasil,76,543,393,936,"(10.445761,-75.516429)"
2015,Abril,Iraq,368,0,1,1,"(4.697144,-74.140516)"
2016,Noviembre,Chile,152,36,74,110,"(3.541112,-76.384584)"
2017,Diciembre,Dominica,212,0,2,2,"(4.697144,-74.140516)"
2018,Diciembre,Australia,36,4,11,15,"(10.886611,-74.776708)"
2014,Diciembre,Hungría,348,21,32,53,"(4.697144,-74.140516)"
2021,Abril,Venezuela,862,120,115,235,"(10.445761,-75.516429)"
2019,Febrero,Cabo Verde,132,1,0,1,"(10.445761,-75.516429)"
2023,Junio,Venezuela,862,411,382,793,"(0.814836,-77.662532)"
2013,Septiembre,Eslovaquia,703,0,1,1,"(8.635765,-77.346578)"
2013,Julio,Panamá,591,5,5,10,"(8.635765,-77.346578)"
2014,Enero,Canadá,124,4,2,6,"(7.128456,-73.183637)"
2017,Octubre,Chipre,196,1,1,2,"(10.445761,-75.516429)"
2022,Mayo,Turquía,792,0,1,1,"(3.893038,-77.067921)"
2021,Septiembre,Belice,84,5,5,10,"(4.697144,-74.140516)"
2018,Septiembre,Suiza,756,5,2,7,"(11.247723,-74.213989)"
2019,Noviembre,Italia,380,0,4,4,"(12.5744111,-81.703935)"
2021,Noviembre,Alemania,276,17,22,39,"(10.408582,-75.538003)"
2012,Febrero,Camerún,120,1,2,3,"(4.697144,-74.140516)"
2014,Mayo,Suecia,752,1,1,2,"(11.247723,-74.213989)"
2013,Febrero,Estonia,233,0,1,1,"(0.814836,-77.662532)"
2018,Enero,Taiwán,158,6,3,9,"(10.445761,-75.516429)"
2022,Noviembre,Perú,604,34,44,78,"(10.886611,-74.776708)"
2015,Diciembre,Francia,250,2,8,10,"(0.25129,-76.875963)"
2013,Mayo,Croacia,191,0,1,1,"(10.445761,-75.516429)"
2015,Agosto,Honduras,340,0,1,1,"(10.971302,-74.765397)"
2014,Mayo,Austria,40,0,2,2,"(-4.197703,-69.941278)"
2019,Octubre,Perú,604,2300,1557,3857,"(10.445761,-75.516429)"
2015,Diciembre,Mauricio,480,0,1,1,"(10.408582,-75.538003)"
2014,Enero,Pakistán,586,0,1,1,"(3.541112,-76.384584)"
2017,Agosto,Cuba,192,12,47,59,"(10.445761,-75.516429)"
2021,Abril,Uruguay,858,2,2,4,"(10.445761,-75.516429)"
2014,Abril,Dinamarca,208,6,9,15,"(3.541112,-76.384584)"
2012,Octubre,Uruguay,858,0,4,4,"(10.886611,-74.776708)"
2017,Febrero,Finlandia,246,3,6,9,"(6.171601,-75.427454)"
2018,Mayo,Alemania,276,1,5,6,"(4.815061,-75.736532)"
2012,Mayo,Japón,392,4,3,7,"(7.818934,-72.453226)"
2014,Mayo,Haití,332,1,1,2,"(7.818934,-72.453226)"
2021,Agosto,Bosnia y Herzegovina,70,0,2,2,"(4.697144,-74.140516)"
2022,Diciembre,Macedonia,807,0,1,1,"(10.886611,-74.776708)"
2013,Febrero,Países Bajos,528,0,3,3,"(7.818934,-72.453226)"
2017,Febrero,Ucrania,804,0,2,2,"(10.886611,-74.776708)"
2023,Abril,Bélgica,56,33,64,97,"(6.171601,-75.427454)"
2018,Agosto,Estonia,233,1,1,2,"(3.541112,-76.384584)"
2018,Enero,Portugal,620,0,1,1,"(7.128456,-73.183637)"
2023,Abril,República Árabe Siria,760,0,21,21,"(3.893038,-77.067921)"
2014,Noviembre,Grecia,300,12,50,62,"(4.697144,-74.140516)"
2020,Enero,Sudáfrica,710,0,4,4,"(10.886611,-74.776708)"
2013,Mayo,Georgia,268,2,0,2,"(4.697144,-74.140516)"
2013,Junio,Chile,152,27,53,80,"(0.814836,-77.662532)"
2021,Mayo,El Salvador,222,1,2,3,"(10.886611,-74.776708)"
2018,Mayo,Canadá,124,7,3,10,"(8.635765,-77.346578)"
2023,Mayo,Panamá,591,3,5,8,"(7.818934,-72.453226)"
2015,Abril,Panamá,591,0,3,3,"(0.814836,-77.662532)"
2018,Noviembre,Bután,64,0,2,2,"(4.697144,-74.140516)"
2022,Octubre,Líbano,422,0,1,1,"(0.814836,-77.662532)"
2021,Diciembre,Alemania,276,0,1,1,"(4.815061,-75.736532)"
2018,Mayo,Islas Caimán/Territorio Británico de Ultramar,136,0,1,1,"(12.586067,-81.702563)"
2023,Febrero,Portugal,620,0,4,4,"(10.408582,-75.538003)"
2016,Abril,Kazajistán,398,2,0,2,"(6.171601,-75.427454)"
2016,Junio,Perú,604,0,4,4,"(1.813928,-78.763924)"
2020,Febrero,Panamá,591,1,0,1,"(11.360009,-72.129330)"
2014,Diciembre,Israel,376,0,1,1,"(-4.223468,-69.945098)"
2019,Marzo,Suecia,752,1,0,1,"(-4.197703,-69.941278)"
2020,Enero,Cuba,192,198,323,521,"(4.697144,-74.140516)"
2016,Marzo,Desconocido,99999,80,143,223,"(4.697144,-74.140516)"
2020,Octubre,Guatemala,320,3,2,5,"(3.541112,-76.384584)"
2017,Octubre,Argentina,32,4,6,10,"(11.360009,-72.129330)"
2022,Mayo,Costa de Marfil,384,1,0,1,"(3.541112,-76.384584)"
2016,Junio,Perú,604,4,6,10,"(0.25129,-76.875963)"
2022,Febrero,Argentina,32,7,8,15,"(7.927209,-72.507910)"
2012,Septiembre,Alemania,276,0,2,2,"(4.452882,-75.766298)"
2016,Diciembre,Letonia,428,0,1,1,"(10.445761,-75.516429)"
2014,Octubre,Reino Unido de Gran Bretaña e Irlanda del Norte,826,0,28,28,"(10.886611,-74.776708)"
2012,Mayo,Bahamas,44,3,8,11,"(4.697144,-74.140516)"
2013,Agosto,Federación de Rusia,643,2,0,2,"(10.886611,-74.776708)"
2014,Agosto,Malta,470,1,0,1,"(7.818934,-72.453226)"
2012,Febrero,Venezuela,862,325,382,707,"(7.927209,-72.507910)"
2019,Abril,Jamaica,388,0,5,5,"(4.815061,-75.736532)"
2015,Noviembre,España,724,18,17,35,"(10.408582,-75.538003)"
2012,Octubre,Francia,250,8,15,23,"(7.818934,-72.453226)"
2015,Febrero,Pakistán,586,0,2,2,"(0.814836,-77.662532)"
2016,Diciembre,República de Irlanda,372,13,19,32,"(10.445761,-75.516429)"
2019,Julio,Ecuador,218,483,514,997,"(3.541112,-76.384584)"
2013,Noviembre,Ecuador,218,423,530,953,"(6.171601,-75.427454)"
2018,Enero,Uruguay,858,4,4,8,"(10.886611,-74.776708)"
2023,Abril,Reino Unido de Gran Bretaña e Irlanda del Norte,826,34,38,72,"(10.408582,-75.538003)"
2017,Septiembre,Pakistán,586,0,3,3,"(10.445761,-75.516429)"
2020,Enero,Santa Lucia,662,1,1,2,"(3.541112,-76.384584)"
2018,Julio,Japón,392,3,11,14,"(0.814836,-77.662532)"
2012,Diciembre,Isla de Man,833,15,60,75,"(6.171601,-75.427454)"
2022,Junio,Líbano,422,1,2,3,"(11.360009,-72.129330)"
2018,Marzo,Panamá,591,9,22,31,"(4.452882,-75.766298)"
2017,Julio,Nueva Zelanda,554,0,1,1,"(-4.197703,-69.941278)"
2018,Enero,Rumania,642,2,3,5,"(10.886611,-74.776708)"
2015,Agosto,Costa Rica,188,2,6,8,"(4.815061,-75.736532)"
2019,Agosto,Ecuador,218,0,1,1,"(4.452882,-75.766298)"
2016,Abril,Honduras,340,3,0,3,"(12.586067,-81.702563)"
2012,Agosto,Japón,392,1,17,18,"(10.445761,-75.516429)"
2023,Abril,Rumania,642,0,1,1,"(10.886611,-74.776708)"
2012,Noviembre,Panamá,591,0,1,1,"(-4.197703,-69.941278)"
2017,Enero,Argentina,32,7556,7744,15300,"(4.697144,-74.140516)"
2013,Marzo,Perú,604,2242,3043,5285,"(4.697144,-74.140516)"
2017,Noviembre,Venezuela,862,105,122,227,"(3.541112,-76.384584)"
2017,Septiembre,Belice,84,5,10,15,"(4.697144,-74.140516)"
2018,Febrero,Letonia,428,2,0,2,"(3.541112,-76.384584)"
2016,Octubre,Noruega,578,5,7,12,"(6.171601,-75.427454)"
2020,Septiembre,Haití,332,1,0,1,"(6.171601,-75.427454)"
2018,Agosto,Suecia,752,0,1,1,"(8.635765,-77.346578)"
2022,Septiembre,Panamá,591,32,37,69,"(7.128456,-73.183637)"
2022,Mayo,Italia,380,44,41,85,"(7.916725,-72.462544)"
2017,Enero,Jamaica,388,1,3,4,"(6.171601,-75.427454)"
2017,Diciembre,Ecuador,218,23,14,37,"(12.586067,-81.702563)"
2015,Junio,Países Bajos,528,198,254,452,"(6.171601,-75.427454)"
2023,Enero,Indonesia,360,13,36,49,"(4.697144,-74.140516)"
2016,Junio,China,156,0,2,2,"(-4.197703,-69.941278)"
2016,Mayo,Islas Caimán/Territorio Británico de Ultramar,136,1,0,1,"(12.586067,-81.702563)"
2013,Junio,Guatemala,320,0,1,1,"(11.360009,-72.129330)"
2013,Febrero,Austria,40,101,222,323,"(4.697144,-74.140516)"
2012,Junio,España,724,1,0,1,"(12.586067,-81.702563)"
2015,Febrero,Perú,604,2,9,11,"(10.886611,-74.776708)"
2018,Junio,Guyana,328,0,1,1,"(7.818934,-72.453226)"
2017,Diciembre,Panamá,591,1855,2008,3863,"(6.171601,-75.427454)"
2017,Febrero,Ecuador,218,0,1,1,"(-4.223468,-69.945098)"
2019,Febrero,Canadá,124,2,2,4,"(11.117806,-74.232622)"
2015,Noviembre,Portugal,620,2,2,4,"(0.814836,-77.662532)"
2022,Marzo,Lituania,440,0,1,1,"(10.886611,-74.776708)"
2016,Junio,Jamaica,388,2,13,15,"(12.586067,-81.702563)"
2014,Septiembre,España,724,22,63,85,"(10.445761,-75.516429)"
2016,Septiembre,Croacia,191,0,2,2,"(10.408582,-75.538003)"
2018,Septiembre,Grecia,300,1,5,6,"(9.402978,-75.681599)"
2012,Abril,Perú,604,95,277,372,"(0.814836,-77.662532)"
2013,Febrero,Haití,332,7,15,22,"(4.697144,-74.140516)"
2019,Marzo,Suiza,756,1,1,2,"(7.818934,-72.453226)"
2017,Junio,Estonia,233,2,3,5,"(6.171601,-75.427454)"
2018,Julio,España,724,5,6,11,"(-4.197703,-69.941278)"
2012,Febrero,Chile,152,71,106,177,"(0.814836,-77.662532)"
2019,Diciembre,Pakistán,586,0,5,5,"(10.445761,-75.516429)"
2020,Noviembre,España,724,11,27,38,"(10.445761,-75.516429)"
2022,Diciembre,Israel,376,114,173,287,"(6.171601,-75.427454)"
2014,Agosto,Angola,24,1,5,6,"(4.697144,-74.140516)"
2017,Diciembre,Japón,392,6,15,21,"(3.541112,-76.384584)"
2017,Febrero,Bolivia,68,0,1,1,"(4.815061,-75.736532)"
2019,Junio,Benín,204,0,1,1,"(10.408582,-75.538003)"
2015,Julio,Honduras,340,14,13,27,"(10.445761,-75.516429)"
2023,Mayo,El Salvador,222,0,1,1,"(8.364293,-72.405710)"
2023,Febrero,Hong Kong,344,0,2,2,"(10.886611,-74.776708)"
2021,Julio,Chile,152,11,19,30,"(10.886611,-74.776708)"
2016,Junio,Alemania,276,89,149,238,"(6.171601,-75.427454)"
2012,Agosto,Guatemala,320,0,1,1,"(11.117806,-74.232622)"
2017,Agosto,Bélgica,56,11,14,25,"(3.541112,-76.384584)"
2014,Noviembre,Australia,36,39,68,107,"(0.814836,-77.662532)"
2023,Febrero,Eslovaquia,703,74,101,175,"(4.697144,-74.140516)"
2016,Marzo,Portugal,620,0,3,3,"(7.818934,-72.453226)"
2018,Mayo,Bermudas/Territorio Británico de Ultramar,60,0,1,1,"(3.541112,-76.384584)"
2018,Abril,Chile,152,4,6,10,"(-4.223468,-69.945098)"
2012,Agosto,Suecia,752,0,1,1,"(13.3387613,-81.372937)"
2018,Noviembre,Bahamas,44,0,1,1,"(3.541112,-76.384584)"
2014,Enero,Taiwán,158,2,0,2,"(7.927209,-72.507910)"
2018,Febrero,Nueva Zelanda,554,3,6,9,"(10.408582,-75.538003)"
2018,Enero,El Salvador,222,0,1,1,"(-4.223468,-69.945098)"
2018,Septiembre,Sudáfrica,710,0,1,1,"(10.886611,-74.776708)"
2014,Agosto,India,356,3,19,22,"(6.171601,-75.427454)"
2016,Marzo,Guatemala,320,1,0,1,"(7.927209,-72.507910)"
2019,Febrero,Alemania,276,3213,3994,7207,"(4.697144,-74.140516)"
2012,Abril,Costa Rica,188,382,673,1055,"(4.697144,-74.140516)"
2018,Mayo,República Del Congo,178,0,1,1,"(0.814836,-77.662532)"
2022,Diciembre,Chile,152,0,2,2,"(0.25129,-76.875963)"
2012,Junio,Ecuador,218,687,1185,1872,"(0.814836,-77.662532)"
2013,Enero,Aruba,533,3,0,3,"(3.541112,-76.384584)"
2021,Octubre,Chile,152,4,0,4,"(6.185799,-67.483929)"
2015,Marzo,Islas Caimán/Territorio Británico de Ultramar,136,1,0,1,"(6.171601,-75.427454)"
2018,Noviembre,Egipto,818,0,3,3,"(3.541112,-76.384584)"
2016,Julio,Egipto,818,0,2,2,"(10.886611,-74.776708)"
2016,Septiembre,Venezuela,862,334,510,844,"(0.814836,-77.662532)"
2020,Febrero,Países Bajos,528,83,96,179,"(10.886611,-74.776708)"
2018,Junio,Desconocido,99999,2,0,2,"(7.088729,-70.740253)"
2016,Noviembre,Argentina,32,0,1,1,"(4.452882,-75.766298)"
2018,Junio,Panamá,591,1,0,1,"(12.5744111,-81.703935)"
2015,Abril,Federación de Rusia,643,10,5,15,"(6.171601,-75.427454)"
2018,Diciembre,República de Corea,410,18,22,40,"(10.445761,-75.516429)"
2013,Octubre,Chile,152,28,19,47,"(12.586067,-81.702563)"
2019,Abril,España,724,2,0,2,"(11.117806,-74.232622)"
2018,Diciembre,Canadá,124,638,848,1486,"(10.445761,-75.516429)"
2017,Febrero,España,724,2,11,13,"(11.360009,-72.129330)"
2015,Diciembre,Dinamarca,208,0,1,1,"(4.815061,-75.736532)"
2021,Septiembre,Portugal,620,11,9,20,"(11.360009,-72.129330)"
2014,Septiembre,Costa Rica,188,181,138,319,"(12.586067,-81.702563)"
2019,Enero,Honduras,340,0,2,2,"(7.818934,-72.453226)"
2012,Febrero,Ecuador,218,0,3,3,"(4.815061,-75.736532)"
2022,Agosto,China,156,0,17,17,"(3.893038,-77.067921)"
2012,Enero,Sudáfrica,710,0,1,1,"(10.408582,-75.538003)"
2019,Febrero,México,484,1,3,4,"(-4.223468,-69.945098)"
2015,Mayo,Italia,380,0,1,1,"(11.247723,-74.213989)"
2023,Mayo,República de Irlanda,372,5,2,7,"(10.408582,-75.538003)"
2015,Abril,Liechtenstein,438,2,2,4,"(4.697144,-74.140516)"
2013,Septiembre,República Checa,203,1,2,3,"(11.360009,-72.129330)"
2012,Enero,Argentina,32,48,61,109,"(3.541112,-76.384584)"
2017,Junio,Vietnam,704,10,4,14,"(4.697144,-74.140516)"
2018,Octubre,Senegal,686,0,1,1,"(10.445761,-75.516429)"
2023,Enero,Honduras,340,0,1,1,"(12.586067,-81.702563)"
2019,Marzo,Alemania,276,1,1,2,"(12.5744111,-81.703935)"
2016,Mayo,Bolivia,68,0,1,1,"(7.128456,-73.183637)"
2022,Octubre,Antigua y Barbuda,28,1,3,4,"(6.171601,-75.427454)"
2013,Febrero,Guatemala,320,2,1,3,"(12.586067,-81.702563)"
2023,Abril,China,156,2,6,8,"(4.815061,-75.736532)"
2023,Marzo,Chile,152,11,30,41,"(0.814836,-77.662532)"
2019,Enero,Guatemala,320,0,5,5,"(10.408582,-75.538003)"
2013,Agosto,Suiza,756,7,10,17,"(-4.197703,-69.941278)"
2022,Enero,Francia,250,1,0,1,"(0.25129,-76.875963)"
2014,Octubre,Argentina,32,111,83,194,"(10.408582,-75.538003)"
2015,Septiembre,Países Bajos,528,0,4,4,"(10.408582,-75.538003)"
2022,Octubre,Polonia,616,0,1,1,"(4.815061,-75.736532)"
2023,Enero,Bosnia y Herzegovina,70,2,6,8,"(4.697144,-74.140516)"
2022,Abril,Jordania,400,0,1,1,"(0.814836,-77.662532)"
2019,Octubre,Paraguay,600,184,84,268,"(10.445761,-75.516429)"
2023,Febrero,Uruguay,858,1,0,1,"(7.927209,-72.507910)"
2014,Marzo,Eslovenia,705,0,1,1,"(0.814836,-77.662532)"
2021,Febrero,Costa Rica,188,37,78,115,"(6.171601,-75.427454)"
2021,Abril,Emiratos Árabes,784,2,0,2,"(4.697144,-74.140516)"
2019,Noviembre,Malta,470,2,6,8,"(4.697144,-74.140516)"
2018,Febrero,Alemania,276,47,46,93,"(10.408582,-75.538003)"
2014,Septiembre,India,356,0,5,5,"(10.408582,-75.538003)"
2015,Julio,Lituania,440,2,1,3,"(10.445761,-75.516429)"
2017,Enero,Canadá,124,24,36,60,"(10.886611,-74.776708)"
2014,Agosto,Francia,250,0,3,3,"(6.185799,-67.483929)"
2017,Octubre,Canadá,124,1,2,3,"(7.128456,-73.183637)"
2019,Junio,Turquía,792,9,13,22,"(10.445761,-75.516429)"
2023,Mayo,Noruega,578,13,8,21,"(6.171601,-75.427454)"
2018,Octubre,Perú,604,4,8,12,"(0.25129,-76.875963)"
2018,Octubre,Santa Lucia,662,0,3,3,"(6.171601,-75.427454)"
2014,Junio,Finlandia,246,30,72,102,"(4.697144,-74.140516)"
2014,Marzo,Costa Rica,188,2,2,4,"(0.814836,-77.662532)"
2021,Marzo,Grecia,300,0,6,6,"(10.445761,-75.516429)"
2022,Julio,Australia,36,2,0,2,"(7.916725,-72.462544)"
2019,Marzo,Noruega,578,0,1,1,"(4.815061,-75.736532)"
2017,Julio,Estados Unidos de América,840,10,11,21,"(8.635765,-77.346578)"
2022,Diciembre,Ecuador,218,50,63,113,"(7.818934,-72.453226)"
2014,Noviembre,Marruecos,504,0,1,1,"(10.445761,-75.516429)"
2022,Diciembre,Lituania,440,1,0,1,"(10.886611,-74.776708)"
2022,Abril,España,724,0,2,2,"(7.088729,-70.740253)"
2022,Julio,Chile,152,0,2,2,"(7.128456,-73.183637)"
2017,Febrero,República Dominicana,214,0,4,4,"(7.818934,-72.453226)"
2014,Mayo,Israel,376,0,1,1,"(1.813928,-78.763924)"
2019,Mayo,Argentina,32,91,151,242,"(0.814836,-77.662532)"
2013,Agosto,Polonia,616,3,8,11,"(6.171601,-75.427454)"
2012,Febrero,España,724,35,52,87,"(10.445761,-75.516429)"
2018,Junio,Israel,376,153,433,586,"(4.697144,-74.140516)"
2014,Enero,China,156,1,2,3,"(0.814836,-77.662532)"
2018,Febrero,Polonia,616,0,4,4,"(8.066966,-76.735404)"
2020,Diciembre,México,484,0,1,1,"(13.3387613,-81.372937)"
2013,Septiembre,Italia,380,350,1347,1697,"(4.697144,-74.140516)"
2014,Enero,Honduras,340,4,2,6,"(0.814836,-77.662532)"
2014,Marzo,Noruega,578,0,1,1,"(8.635765,-77.346578)"
2018,Diciembre,Palestina,99999,1,2,3,"(10.445761,-75.516429)"
2018,Enero,Paraguay,600,0,3,3,"(7.927209,-72.507910)"
2020,Marzo,Croacia,191,2,11,13,"(10.445761,-75.516429)"
2013,Febrero,Brasil,76,1,0,1,"(4.077098,-73.565239)"
2022,Julio,República de Corea,410,0,1,1,"(7.818934,-72.453226)"
2017,Septiembre,Países Bajos,528,60,99,159,"(10.445761,-75.516429)"
2017,Septiembre,Países Bajos,528,0,6,6,"(10.971302,-74.765397)"
2023,Febrero,Sudán,736,0,1,1,"(6.171601,-75.427454)"
2023,Abril,Malasia,458,0,1,1,"(-4.197703,-69.941278)"
2022,Diciembre,Granada,308,0,2,2,"(10.445761,-75.516429)"
2019,Mayo,Rumania,642,2,3,5,"(3.541112,-76.384584)"
2020,Diciembre,Singapur,702,2,0,2,"(6.171601,-75.427454)"
2022,Marzo,México,484,20,19,39,"(4.815061,-75.736532)"
2018,Junio,Chipre,196,1,1,2,"(10.445761,-75.516429)"
2020,Julio,Suiza,756,1,0,1,"(10.445761,-75.516429)"
2019,Agosto,Rumania,642,2,0,2,"(3.541112,-76.384584)"
2018,Febrero,Sudáfrica,710,1,2,3,"(10.886611,-74.776708)"
2017,Febrero,Brasil,76,26,40,66,"(0.814836,-77.662532)"
2017,Octubre,Argentina,32,0,3,3,"(7.128456,-73.183637)"
2019,Enero,Serbia,688,1,1,2,"(3.541112,-76.384584)"
2017,Febrero,Israel,376,8,17,25,"(0.814836,-77.662532)"
2022,Diciembre,Federación de Rusia,643,0,6,6,"(11.247723,-74.213989)"
2022,Agosto,Filipinas,608,51,53,104,"(4.697144,-74.140516)"
2016,Septiembre,Noruega,578,9,13,22,"(10.445761,-75.516429)"
2018,Enero,Noruega,578,3,8,11,"(10.408582,-75.538003)"
2012,Noviembre,China,156,1,6,7,"(10.445761,-75.516429)"
2016,Marzo,Costa Rica,188,1,1,2,"(7.818934,-72.453226)"
2021,Junio,Nicaragua,558,13,8,21,"(3.541112,-76.384584)"
2019,Junio,Australia,36,3,3,6,"(-4.223468,-69.945098)"
2013,Julio,Canadá,124,30,26,56,"(0.814836,-77.662532)"
2014,Noviembre,Barbados,52,1,0,1,"(7.128456,-73.183637)"
2019,Enero,Francia,250,23,38,61,"(10.886611,-74.776708)"
2019,Abril,Perú,604,766,1028,1794,"(6.171601,-75.427454)"
2019,Diciembre,Austria,40,1,1,2,"(7.818934,-72.453226)"
2017,Diciembre,Bélgica,56,1,3,4,"(-4.223468,-69.945098)"
2014,Mayo,Rwanda,646,0,1,1,"(3.541112,-76.384584)"
2019,Noviembre,Turquía,792,1,2,3,"(10.886611,-74.776708)"
2021,Abril,Canadá,124,44,28,72,"(3.541112,-76.384584)"
2016,Abril,Uruguay,858,0,7,7,"(7.818934,-72.453226)"
2019,Diciembre,Líbano,422,17,30,47,"(4.697144,-74.140516)"
2023,Junio,Dinamarca,208,1,0,1,"(10.408582,-75.538003)"
2022,Octubre,República Checa,203,0,1,1,"(-4.223468,-69.945098)"
2015,Enero,Estados Unidos de América,840,0,1,1,"(11.117806,-74.232622)"
2019,Junio,Italia,380,16,29,45,"(7.818934,-72.453226)"
2022,Junio,República de Corea,410,0,1,1,"(10.886611,-74.776708)"
2020,Enero,Eslovenia,705,2,2,4,"(10.445761,-75.516429)"
2022,Febrero,Sudáfrica,710,3,1,4,"(10.445761,-75.516429)"
2020,Enero,Francia,250,1,1,2,"(10.971302,-74.765397)"
2019,Abril,Italia,380,22,91,113,"(3.541112,-76.384584)"
2021,Diciembre,Noruega,578,98,145,243,"(4.697144,-74.140516)"
2017,Mayo,Finlandia,246,4,0,4,"(0.814836,-77.662532)"
2018,Junio,Suiza,756,1,0,1,"(7.818934,-72.453226)"
2023,Enero,Polonia,616,44,86,130,"(6.171601,-75.427454)"
2014,Agosto,Reino Unido de Gran Bretaña e Irlanda del Norte,826,3,0,3,"(4.452882,-75.766298)"
2022,Abril,Tailandia,764,1,2,3,"(10.408582,-75.538003)"
2023,Enero,México,484,680,822,1502,"(10.445761,-75.516429)"
2022,Marzo,Panamá,591,0,4,4,"(3.893038,-77.067921)"
2017,Agosto,Ecuador,218,3939,4382,8321,"(4.697144,-74.140516)"
2019,Septiembre,Ucrania,804,0,1,1,"(11.247723,-74.213989)"
2015,Septiembre,Guyana,328,0,1,1,"(10.886611,-74.776708)"
2023,Junio,Islas Turcas y Caicos/Territorio Británico de Ultramar,796,0,2,2,"(6.171601,-75.427454)"
2012,Noviembre,Argentina,32,4,18,22,"(10.886611,-74.776708)"
2023,Abril,República de Corea,410,0,2,2,"(-4.197703,-69.941278)"
2013,Septiembre,Canadá,124,2,2,4,"(-4.197703,-69.941278)"
2014,Abril,San Cristóbal y Nevis,659,3,3,6,"(4.697144,-74.140516)"
2016,Julio,Taiwán,158,63,93,156,"(4.697144,-74.140516)"
2017,Septiembre,Francia,250,1,0,1,"(-4.223468,-69.945098)"
2019,Julio,Suecia,752,9,17,26,"(3.541112,-76.384584)"
2019,Septiembre,Pakistán,586,1,0,1,"(10.445761,-75.516429)"
2019,Agosto,Federación de Rusia,643,7,7,14,"(0.814836,-77.662532)"
2022,Febrero,Nueva Zelanda,554,3,2,5,"(10.408582,-75.538003)"
2020,Noviembre,Italia,380,7,17,24,"(3.541112,-76.384584)"
2017,Agosto,Ecuador,218,150,196,346,"(7.818934,-72.453226)"
2017,Agosto,Hungría,348,0,2,2,"(7.818934,-72.453226)"
2015,Julio,México,484,0,3,3,"(10.408582,-75.538003)"
2012,Mayo,Estados Unidos de América,840,56,78,134,"(0.814836,-77.662532)"
2018,Noviembre,Polonia,616,0,2,2,"(8.635765,-77.346578)"
2013,Agosto,Líbano,422,1,0,1,"(12.586067,-81.702563)"
2019,Junio,Ecuador,218,0,1,1,"(11.117806,-74.232622)"
2017,Marzo,Estados Unidos de América,840,2,1,3,"(1.813928,-78.763924)"
2019,Mayo,España,724,2454,5636,8090,"(4.697144,-74.140516)"
2014,Marzo,Tailandia,764,0,1,1,"(6.171601,-75.427454)"
2022,Enero,Guatemala,320,0,1,1,"(7.927209,-72.507910)"
2016,Enero,Ecuador,218,1492,2450,3942,"(0.814836,-77.662532)"
2012,Agosto,República Dominicana,214,226,268,494,"(4.697144,-74.140516)"
2021,Enero,Paraguay,600,9,7,16,"(6.171601,-75.427454)"
2019,Enero,Uruguay,858,2,2,4,"(4.815061,-75.736532)"
2022,Enero,Taiwán,158,0,2,2,"(3.541112,-76.384584)"
2015,Marzo,Serbia,688,11,18,29,"(4.697144,-74.140516)"
2018,Septiembre,Filipinas,608,2,30,32,"(10.408582,-75.538003)"
2017,Julio,Trinidad y Tobago,780,22,33,55,"(4.697144,-74.140516)"
2014,Mayo,Lituania,440,2,0,2,"(6.171601,-75.427454)"
2015,Septiembre,China,156,2,9,11,"(7.818934,-72.453226)"
2014,Marzo,Suecia,752,1,4,5,"(-4.197703,-69.941278)"
2022,Marzo,Brasil,76,3,2,5,"(4.452882,-75.766298)"
2022,Julio,Suiza,756,0,4,4,"(4.452882,-75.766298)"
2017,Mayo,Perú,604,5,10,15,"(4.815061,-75.736532)"
2017,Abril,Mozambique,508,1,4,5,"(3.541112,-76.384584)"
2017,Enero,Guyana,328,1,0,1,"(7.818934,-72.453226)"
2022,Noviembre,Venezuela,862,15,22,37,"(4.815061,-75.736532)"
2013,Mayo,Reino Unido de Gran Bretaña e Irlanda del Norte,826,10,25,35,"(6.171601,-75.427454)"
2023,Marzo,Portugal,620,0,1,1,"(7.088729,-70.740253)"
2020,Febrero,República Checa,203,125,234,359,"(4.697144,-74.140516)"
2023,Abril,Países Bajos,528,1,0,1,"(12.5744111,-81.703935)"
2014,Febrero,Argentina,32,589,507,1096,"(10.445761,-75.516429)"
2018,Diciembre,Cuba,192,15,39,54,"(10.445761,-75.516429)"
2023,Febrero,México,484,1,2,3,"(10.408582,-75.538003)"
2014,Septiembre,Francia,250,1,3,4,"(7.128456,-73.183637)"
2022,Febrero,Perú,604,18,74,92,"(0.814836,-77.662532)"
2015,Marzo,Noruega,578,8,9,17,"(10.408582,-75.538003)"
2016,Agosto,Chile,152,1,2,3,"(0.25129,-76.875963)"
2015,Junio,Canadá,124,6,3,9,"(-4.197703,-69.941278)"
2014,Junio,Brasil,76,11,2,13,"(7.927209,-72.507910)"
2013,Enero,Reino Unido de Gran Bretaña e Irlanda del Norte,826,2,7,9,"(7.818934,-72.453226)"
2020,Noviembre,Honduras,340,85,81,166,"(4.697144,-74.140516)"
2022,Diciembre,Nueva Zelanda,554,1,1,2,"(0.814836,-77.662532)"
2014,Diciembre,Indonesia,360,7,17,24,"(4.697144,-74.140516)"
2022,Junio,Belice,84,0,3,3,"(10.445761,-75.516429)"
2018,Mayo,Brasil,76,19,29,48,"(0.814836,-77.662532)"
2014,Septiembre,Malawi,454,0,1,1,"(4.697144,-74.140516)"
2015,Mayo,Japón,392,0,1,1,"(7.927209,-72.507910)"
2023,Febrero,Dinamarca,208,16,30,46,"(6.171601,-75.427454)"
2017,Abril,Australia,36,41,90,131,"(6.171601,-75.427454)"
2017,Septiembre,Japón,392,0,6,6,"(10.886611,-74.776708)"
2018,Junio,Bélgica,56,15,25,40,"(3.541112,-76.384584)"
2018,Agosto,Estados Unidos de América,840,7,11,18,"(8.635765,-77.346578)"
2023,Enero,España,724,39,53,92,"(0.814836,-77.662532)"
2016,Enero,República Checa,203,1,1,2,"(12.586067,-81.702563)"
2020,Enero,República de Belarús,112,7,5,12,"(4.697144,-74.140516)"
2023,Junio,Ucrania,804,2,0,2,"(0.814836,-77.662532)"
2018,Septiembre,Australia,36,1,0,1,"(7.088729,-70.740253)"
2021,Enero,Irán,364,1,1,2,"(4.697144,-74.140516)"
2019,Junio,Costa Rica,188,0,3,3,"(7.818934,-72.453226)"
2021,Agosto,Guatemala,320,5,8,13,"(4.815061,-75.736532)"
2016,Junio,Ecuador,218,1,2,3,"(7.128456,-73.183637)"
2016,Mayo,Países Bajos,528,349,456,805,"(6.171601,-75.427454)"
2015,Diciembre,República Democrática del Congo,180,1,0,1,"(6.171601,-75.427454)"
2017,Diciembre,Paraguay,600,45,34,79,"(12.586067,-81.702563)"
2013,Septiembre,Costa Rica,188,2,2,4,"(8.635765,-77.346578)"
2017,Diciembre,Austria,40,21,28,49,"(10.445761,-75.516429)"
2019,Enero,Francia,250,6,9,15,"(4.815061,-75.736532)"
2019,Marzo,Belice,84,5,14,19,"(4.697144,-74.140516)"
2022,Julio,República de Moldavia,498,1,0,1,"(10.445761,-75.516429)"
2014,Agosto,Canadá,124,5,3,8,"(12.586067,-81.702563)"
2016,Enero,Dinamarca,208,6,11,17,"(0.814836,-77.662532)"
2015,Junio,Francia,250,88,123,211,"(0.814836,-77.662532)"
2017,Enero,Alemania,276,99,138,237,"(10.445761,-75.516429)"
2018,Marzo,Belice,84,3,1,4,"(0.814836,-77.662532)"
2015,Diciembre,Noruega,578,0,1,1,"(11.360009,-72.129330)"
2014,Diciembre,Portugal,620,3,20,23,"(3.541112,-76.384584)"
2021,Abril,Paraguay,600,1,6,7,"(10.886611,-74.776708)"
2015,Julio,Bolivia,68,544,588,1132,"(4.697144,-74.140516)"
2016,Julio,Paraguay,600,44,33,77,"(12.586067,-81.702563)"
2014,Abril,Ucrania,804,2,4,6,"(6.171601,-75.427454)"
2016,Mayo,Lituania,440,1,2,3,"(10.408582,-75.538003)"
2021,Marzo,Francia,250,8,15,23,"(3.541112,-76.384584)"
2012,Agosto,Filipinas,608,1,1,2,"(11.247723,-74.213989)"
2013,Octubre,Argentina,32,2,10,12,"(7.927209,-72.507910)"
2016,Agosto,Guatemala,320,7,7,14,"(7.128456,-73.183637)"
2012,Junio,Turquía,792,0,1,1,"(10.408582,-75.538003)"
2015,Abril,Noruega,578,0,1,1,"(11.360009,-72.129330)"
2023,Enero,República Dominicana,214,1,4,5,"(7.916725,-72.462544)"
2016,Octubre,Honduras,340,78,109,187,"(6.171601,-75.427454)"
2018,Febrero,Suecia,752,15,10,25,"(10.408582,-75.538003)"
2017,Febrero,Panamá,591,0,1,1,"(11.360009,-72.129330)"
2022,Febrero,Reino Unido de Gran Bretaña e Irlanda del Norte,826,4,6,10,"(4.815061,-75.736532)"
2014,Diciembre,Jamaica,388,2,1,3,"(3.541112,-76.384584)"
2014,Octubre,Vietnam,704,1,0,1,"(4.697144,-74.140516)"
2012,Enero,Federación de Rusia,643,3,1,4,"(10.445761,-75.516429)"
2017,Agosto,Canadá,124,0,1,1,"(0.25129,-76.875963)"
2016,Septiembre,Nepal,524,0,1,1,"(4.697144,-74.140516)"
2019,Julio,Montenegro,499,0,2,2,"(10.408582,-75.538003)"
2022,Agosto,Venezuela,862,0,4,4,"(6.17134,-75.427194)"
2020,Octubre,Ucrania,804,0,2,2,"(10.445761,-75.516429)"
2022,Marzo,Suecia,752,2,4,6,"(10.886611,-74.776708)"
2022,Septiembre,México,484,64,89,153,"(10.886611,-74.776708)"
2014,Abril,Mónaco,492,0,1,1,"(4.697144,-74.140516)"
2014,Septiembre,Canadá,124,3,4,7,"(4.452882,-75.766298)"
2014,Octubre,Reino Unido de Gran Bretaña e Irlanda del Norte,826,0,16,16,"(3.893038,-77.067921)"
2012,Enero,Filipinas,608,2,6,8,"(10.445761,-75.516429)"
2019,Noviembre,Israel,376,98,314,412,"(4.697144,-74.140516)"
2021,Julio,Rumania,642,0,2,2,"(10.886611,-74.776708)"
2012,Junio,Brasil,76,0,1,1,"(7.128456,-73.183637)"
2016,Diciembre,Alemania,276,1,9,10,"(7.818934,-72.453226)"
2020,Enero,República de Irlanda,372,2,5,7,"(10.408582,-75.538003)"
2014,Mayo,Francia,250,833,1715,2548,"(4.697144,-74.140516)"
2016,Octubre,Mozambique,508,1,0,1,"(10.408582,-75.538003)"
2014,Octubre,Estonia,233,1,0,1,"(10.445761,-75.516429)"
2017,Noviembre,Bulgaria,100,5,2,7,"(3.541112,-76.384584)"
2015,Junio,Grecia,300,0,1,1,"(-4.197703,-69.941278)"
2016,Abril,Honduras,340,30,26,56,"(10.445761,-75.516429)"
2023,Junio,Nigeria,566,0,3,3,"(6.171601,-75.427454)"
2022,Enero,Costa Rica,188,0,1,1,"(4.452882,-75.766298)"
2014,Mayo,Paraguay,600,73,39,112,"(12.586067,-81.702563)"
2013,Diciembre,Finlandia,246,0,1,1,"(11.117806,-74.232622)"
2014,Julio,Chile,152,76,65,141,"(10.445761,-75.516429)"
2019,Agosto,Francia,250,0,1,1,"(12.586067,-81.702563)"
2018,Marzo,Perú,604,226,153,379,"(12.586067,-81.702563)"
2014,Diciembre,Dominica,212,2,2,4,"(4.697144,-74.140516)"
2018,Marzo,Uruguay,858,40,70,114,"(6.171601,-75.427454)"
2013,Junio,República de Moldavia,498,1,1,2,"(4.697144,-74.140516)"
2013,Agosto,El Salvador,222,2,0,2,"(10.886611,-74.776708)"
2015,Julio,Paraguay,600,11,12,23,"(3.541112,-76.384584)"
2015,Diciembre,Federación de Rusia,643,7,6,13,"(10.445761,-75.516429)"
2012,Octubre,Australia,36,0,1,1,"(4.815061,-75.736532)"
2015,Enero,Perú,604,3,5,8,"(0.25129,-76.875963)"
2015,Enero,Bolivia,68,31,28,59,"(3.541112,-76.384584)"
2016,Enero,Sudáfrica,710,1,0,1,"(10.408582,-75.538003)"
2016,Febrero,Alemania,276,0,5,5,"(4.815061,-75.736532)"
2018,Septiembre,Estados Unidos de América,840,4,9,13,"(-4.223468,-69.945098)"
2013,Febrero,República de Belarús,112,2,0,2,"(4.697144,-74.140516)"
2022,Mayo,Georgia,268,0,1,1,"(11.247723,-74.213989)"
2021,Enero,Turquía,792,0,2,2,"(10.971302,-74.765397)"
2020,Marzo,Estados Unidos de América,840,1,1,2,"(-4.197703,-69.941278)"
2021,Diciembre,El Salvador,222,0,1,1,"(7.818934,-72.453226)"
2016,Octubre,Honduras,340,0,1,1,"(7.818934,-72.453226)"
2014,Enero,Nicaragua,558,2,3,5,"(10.445761,-75.516429)"
2014,Octubre,Portugal,620,0,3,3,"(4.815061,-75.736532)"
2019,Septiembre,Suecia,752,5,11,16,"(3.541112,-76.384584)"
2023,Mayo,Indonesia,360,0,2,2,"(11.117806,-74.232622)"
2016,Junio,Suecia,752,17,33,50,"(10.445761,-75.516429)"
2017,Diciembre,Turquía,792,0,1,1,"(3.893038,-77.067921)"
2019,Abril,Bélgica,56,0,1,1,"(12.5744111,-81.703935)"
2013,Marzo,Honduras,340,2,0,2,"(7.818934,-72.453226)"
2019,Octubre,Noruega,578,82,120,202,"(4.697144,-74.140516)"
2016,Junio,República de Irlanda,372,3,5,8,"(10.408582,-75.538003)"
2012,Julio,Francia,250,0,1,1,"(4.815061,-75.736532)"
2014,Octubre,Federación de Rusia,643,1,0,1,"(4.452882,-75.766298)"
2014,Septiembre,Guatemala,320,7,7,14,"(12.586067,-81.702563)"
2022,Noviembre,Bahamas,44,8,13,21,"(4.697144,-74.140516)"
2019,Octubre,Filipinas,608,0,47,47,"(3.893038,-77.067921)"
2018,Junio,Dinamarca,208,7,25,32,"(6.171601,-75.427454)"
2014,Abril,Guatemala,320,58,65,123,"(12.586067,-81.702563)"
2019,Abril,Kazajistán,398,1,1,2,"(0.814836,-77.662532)"
2018,Febrero,China,156,1,2,3,"(8.36068,-72.409396)"
2016,Mayo,Rumania,642,4,6,10,"(10.445761,-75.516429)"
2014,Septiembre,Marruecos,504,11,5,16,"(4.697144,-74.140516)"
2018,Febrero,Montenegro,499,0,5,5,"(10.445761,-75.516429)"
2016,Febrero,Rumania,642,46,68,114,"(4.697144,-74.140516)"
2015,Septiembre,República de Irlanda,372,2,8,10,"(8.635765,-77.346578)"
2018,Abril,República de Corea,410,8,34,42,"(6.171601,-75.427454)"
2021,Octubre,Países Bajos,528,0,1,1,"(7.818934,-72.453226)"
2022,Noviembre,Venezuela,862,0,2,2,"(6.17134,-75.427194)"
2017,Noviembre,Suecia,752,23,34,57,"(10.445761,-75.516429)"
2014,Noviembre,Portugal,620,239,553,792,"(4.697144,-74.140516)"
2014,Octubre,Alemania,276,14,33,47,"(10.408582,-75.538003)"
2022,Julio,Serbia,688,1,2,3,"(10.445761,-75.516429)"
2015,Marzo,Uruguay,858,189,348,537,"(4.697144,-74.140516)"
2015,Septiembre,Albania,8,1,1,2,"(4.697144,-74.140516)"
2016,Agosto,Suiza,756,8,15,23,"(10.408582,-75.538003)"
2022,Octubre,Rumania,642,1,26,27,"(10.408582,-75.538003)"
2022,Julio,Letonia,428,0,1,1,"(10.971302,-74.765397)"
2016,Agosto,Brasil,76,45,84,129,"(3.541112,-76.384584)"
2014,Diciembre,Cuba,192,1,3,4,"(4.815061,-75.736532)"
2015,Noviembre,Jamaica,388,2,12,14,"(12.586067,-81.702563)"
2019,Abril,Polonia,616,3,13,16,"(3.541112,-76.384584)"
2019,Julio,Venezuela,862,1,0,1,"(4.452882,-75.766298)"
2021,Diciembre,Brasil,76,2,6,8,"(4.452882,-75.766298)"
2012,Mayo,Filipinas,608,0,2,2,"(3.893038,-77.067921)"
2016,Diciembre,Trinidad y Tobago,780,3,8,11,"(3.541112,-76.384584)"
2018,Septiembre,Canadá,124,811,1448,2259,"(4.697144,-74.140516)"
2022,Enero,India,356,5,45,51,"(10.445761,-75.516429)"
2015,Marzo,Austria,40,4,20,24,"(6.171601,-75.427454)"
2017,Agosto,Suiza,756,0,1,1,"(11.360009,-72.129330)"
2017,Diciembre,Hungría,348,1,0,1,"(-4.223468,-69.945098)"
2017,Febrero,Suiza,756,5,5,10,"(10.886611,-74.776708)"
2016,Enero,Chile,152,2,3,5,"(0.25129,-76.875963)"
2013,Abril,República de Irlanda,372,0,1,1,"(10.886611,-74.776708)"
2022,Abril,Suecia,752,132,172,304,"(4.697144,-74.140516)"
2023,Abril,Austria,40,1,2,3,"(7.128456,-73.183637)"
2019,Enero,Paraguay,600,141,95,237,"(10.445761,-75.516429)"
2017,Octubre,Sri Lanka,144,0,4,4,"(10.971302,-74.765397)"
2020,Octubre,Andorra,20,0,1,1,"(4.697144,-74.140516)"
2023,Abril,Israel,376,3,13,16,"(-4.223468,-69.945098)"
2016,Septiembre,Brasil,76,114,227,341,"(6.171601,-75.427454)"
2022,Febrero,Estados Unidos de América,840,92,179,271,"(7.128456,-73.183637)"
2023,Marzo,Canadá,124,2362,3754,6116,"(4.697144,-74.140516)"
2017,Agosto,Lituania,440,17,15,32,"(4.697144,-74.140516)"
2022,Diciembre,Dinamarca,208,19,32,51,"(6.171601,-75.427454)"
2018,Octubre,Venezuela,862,173,175,348,"(10.445761,-75.516429)"
2017,Octubre,Guatemala,320,1,1,2,"(4.452882,-75.766298)"
2014,Marzo,Perú,604,134,349,483,"(0.814836,-77.662532)"
2020,Septiembre,Paraguay,600,0,1,1,"(6.171601,-75.427454)"
2015,Junio,Líbano,422,1,1,2,"(3.541112,-76.384584)"
2023,Marzo,Países Bajos,528,21,13,34,"(8.635765,-77.346578)"
2018,Julio,Uruguay,858,0,3,3,"(0.25129,-76.875963)"
2016,Mayo,Sudáfrica,710,3,3,6,"(10.408582,-75.538003)"
2019,Mayo,Vietnam,704,19,18,37,"(4.697144,-74.140516)"
2021,Abril,Italia,380,12,21,33,"(3.541112,-76.384584)"
2017,Agosto,Noruega,578,4,8,12,"(3.541112,-76.384584)"
2013,Enero,Australia,36,0,1,1,"(7.927209,-72.507910)"
2015,Septiembre,Perú,604,56,92,148,"(-4.197703,-69.941278)"
2016,Enero,Ucrania,804,31,34,65,"(4.697144,-74.140516)"
2017,Octubre,Tailandia,764,39,33,72,"(4.697144,-74.140516)"
2018,Abril,Australia,36,50,96,146,"(6.171601,-75.427454)"
2017,Febrero,Polonia,616,145,218,363,"(4.697144,-74.140516)"
2021,Julio,China,156,56,186,242,"(4.697144,-74.140516)"
2020,Junio,Bahréin,48,0,1,1,"(4.697144,-74.140516)"
2022,Abril,Guatemala,320,558,767,1325,"(4.697144,-74.140516)"
2017,Noviembre,Turquía,792,0,2,2,"(7.818934,-72.453226)"
2017,Julio,Indonesia,360,24,33,57,"(4.697144,-74.140516)"
2017,Junio,Estados Unidos de América,840,42,83,125,"(7.128456,-73.183637)"
2019,Marzo,Pakistán,586,0,2,2,"(3.541112,-76.384584)"
2014,Septiembre,Nueva Zelanda,554,2,4,6,"(10.408582,-75.538003)"
2021,Enero,Turkmenistán,795,0,1,1,"(4.697144,-74.140516)"
2020,Febrero,Suecia,752,1,1,2,"(0.25129,-76.875963)"
2023,Enero,México,484,3,4,7,"(10.408582,-75.538003)"
2013,Enero,Isla de Man,833,5,12,17,"(10.445761,-75.516429)"
2016,Marzo,Noruega,578,10,16,26,"(6.171601,-75.427454)"
2018,Abril,Eslovenia,705,0,2,2,"(10.886611,-74.776708)"
2015,Octubre,Lituania,440,1,2,3,"(10.408582,-75.538003)"
2012,Agosto,Portugal,620,1,3,4,"(0.814836,-77.662532)"
2012,Agosto,Líbano,422,0,1,1,"(10.886611,-74.776708)"
2022,Septiembre,Filipinas,608,1,12,13,"(10.886611,-74.776708)"
2018,Marzo,Andorra,20,0,1,1,"(6.171601,-75.427454)"
2018,Enero,España,724,2,3,5,"(12.586067,-81.702563)"
2014,Noviembre,Guatemala,320,6,12,18,"(7.818934,-72.453226)"
2016,Septiembre,Noruega,578,1,10,11,"(10.886611,-74.776708)"
2017,Septiembre,Líbano,422,2,1,3,"(10.445761,-75.516429)"
2017,Diciembre,Estados Unidos de América,840,3,7,10,"(11.360009,-72.129330)"
2019,Diciembre,Brasil,76,19,31,50,"(10.886611,-74.776708)"
2017,Diciembre,Indonesia,360,0,1,1,"(3.541112,-76.384584)"
2022,Julio,Suecia,752,11,25,36,"(3.541112,-76.384584)"
2017,Septiembre,República de Irlanda,372,132,210,342,"(4.697144,-74.140516)"
2018,Septiembre,Marruecos,504,2,3,5,"(6.171601,-75.427454)"
2016,Febrero,Trinidad y Tobago,780,2,0,2,"(7.128456,-73.183637)"
2015,Octubre,India,356,0,5,5,"(10.408582,-75.538003)"
2017,Agosto,Malasia,458,1,5,6,"(6.171601,-75.427454)"
2020,Marzo,Bélgica,56,10,13,23,"(0.814836,-77.662532)"
2013,Febrero,Malasia,458,13,18,31,"(4.697144,-74.140516)"
2012,Noviembre,Francia,250,9,9,18,"(11.247723,-74.213989)"
2022,Abril,Estados Unidos de América,840,2599,3013,5613,"(3.541112,-76.384584)"
2015,Marzo,República Dominicana,214,0,4,4,"(11.360009,-72.129330)"
2013,Julio,Angola,24,0,1,1,"(10.445761,-75.516429)"
2016,Septiembre,Estonia,233,0,1,1,"(10.445761,-75.516429)"
2015,Julio,Reino Unido de Gran Bretaña e Irlanda del Norte,826,1,1,2,"(7.128456,-73.183637)"
2017,Marzo,Turquía,792,0,1,1,"(-4.197703,-69.941278)"
2017,Septiembre,Federación de Rusia,643,12,7,19,"(6.171601,-75.427454)"
2023,Junio,Sri Lanka,144,0,1,1,"(6.171601,-75.427454)"
2018,Noviembre,Myanmar,104,1,1,2,"(4.697144,-74.140516)"
2012,Noviembre,Malta,470,0,2,2,"(4.697144,-74.140516)"
2023,Abril,Venezuela,862,520,416,936,"(7.927209,-72.507910)"
2014,Enero,Suiza,756,28,54,82,"(6.171601,-75.427454)"
2022,Abril,Reino Unido de Gran Bretaña e Irlanda del Norte,826,120,202,322,"(10.445761,-75.516429)"
2014,Marzo,Honduras,340,22,27,49,"(6.171601,-75.427454)"
2014,Noviembre,México,484,2,28,30,"(4.815061,-75.736532)"
2017,Julio,El Salvador,222,0,3,3,"(0.814836,-77.662532)"
2020,Marzo,Alemania,276,1,6,7,"(-4.197703,-69.941278)"
2021,Agosto,Noruega,578,25,43,68,"(4.697144,-74.140516)"
2016,Febrero,Eslovenia,705,27,25,52,"(4.697144,-74.140516)"
2014,Septiembre,Venezuela,862,32,141,173,"(10.886611,-74.776708)"
2023,Junio,Uganda,800,0,1,1,"(3.541112,-76.384584)"
2014,Mayo,Cuba,192,0,3,3,"(4.815061,-75.736532)"
2018,Octubre,Panamá,591,10,9,19,"(7.128456,-73.183637)"
2013,Mayo,España,724,7,5,12,"(0.814836,-77.662532)"
2014,Marzo,Honduras,340,10,13,23,"(10.445761,-75.516429)"
2015,Abril,Guyana,328,1,1,2,"(10.445761,-75.516429)"
2023,Marzo,Chile,152,4621,5490,10111,"(4.697144,-74.140516)"
2014,Junio,Panamá,591,1,5,6,"(10.408582,-75.538003)"
2019,Marzo,Libia,434,0,2,2,"(4.697144,-74.140516)"
2017,Julio,Eslovaquia,703,1,0,1,"(0.814836,-77.662532)"
2018,Julio,Nicaragua,558,2,1,3,"(4.815061,-75.736532)"
2021,Septiembre,Costa Rica,188,0,1,1,"(8.635765,-77.346578)"
2015,Julio,Hungría,348,35,49,84,"(4.697144,-74.140516)"
2015,Junio,Reino Unido de Gran Bretaña e Irlanda del Norte,826,12,17,29,"(8.635765,-77.346578)"
2013,Julio,Bélgica,56,68,107,175,"(3.541112,-76.384584)"
2020,Octubre,Panamá,591,37,49,86,"(10.445761,-75.516429)"
2018,Octubre,Argentina,32,0,2,2,"(1.813928,-78.763924)"
2018,Enero,Haití,332,3,6,9,"(6.171601,-75.427454)"
2014,Agosto,Uruguay,858,3,5,8,"(0.814836,-77.662532)"
2015,Septiembre,Italia,380,279,166,445,"(3.541112,-76.384584)"
2015,Marzo,Suecia,752,7,19,26,"(10.445761,-75.516429)"
2016,Febrero,Guyana,328,0,1,1,"(10.408582,-75.538003)"
2015,Agosto,Bahamas,44,0,1,1,"(3.541112,-76.384584)"
2015,Septiembre,Camboya,116,0,1,1,"(4.697144,-74.140516)"
2012,Junio,España,724,1763,4189,5952,"(4.697144,-74.140516)"
2023,Febrero,Uruguay,858,1,0,1,"(11.360009,-72.129330)"
2015,Septiembre,Nueva Zelanda,554,4,12,16,"(6.171601,-75.427454)"
2015,Octubre,Portugal,620,6,10,16,"(10.445761,-75.516429)"
2018,Noviembre,Países Bajos,528,1,7,8,"(7.818934,-72.453226)"
2017,Marzo,Bélgica,56,1,1,2,"(8.635765,-77.346578)"
2018,Diciembre,Países Bajos,528,0,1,1,"(11.117806,-74.232622)"
2023,Febrero,Andorra,20,7,9,16,"(4.697144,-74.140516)"
2018,Diciembre,Lituania,440,2,0,2,"(3.541112,-76.384584)"
2017,Septiembre,India,356,6,40,46,"(10.445761,-75.516429)"
2018,Enero,Cuba,192,0,1,1,"(7.088729,-70.740253)"
2021,Agosto,Bulgaria,100,0,2,2,"(10.408582,-75.538003)"
2019,Mayo,Panamá,591,0,2,2,"(11.360009,-72.129330)"
2020,Octubre,República Checa,203,0,4,4,"(6.171601,-75.427454)"
2021,Julio,Países Bajos,528,3,3,6,"(7.128456,-73.183637)"
2022,Junio,Burundi,108,1,0,1,"(4.697144,-74.140516)"
2020,Octubre,Egipto,818,0,1,1,"(10.445761,-75.516429)"
2014,Septiembre,Israel,376,0,5,5,"(-4.197703,-69.941278)"
2014,Diciembre,Austria,40,2,5,7,"(12.586067,-81.702563)"
2017,Mayo,Italia,380,543,1578,2121,"(4.697144,-74.140516)"
2022,Junio,Desconocido,99999,1,2,3,"(10.445761,-75.516429)"
2019,Julio,Barbados,52,2,7,9,"(6.171601,-75.427454)"
2021,Septiembre,Perú,604,0,4,4,"(11.360009,-72.129330)"
2020,Octubre,Túnez,788,0,1,1,"(3.541112,-76.384584)"
2019,Febrero,Irán,364,0,1,1,"(10.408582,-75.538003)"
2016,Noviembre,Uruguay,858,1,1,2,"(-4.197703,-69.941278)"
2018,Octubre,Suecia,752,7,8,15,"(0.814836,-77.662532)"
2013,Noviembre,Paraguay,600,15,49,64,"(6.171601,-75.427454)"
2022,Marzo,Chile,152,44,37,81,"(12.586067,-81.702563)"
2023,Marzo,Venezuela,862,4,4,8,"(3.866713,-67.927521)"
2014,Noviembre,España,724,0,1,1,"(7.088729,-70.740253)"
2019,Abril,Pakistán,586,1,0,1,"(3.541112,-76.384584)"
2018,Julio,Paraguay,600,0,3,3,"(7.818934,-72.453226)"
2018,Enero,Venezuela,862,24,24,48,"(0.25129,-76.875963)"
2014,Octubre,Filipinas,608,3,27,30,"(10.445761,-75.516429)"
2013,Diciembre,Sudáfrica,710,1,1,2,"(10.886611,-74.776708)"
2017,Marzo,Panamá,591,0,1,1,"(11.247723,-74.213989)"
2022,Julio,Mozambique,508,1,0,1,"(6.171601,-75.427454)"
2019,Noviembre,Israel,376,16,48,64,"(10.445761,-75.516429)"
2016,Febrero,Haití,332,0,2,2,"(10.445761,-75.516429)"
2017,Enero,Federación de Rusia,643,17,14,31,"(10.445761,-75.516429)"
2021,Marzo,Antigua y Barbuda,28,1,0,1,"(6.171601,-75.427454)"
2023,Junio,China,156,1,0,1,"(4.452882,-75.766298)"
2018,Junio,Ucrania,804,0,3,3,"(3.893038,-77.067921)"
2013,Julio,Tailandia,764,1,0,1,"(10.408582,-75.538003)"
2020,Enero,Gambia,270,0,1,1,"(10.445761,-75.516429)"
2016,Julio,Francia,250,87,122,209,"(10.445761,-75.516429)"
2018,Junio,Polonia,616,0,9,9,"(10.408582,-75.538003)"
2018,Julio,Chipre,196,4,5,9,"(4.697144,-74.140516)"
2013,Marzo,Chile,152,9,14,23,"(11.360009,-72.129330)"
2013,Marzo,Pakistán,586,0,1,1,"(7.818934,-72.453226)"
2023,Abril,Alemania,276,184,302,486,"(6.171601,-75.427454)"
2012,Agosto,Haití,332,0,2,2,"(10.445761,-75.516429)"
2022,Junio,Kuwait,414,2,2,4,"(4.697144,-74.140516)"
2018,Diciembre,Angola,24,2,1,3,"(10.445761,-75.516429)"
2014,Septiembre,Reino Unido de Gran Bretaña e Irlanda del Norte,826,1,1,2,"(0.25129,-76.875963)"
2019,Octubre,Desconocido,99999,6,6,12,"(10.445761,-75.516429)"
2013,Marzo,Costa Rica,188,53,58,111,"(10.445761,-75.516429)"
2015,Agosto,Croacia,191,1,2,3,"(10.445761,-75.516429)"
2023,Abril,Bermudas/Territorio Británico de Ultramar,60,1,0,1,"(4.697144,-74.140516)"
2013,Noviembre,Iraq,368,1,0,1,"(10.886611,-74.776708)"
2022,Enero,Malta,470,0,1,1,"(10.445761,-75.516429)"
2019,Noviembre,Islas Caimán/Territorio Británico de Ultramar,136,0,1,1,"(4.697144,-74.140516)"
2018,Julio,República de Irlanda,372,1,3,4,"(4.815061,-75.736532)"
2012,Agosto,Canadá,124,7,9,16,"(10.408582,-75.538003)"
2018,Noviembre,República de Irlanda,372,7,14,21,"(8.635765,-77.346578)"
2012,Julio,Madagascar,450,1,0,1,"(6.171601,-75.427454)"
2012,Noviembre,Polonia,616,2,4,6,"(0.814836,-77.662532)"
2014,Septiembre,Liechtenstein,438,1,1,2,"(4.697144,-74.140516)"
2014,Febrero,Ecuador,218,17,24,41,"(10.886611,-74.776708)"
2015,Enero,Países Bajos,528,18,30,48,"(10.408582,-75.538003)"
2015,Enero,Japón,392,14,35,49,"(3.541112,-76.384584)"
2012,Enero,India,356,0,1,1,"(4.815061,-75.736532)"
2013,Julio,Bélgica,56,0,1,1,"(7.128456,-73.183637)"
2021,Diciembre,Guinea,324,0,1,1,"(4.697144,-74.140516)"
2012,Diciembre,México,484,3,3,6,"(12.586067,-81.702563)"
2023,Marzo,Islas Vírgenes Británicas/Territorio Británico de Ultramar,92,1,0,1,"(10.445761,-75.516429)"
2019,Febrero,Japón,392,8,7,15,"(0.814836,-77.662532)"
2019,Junio,Afganistán,4,1,1,2,"(4.697144,-74.140516)"
2016,Marzo,Australia,36,2,1,3,"(4.815061,-75.736532)"
2016,Mayo,República Democrática del Congo,180,0,1,1,"(4.697144,-74.140516)"
2020,Enero,Alemania,276,19,13,32,"(8.635765,-77.346578)"
2022,Octubre,Lesoto,426,1,0,1,"(4.697144,-74.140516)"
2014,Agosto,Canadá,124,78,189,267,"(6.171601,-75.427454)"
2022,Abril,Zimbabue,716,1,0,1,"(10.445761,-75.516429)"
2013,Junio,Bélgica,56,2,1,3,"(7.818934,-72.453226)"
2013,Junio,Perú,604,225,451,676,"(6.171601,-75.427454)"
2015,Octubre,Panamá,591,167,168,335,"(10.445761,-75.516429)"
2015,Septiembre,Guatemala,320,2,3,5,"(7.128456,-73.183637)"
2012,Junio,Israel,376,1,1,2,"(12.586067,-81.702563)"
2015,Agosto,Cuba,192,0,1,1,"(1.813928,-78.763924)"
2015,Agosto,República de Armenia,51,1,0,1,"(6.171601,-75.427454)"
2017,Octubre,Togo,768,0,1,1,"(10.445761,-75.516429)"
2018,Marzo,Croacia,191,0,5,5,"(10.408582,-75.538003)"
2013,Agosto,Países Bajos,528,2,2,4,"(10.445761,-75.516429)"
2023,Febrero,Suiza,756,1,0,1,"(11.360009,-72.129330)"
2014,Junio,Suecia,752,6,3,9,"(10.886611,-74.776708)"
2013,Octubre,Antigua y Barbuda,28,2,9,11,"(4.697144,-74.140516)"
2020,Enero,Países Bajos,528,1,1,2,"(0.25129,-76.875963)"
2012,Febrero,Estados Unidos de América,840,30,79,109,"(0.814836,-77.662532)"
2013,Junio,Líbano,422,1,1,2,"(6.171601,-75.427454)"
2022,Agosto,Reino Unido de Gran Bretaña e Irlanda del Norte,826,0,5,5,"(7.128456,-73.183637)"
2012,Febrero,Paraguay,600,18,13,31,"(12.586067,-81.702563)"
2019,Noviembre,Granada,308,0,1,1,"(4.697144,-74.140516)"
2018,Marzo,México,484,0,2,2,"(12.586067,-81.702563)"
2016,Agosto,Austria,40,6,15,21,"(10.445761,-75.516429)"
2016,Octubre,Reino Unido de Gran Bretaña e Irlanda del Norte,826,1,4,5,"(7.128456,-73.183637)"
2016,Mayo,Ecuador,218,91,218,309,"(0.25129,-76.875963)"
2020,Octubre,Francia,250,132,320,452,"(4.697144,-74.140516)"
2015,Enero,Polonia,616,10,7,17,"(3.541112,-76.384584)"
2013,Octubre,Jamaica,388,1,3,4,"(3.541112,-76.384584)"
2015,Abril,Guatemala,320,2,1,3,"(7.818934,-72.453226)"
2019,Septiembre,Federación de Rusia,643,171,216,387,"(4.697144,-74.140516)"
2018,Septiembre,Países Bajos,528,1,8,9,"(4.815061,-75.736532)"
2021,Diciembre,República de Moldavia,498,1,0,1,"(6.171601,-75.427454)"
2022,Abril,Túnez,788,1,0,1,"(10.445761,-75.516429)"
2013,Junio,Ecuador,218,0,2,2,"(4.452882,-75.766298)"
2018,Julio,Brasil,76,1,2,3,"(8.36068,-72.409396)"
2013,Septiembre,Rumania,642,0,1,1,"(7.818934,-72.453226)"
2020,Octubre,Venezuela,862,81,104,185,"(10.886611,-74.776708)"
2016,Abril,Israel,376,1,9,10,"(-4.197703,-69.941278)"
2020,Noviembre,Honduras,340,0,14,14,"(12.5744111,-81.703935)"
2013,Septiembre,Haití,332,3,5,8,"(3.541112,-76.384584)"
2014,Mayo,México,484,83,312,395,"(6.171601,-75.427454)"
2023,Marzo,República Dominicana,214,7,11,18,"(4.815061,-75.736532)"
2019,Octubre,Brasil,76,0,2,2,"(3.866713,-67.927521)"
2017,Julio,Marruecos,504,2,0,2,"(10.445761,-75.516429)"
2016,Abril,Ecuador,218,54,245,299,"(7.818934,-72.453226)"
2023,Enero,Georgia,268,15,31,46,"(4.697144,-74.140516)"
2022,Mayo,Suiza,756,0,1,1,"(7.818934,-72.453226)"
2015,Noviembre,Liechtenstein,438,0,2,2,"(4.697144,-74.140516)"
2012,Marzo,Israel,376,3,29,32,"(10.445761,-75.516429)"
2018,Junio,República de Corea,410,18,22,40,"(10.445761,-75.516429)"
2022,Febrero,Sudáfrica,710,0,3,3,"(10.408582,-75.538003)"
2015,Junio,Venezuela,862,3,42,45,"(10.408582,-75.538003)"
2022,Febrero,Costa Rica,188,52,64,116,"(3.541112,-76.384584)"
2022,Mayo,Grecia,300,0,2,2,"(10.886611,-74.776708)"
2013,Enero,España,724,2,9,11,"(4.815061,-75.736532)"
2017,Febrero,China,156,1,1,2,"(-4.197703,-69.941278)"
2017,Noviembre,Hungría,348,7,7,14,"(6.171601,-75.427454)"
2017,Agosto,Marruecos,504,8,18,26,"(4.697144,-74.140516)"
2017,Junio,Perú,604,0,1,1,"(10.971302,-74.765397)"
2021,Noviembre,Perú,604,2,1,3,"(8.36068,-72.409396)"
2012,Diciembre,Canadá,124,3,5,8,"(4.815061,-75.736532)"
2021,Octubre,Dominica,212,0,4,4,"(4.697144,-74.140516)"
2017,Agosto,Malasia,458,1,0,1,"(0.814836,-77.662532)"
2013,Noviembre,México,484,37,81,118,"(10.886611,-74.776708)"
2014,Septiembre,Líbano,422,18,23,41,"(4.697144,-74.140516)"
2019,Septiembre,Sudáfrica,710,2,24,26,"(6.171601,-75.427454)"
2014,Enero,Indonesia,360,0,9,9,"(10.408582,-75.538003)"
2015,Septiembre,Paraguay,600,32,70,102,"(6.171601,-75.427454)"
2014,Mayo,Granada,308,0,1,1,"(4.697144,-74.140516)"
2022,Junio,Bahamas,44,7,4,11,"(3.541112,-76.384584)"
2012,Junio,Reino Unido de Gran Bretaña e Irlanda del Norte,826,11,17,28,"(10.408582,-75.538003)"
2014,Mayo,Hungría,348,0,3,3,"(3.541112,-76.384584)"
2013,Agosto,Perú,604,47,78,125,"(7.818934,-72.453226)"
2019,Abril,República de Belarús,112,0,1,1,"(6.171601,-75.427454)"
2013,Enero,Canadá,124,0,3,3,"(11.247723,-74.213989)"
2013,Febrero,Italia,380,7,25,32,"(7.818934,-72.453226)"
2012,Marzo,Islandia,352,2,0,2,"(0.814836,-77.662532)"
2022,Agosto,Canadá,124,3,6,9,"(10.408582,-75.538003)"
2022,Diciembre,Japón,392,5,5,10,"(3.541112,-76.384584)"
2012,Junio,Suiza,756,12,9,21,"(10.408582,-75.538003)"
2012,Octubre,Jamaica,388,3,1,4,"(6.171601,-75.427454)"
2021,Septiembre,Serbia,688,1,1,2,"(3.541112,-76.384584)"
2012,Mayo,Polonia,616,0,1,1,"(9.402978,-75.681599)"
2017,Enero,Estonia,233,14,13,27,"(4.697144,-74.140516)"
2019,Enero,Polonia,616,1,1,2,"(12.586067,-81.702563)"
2017,Abril,Croacia,191,0,1,1,"(8.635765,-77.346578)"
2018,Enero,Estonia,233,2,3,5,"(6.171601,-75.427454)"
2022,Diciembre,Cabo Verde,132,0,1,1,"(4.697144,-74.140516)"
2022,Mayo,Bahamas,44,4,5,9,"(4.697144,-74.140516)"
2018,Julio,Federación de Rusia,643,0,1,1,"(8.635765,-77.346578)"
2020,Marzo,Federación de Rusia,643,5,0,5,"(3.541112,-76.384584)"
2017,Marzo,Uganda,800,3,5,8,"(4.697144,-74.140516)"
2016,Febrero,República Checa,203,0,1,1,"(11.360009,-72.129330)"
2015,Abril,España,724,0,1,1,"(4.452882,-75.766298)"
2019,Febrero,Malta,470,5,12,17,"(4.697144,-74.140516)"
2014,Octubre,Australia,36,32,60,92,"(0.814836,-77.662532)"
2012,Agosto,Jamaica,388,2,0,2,"(10.445761,-75.516429)"
2014,Junio,Reino Unido de Gran Bretaña e Irlanda del Norte,826,1,4,5,"(4.815061,-75.736532)"
2014,Octubre,Bahamas,44,1,4,5,"(4.697144,-74.140516)"
2022,Diciembre,Guatemala,320,4,2,6,"(7.818934,-72.453226)"
2014,Julio,Australia,36,1,5,6,"(11.360009,-72.129330)"
2019,Diciembre,Albania,8,3,18,21,"(4.697144,-74.140516)"
2018,Febrero,México,484,2,10,12,"(8.36068,-72.409396)"
2019,Marzo,Reino Unido de Gran Bretaña e Irlanda del Norte,826,9,9,18,"(-4.223468,-69.945098)"
2022,Marzo,Países Bajos,528,25,19,44,"(10.408582,-75.538003)"
2019,Noviembre,Honduras,340,76,63,139,"(10.445761,-75.516429)"
2022,Octubre,Rumania,642,0,1,1,"(11.247723,-74.213989)"
2023,Febrero,Ecuador,218,27,25,52,"(11.117806,-74.232622)"
2012,Diciembre,Grecia,300,29,51,80,"(4.697144,-74.140516)"
2018,Enero,Finlandia,246,2,0,2,"(8.635765,-77.346578)"
2022,Febrero,Venezuela,862,1,4,5,"(4.452882,-75.766298)"
2023,Junio,Hungría,348,3,2,5,"(0.814836,-77.662532)"
2012,Marzo,Finlandia,246,5,6,11,"(6.171601,-75.427454)"
2022,Marzo,Santa Lucia,662,0,1,1,"(12.586067,-81.702563)"
2019,Febrero,República Dominicana,214,0,1,1,"(-4.223468,-69.945098)"
2013,Marzo,Bolivia,68,242,387,629,"(4.697144,-74.140516)"
2018,Diciembre,Israel,376,0,1,1,"(-4.223468,-69.945098)"
2014,Septiembre,Sudáfrica,710,1,6,7,"(6.171601,-75.427454)"
2023,Mayo,Ecuador,218,2,4,6,"(4.452882,-75.766298)"
2017,Abril,Italia,380,0,2,2,"(8.36068,-72.409396)"
2017,Mayo,Bolivia,68,127,97,224,"(10.445761,-75.516429)"
2016,Abril,Argentina,32,78,246,324,"(6.171601,-75.427454)"
2022,Febrero,República de Irlanda,372,42,132,174,"(4.697144,-74.140516)"
2014,Septiembre,República de Corea,410,1,0,1,"(11.360009,-72.129330)"
2017,Octubre,Noruega,578,0,1,1,"(12.586067,-81.702563)"
2018,Mayo,Federación de Rusia,643,7,21,28,"(6.171601,-75.427454)"
2015,Octubre,Marruecos,504,0,1,1,"(6.171601,-75.427454)"
2012,Marzo,Nueva Zelanda,554,33,51,84,"(4.697144,-74.140516)"
2022,Diciembre,Turquía,792,4,3,7,"(3.541112,-76.384584)"
2014,Julio,Reino Unido de Gran Bretaña e Irlanda del Norte,826,36,25,61,"(10.408582,-75.538003)"
2012,Noviembre,Venezuela,862,40,79,119,"(7.088729,-70.740253)"
2018,Junio,Palestina,99999,1,3,4,"(4.697144,-74.140516)"
2022,Abril,Federación de Rusia,643,0,1,1,"(4.815061,-75.736532)"
2013,Abril,Surinam,740,9,14,23,"(4.697144,-74.140516)"
2017,Febrero,Italia,380,51,111,162,"(10.445761,-75.516429)"
2015,Marzo,Barbados,52,1,0,1,"(6.171601,-75.427454)"
2023,Febrero,Etiopia,231,0,1,1,"(10.971302,-74.765397)"
2019,Noviembre,Pakistán,586,0,3,3,"(6.171601,-75.427454)"
2012,Octubre,España,724,7,6,13,"(0.814836,-77.662532)"
2017,Mayo,Rumania,642,0,1,1,"(-4.223468,-69.945098)"
2018,Diciembre,Panamá,591,64,65,129,"(12.586067,-81.702563)"
2019,Febrero,Canadá,124,4,2,6,"(0.25129,-76.875963)"
2018,Agosto,San Cristóbal y Nevis,659,0,1,1,"(10.408582,-75.538003)"
2016,Septiembre,Croacia,191,0,2,2,"(3.541112,-76.384584)"
2017,Mayo,Honduras,340,6,4,10,"(10.886611,-74.776708)"
2018,Enero,Serbia,688,1,2,3,"(3.541112,-76.384584)"
2017,Octubre,Singapur,702,22,45,67,"(4.697144,-74.140516)"
2023,Enero,Kazajistán,398,1,4,5,"(6.171601,-75.427454)"
2019,Febrero,Perú,604,4890,5156,10046,"(4.697144,-74.140516)"
2018,Abril,Federación de Rusia,643,156,194,350,"(4.697144,-74.140516)"
2013,Mayo,Croacia,191,0,3,3,"(3.541112,-76.384584)"
2013,Marzo,Reino Unido de Gran Bretaña e Irlanda del Norte,826,0,1,1,"(10.408582,-75.538003)"
2017,Octubre,Bolivia,68,23,41,64,"(3.541112,-76.384584)"
2015,Octubre,Noruega,578,1,0,1,"(4.452882,-75.766298)"
2015,Septiembre,República de Irlanda,372,0,1,1,"(-4.197703,-69.941278)"
2017,Junio,Portugal,620,195,386,581,"(4.697144,-74.140516)"
2021,Julio,Portugal,620,99,186,285,"(4.697144,-74.140516)"
2022,Julio,Líbano,422,1,0,1,"(10.886611,-74.776708)"
2023,Febrero,Canadá,124,0,2,2,"(7.916725,-72.462544)"
2019,Abril,Nepal,524,2,2,4,"(4.697144,-74.140516)"
2013,Noviembre,Eslovaquia,703,1,0,1,"(10.408582,-75.538003)"
2022,Febrero,Iraq,368,0,1,1,"(6.171601,-75.427454)"
2014,Junio,Venezuela,862,33,61,94,"(3.541112,-76.384584)"
2022,Junio,Países Bajos,528,1,3,4,"(11.117806,-74.232622)"
2016,Noviembre,Eslovenia,705,1,1,2,"(-4.197703,-69.941278)"
2021,Julio,Bélgica,56,89,160,249,"(4.697144,-74.140516)"
2020,Octubre,Nicaragua,558,1,2,3,"(10.445761,-75.516429)"
2015,Abril,Australia,36,1,0,1,"(13.3387613,-81.372937)"
2016,Octubre,Ecuador,218,0,2,2,"(6.185799,-67.483929)"
2016,Septiembre,Albania,8,3,2,5,"(4.697144,-74.140516)"
2012,Abril,Federación de Rusia,643,0,1,1,"(10.971302,-74.765397)"
2023,Marzo,Trinidad y Tobago,780,0,1,1,"(10.408582,-75.538003)"
2013,Marzo,Dinamarca,208,0,1,1,"(4.815061,-75.736532)"
2020,Enero,Reino Unido de Gran Bretaña e Irlanda del Norte,826,4,5,9,"(-4.197703,-69.941278)"
2016,Noviembre,Nicaragua,558,6,15,21,"(3.541112,-76.384584)"
2012,Septiembre,Sudáfrica,710,23,54,77,"(4.697144,-74.140516)"
2021,Julio,Kenia,404,5,7,12,"(4.697144,-74.140516)"
2012,Febrero,Alemania,276,31,60,91,"(3.541112,-76.384584)"
2021,Julio,Rumania,642,2,2,4,"(3.541112,-76.384584)"
2013,Junio,Egipto,818,2,14,16,"(4.697144,-74.140516)"
2013,Agosto,Federación de Rusia,643,0,1,1,"(10.408582,-75.538003)"
2014,Abril,Rwanda,646,0,1,1,"(6.171601,-75.427454)"
2012,Octubre,Estados Unidos de América,840,445,906,1351,"(3.541112,-76.384584)"
2017,Junio,Francia,250,76,176,252,"(6.171601,-75.427454)"
2019,Febrero,Bolivia,68,0,2,2,"(7.818934,-72.453226)"
2022,Diciembre,Argentina,32,2,0,2,"(8.635765,-77.346578)"
2017,Junio,Finlandia,246,3,0,3,"(12.586067,-81.702563)"
2023,Enero,Qatar,634,0,2,2,"(6.171601,-75.427454)"
2012,Marzo,Suecia,752,2,5,7,"(7.818934,-72.453226)"
2019,Diciembre,Bosnia y Herzegovina,70,0,2,2,"(6.171601,-75.427454)"
2022,Diciembre,Surinam,740,18,18,36,"(4.697144,-74.140516)"
2014,Abril,Costa Rica,188,102,165,267,"(6.171601,-75.427454)"
2017,Noviembre,Polonia,616,17,26,43,"(6.171601,-75.427454)"
2023,Febrero,Perú,604,24,34,58,"(0.25129,-76.875963)"
2016,Julio,Túnez,788,0,1,1,"(3.541112,-76.384584)"
2020,Agosto,Italia,380,1,0,1,"(7.818934,-72.453226)"
2019,Julio,Estados Unidos de América,840,5991,7165,13159,"(10.445761,-75.516429)"
2014,Noviembre,República de Corea,410,0,4,4,"(10.886611,-74.776708)"
2015,Noviembre,Noruega,578,6,10,16,"(6.171601,-75.427454)"
2020,Febrero,Noruega,578,0,2,2,"(7.818934,-72.453226)"
2015,Marzo,Haití,332,1,1,2,"(7.128456,-73.183637)"
2021,Julio,Suiza,756,1,0,1,"(11.117806,-74.232622)"
2014,Enero,Federación de Rusia,643,2,3,5,"(10.408582,-75.538003)"
2018,Agosto,Barbados,52,5,7,12,"(4.697144,-74.140516)"
2015,Abril,Nicaragua,558,0,1,1,"(13.3387613,-81.372937)"
2016,Agosto,Suecia,752,7,16,23,"(3.541112,-76.384584)"
2018,Febrero,Marruecos,504,10,14,24,"(4.697144,-74.140516)"
2018,Julio,Honduras,340,0,1,1,"(7.128456,-73.183637)"
2014,Enero,Países Bajos,528,2,6,8,"(4.815061,-75.736532)"
2022,Noviembre,Venezuela,862,0,9,9,"(11.247723,-74.213989)"
2023,Febrero,Turquía,792,0,3,3,"(0.814836,-77.662532)"
2019,Abril,Taiwán,158,3,1,4,"(0.814836,-77.662532)"
2017,Abril,Finlandia,246,36,64,100,"(4.697144,-74.140516)"
2018,Septiembre,Países Bajos,528,274,281,555,"(10.445761,-75.516429)"
2016,Agosto,Madagascar,450,1,0,1,"(4.697144,-74.140516)"
2019,Junio,Noruega,578,1,0,1,"(-4.223468,-69.945098)"
2013,Agosto,Venezuela,862,252,316,568,"(7.927209,-72.507910)"
2023,Febrero,Turquía,792,6,32,38,"(6.171601,-75.427454)"
2012,Mayo,Bolivia,68,11,15,26,"(10.445761,-75.516429)"
2015,Julio,Perú,604,4798,5200,9998,"(4.697144,-74.140516)"
2018,Octubre,Etiopia,231,2,41,43,"(4.697144,-74.140516)"
2019,Diciembre,Guyana,328,0,1,1,"(10.408582,-75.538003)"
2013,Noviembre,Estados Unidos de América,840,0,4,4,"(12.5744111,-81.703935)"
2016,Mayo,Italia,380,0,3,3,"(7.927209,-72.507910)"
2019,Septiembre,Nigeria,566,2,0,2,"(3.541112,-76.384584)"
2014,Enero,Nicaragua,558,1,0,1,"(10.886611,-74.776708)"
2018,Junio,Rumania,642,0,7,7,"(10.408582,-75.538003)"
2016,Marzo,Cuba,192,1,1,2,"(0.814836,-77.662532)"
2014,Junio,Australia,36,2,4,6,"(11.360009,-72.129330)"
2017,Febrero,Georgia,268,0,1,1,"(6.171601,-75.427454)"
2016,Octubre,Surinam,740,1,2,3,"(7.128456,-73.183637)"
2017,Febrero,Eslovaquia,703,1,5,6,"(0.814836,-77.662532)"
2014,Mayo,Costa Rica,188,0,1,1,"(10.971302,-74.765397)"
2018,Diciembre,Egipto,818,0,1,1,"(0.814836,-77.662532)"
2015,Diciembre,Grecia,300,37,77,114,"(4.697144,-74.140516)"
2016,Diciembre,Islas Caimán/Territorio Británico de Ultramar,136,2,27,29,"(12.586067,-81.702563)"
2018,Abril,República de Irlanda,372,139,212,351,"(4.697144,-74.140516)"
2016,Enero,República Dominicana,214,1,0,1,"(4.452882,-75.766298)"
2014,Mayo,China,156,0,2,2,"(10.886611,-74.776708)"
2017,Junio,Paraguay,600,5,6,11,"(3.541112,-76.384584)"
2012,Noviembre,Países Bajos,528,1,0,1,"(4.815061,-75.736532)"
2021,Enero,Guyana,328,0,2,2,"(10.445761,-75.516429)"
2021,Febrero,Serbia,688,0,5,5,"(6.171601,-75.427454)"
2013,Octubre,Honduras,340,25,39,64,"(6.171601,-75.427454)"
2017,Septiembre,Santa Lucia,662,3,1,4,"(4.697144,-74.140516)"
2019,Enero,Trinidad y Tobago,780,21,53,74,"(4.697144,-74.140516)"
2022,Abril,Argentina,32,2390,3289,5679,"(4.697144,-74.140516)"
2022,Junio,Alemania,276,5,5,10,"(8.635765,-77.346578)"
2017,Octubre,Afganistán,4,1,7,8,"(4.697144,-74.140516)"
2018,Septiembre,España,724,121,215,336,"(10.445761,-75.516429)"
2013,Noviembre,Turquía,792,4,8,12,"(10.445761,-75.516429)"
2014,Julio,Cuba,192,17,27,44,"(3.541112,-76.384584)"
2015,Septiembre,Bélgica,56,1,1,2,"(8.635765,-77.346578)"
2015,Febrero,Brasil,76,277,315,592,"(6.171601,-75.427454)"
2016,Febrero,Portugal,620,0,1,1,"(4.815061,-75.736532)"
2013,Abril,Japón,392,88,431,519,"(4.697144,-74.140516)"
2019,Marzo,Honduras,340,0,1,1,"(4.452882,-75.766298)"
2023,Enero,Canadá,124,356,913,1269,"(6.171601,-75.427454)"
2022,Marzo,Estonia,233,1,1,2,"(3.541112,-76.384584)"
2022,Marzo,Bélgica,56,1,10,11,"(0.814836,-77.662532)"
2017,Marzo,Nicaragua,558,0,2,2,"(12.586067,-81.702563)"
2016,Noviembre,Perú,604,385,574,959,"(6.171601,-75.427454)"
2014,Abril,Alemania,276,1327,1945,3272,"(4.697144,-74.140516)"
2022,Octubre,India,356,3,8,11,"(3.541112,-76.384584)"
2017,Marzo,Malta,470,1,6,7,"(4.697144,-74.140516)"
2023,Junio,Brasil,76,24,33,57,"(10.886611,-74.776708)"
2021,Septiembre,Alemania,276,1,5,6,"(7.818934,-72.453226)"
2015,Septiembre,Benín,204,0,1,1,"(6.171601,-75.427454)"
2019,Agosto,República Dominicana,214,0,1,1,"(7.088729,-70.740253)"
2017,Julio,Bosnia y Herzegovina,70,0,2,2,"(4.697144,-74.140516)"
2015,Enero,Croacia,191,1,0,1,"(6.171601,-75.427454)"
2016,Febrero,Eslovenia,705,1,4,5,"(3.541112,-76.384584)"
2016,Octubre,Belice,84,0,3,3,"(6.171601,-75.427454)"
2012,Febrero,Federación de Rusia,643,1,3,4,"(6.171601,-75.427454)"
2013,Agosto,República Dominicana,214,6,2,8,"(10.408582,-75.538003)"
2014,Marzo,Francia,250,3,4,7,"(12.586067,-81.702563)"
2023,Mayo,Polonia,616,0,1,1,"(8.36068,-72.409396)"
2015,Mayo,Uruguay,858,0,5,5,"(7.818934,-72.453226)"
2015,Mayo,México,484,6,18,24,"(12.586067,-81.702563)"
2023,Mayo,Uruguay,858,0,1,1,"(10.408582,-75.538003)"
2015,Septiembre,Suiza,756,1,3,4,"(-4.197703,-69.941278)"
2019,Febrero,México,484,8,11,19,"(7.818934,-72.453226)"
2016,Febrero,Honduras,340,2,4,6,"(4.815061,-75.736532)"
2019,Abril,Noruega,578,10,3,13,"(0.814836,-77.662532)"
2021,Enero,Guyana,328,2,5,7,"(4.697144,-74.140516)"
2017,Junio,Islas Caimán/Territorio Británico de Ultramar,136,1,0,1,"(10.886611,-74.776708)"
2023,Mayo,Gabón,266,1,0,1,"(4.697144,-74.140516)"
2019,Febrero,República de Armenia,51,0,2,2,"(10.445761,-75.516429)"
2021,Diciembre,España,724,82,118,200,"(10.445761,-75.516429)"
2017,Mayo,Uruguay,858,44,45,89,"(12.586067,-81.702563)"
2017,Septiembre,Macedonia,807,0,1,1,"(10.445761,-75.516429)"
2013,Noviembre,Perú,604,0,1,1,"(1.813928,-78.763924)"
2016,Noviembre,Honduras,340,296,378,674,"(4.697144,-74.140516)"
2016,Diciembre,Finlandia,246,82,120,202,"(4.697144,-74.140516)"
2019,Junio,Estados Unidos de América,840,14,20,34,"(-4.223468,-69.945098)"
2022,Marzo,Uganda,800,1,0,1,"(3.541112,-76.384584)"
2012,Septiembre,Hungría,348,20,42,62,"(4.697144,-74.140516)"
2020,Marzo,Bulgaria,100,0,1,1,"(11.247723,-74.213989)"
2022,Mayo,Grecia,300,0,4,4,"(11.247723,-74.213989)"
2017,Octubre,España,724,0,1,1,"(7.088729,-70.740253)"
2016,Enero,San  Vicente y las Granadinas,670,0,1,1,"(10.445761,-75.516429)"
2017,Abril,Jamaica,388,1,3,4,"(0.814836,-77.662532)"
2015,Septiembre,Taiwán,158,3,3,6,"(0.814836,-77.662532)"
2022,Abril,Indonesia,360,2,6,8,"(6.171601,-75.427454)"
2019,Abril,Nigeria,566,1,3,4,"(6.171601,-75.427454)"
2020,Enero,Reino Unido de Gran Bretaña e Irlanda del Norte,826,128,225,353,"(10.445761,-75.516429)"
2015,Enero,Perú,604,38,31,69,"(-4.197703,-69.941278)"
2012,Febrero,Uruguay,858,0,1,1,"(8.635765,-77.346578)"
2021,Abril,Sudáfrica,710,0,1,1,"(3.541112,-76.384584)"
2017,Febrero,Burundi,108,1,5,6,"(4.697144,-74.140516)"
2022,Septiembre,Montenegro,499,0,1,1,"(10.445761,-75.516429)"
2012,Agosto,Perú,604,153,357,510,"(0.814836,-77.662532)"
2023,Abril,Francia,250,2,5,7,"(10.971302,-74.765397)"
2018,Abril,Hong Kong,344,1,1,2,"(10.445761,-75.516429)"
2014,Abril,República Democrática Popular de Corea,408,1,2,3,"(4.697144,-74.140516)"
2021,Octubre,India,356,7,47,54,"(6.171601,-75.427454)"
2022,Junio,Ecuador,218,56,81,137,"(0.25129,-76.875963)"
2019,Julio,Suiza,756,3,3,6,"(12.586067,-81.702563)"
2019,Diciembre,Federación de Rusia,643,1,1,2,"(12.586067,-81.702563)"
2017,Marzo,Santa Lucia,662,0,1,1,"(7.818934,-72.453226)"
2015,Octubre,Indonesia,360,0,10,10,"(10.445761,-75.516429)"
2013,Febrero,Ecuador,218,0,3,3,"(1.813928,-78.763924)"
2022,Septiembre,Rwanda,646,1,0,1,"(4.697144,-74.140516)"
2012,Diciembre,Chile,152,52,92,144,"(3.541112,-76.384584)"
2013,Febrero,Honduras,340,1,1,2,"(4.815061,-75.736532)"
2012,Agosto,Finlandia,246,0,2,2,"(7.128456,-73.183637)"
2016,Diciembre,Eslovenia,705,0,1,1,"(7.818934,-72.453226)"
2022,Diciembre,Hungría,348,5,11,16,"(10.445761,-75.516429)"
2021,Junio,Dominica,212,1,0,1,"(6.171601,-75.427454)"
2022,Octubre,Italia,380,3,9,12,"(7.088729,-70.740253)"
2016,Julio,Togo,768,0,1,1,"(4.697144,-74.140516)"
2015,Diciembre,Jordania,400,0,1,1,"(3.541112,-76.384584)"
2017,Febrero,Países Bajos,528,2,4,6,"(11.360009,-72.129330)"
2019,Marzo,Nepal,524,0,4,4,"(4.697144,-74.140516)"
2012,Julio,Países Bajos,528,9,20,29,"(11.360009,-72.129330)"
2012,Julio,Brasil,76,40,78,118,"(3.541112,-76.384584)"
2015,Agosto,Ucrania,804,1,0,1,"(3.541112,-76.384584)"
2020,Febrero,Costa Rica,188,11,32,43,"(10.886611,-74.776708)"
2017,Mayo,Nueva Zelanda,554,2,0,2,"(0.25129,-76.875963)"
2020,Enero,Venezuela,862,10,12,22,"(7.128456,-73.183637)"
2015,Octubre,Desconocido,99999,0,2,2,"(6.171601,-75.427454)"
2013,Julio,Chile,152,2,1,3,"(8.635765,-77.346578)"
2015,Diciembre,Chile,152,1,6,7,"(4.815061,-75.736532)"
2021,Diciembre,Honduras,340,39,48,87,"(10.445761,-75.516429)"
2018,Septiembre,India,356,0,1,1,"(0.814836,-77.662532)"
2022,Diciembre,Bélgica,56,1,8,9,"(10.886611,-74.776708)"
2016,Marzo,Ucrania,804,0,5,5,"(10.445761,-75.516429)"
2019,Mayo,Portugal,620,5,5,10,"(11.360009,-72.129330)"
2018,Marzo,Bulgaria,100,5,10,15,"(6.171601,-75.427454)"
2013,Marzo,Dominica,212,1,1,2,"(4.697144,-74.140516)"
2021,Julio,Taiwán,158,8,11,19,"(4.697144,-74.140516)"
2023,Enero,Grecia,300,1,0,1,"(6.18189,-67.47535)"
2022,Julio,Suiza,756,50,55,105,"(10.445761,-75.516429)"
2014,Enero,Reino Unido de Gran Bretaña e Irlanda del Norte,826,1,1,2,"(13.3387613,-81.372937)"
2014,Noviembre,Filipinas,608,1,0,1,"(7.128456,-73.183637)"
2013,Noviembre,Finlandia,246,0,1,1,"(10.408582,-75.538003)"
2023,Mayo,Sri Lanka,144,0,4,4,"(11.247723,-74.213989)"
2019,Marzo,Nigeria,566,1,0,1,"(3.541112,-76.384584)"
2017,Enero,Venezuela,862,10,14,24,"(4.815061,-75.736532)"
2017,Agosto,Venezuela,862,23151,26617,49768,"(7.818934,-72.453226)"
2017,Junio,Australia,36,0,1,1,"(7.128456,-73.183637)"
2016,Febrero,Bélgica,56,1,1,2,"(12.586067,-81.702563)"
2017,Septiembre,San Cristóbal y Nevis,659,2,0,2,"(4.697144,-74.140516)"
2021,Octubre,Suecia,752,9,25,34,"(6.171601,-75.427454)"
2021,Mayo,El Salvador,222,2,0,2,"(4.452882,-75.766298)"
2023,Enero,Bélgica,56,0,2,2,"(4.452882,-75.766298)"
2020,Octubre,México,484,25,44,69,"(10.445761,-75.516429)"
2012,Agosto,Guatemala,320,1,1,2,"(4.452882,-75.766298)"
2022,Diciembre,Ghana,288,0,1,1,"(10.445761,-75.516429)"
2017,Marzo,Trinidad y Tobago,780,0,1,1,"(12.586067,-81.702563)"
2022,Febrero,Filipinas,608,5,4,9,"(6.171601,-75.427454)"
2022,Septiembre,Sierra Leona,694,1,2,3,"(4.697144,-74.140516)"
2018,Julio,Suiza,756,62,76,138,"(10.445761,-75.516429)"
2015,Diciembre,República de Belarús,112,1,0,1,"(6.171601,-75.427454)"
2023,Enero,Liberia,430,0,2,2,"(4.697144,-74.140516)"
2014,Enero,Suecia,752,12,29,41,"(6.171601,-75.427454)"
2015,Abril,Madagascar,450,2,0,2,"(0.814836,-77.662532)"
2019,Abril,Alemania,276,2,2,4,"(8.36068,-72.409396)"
2018,Febrero,China,156,39,47,86,"(6.171601,-75.427454)"
2021,Marzo,Venezuela,862,120,149,269,"(10.886611,-74.776708)"
2019,Noviembre,Costa Rica,188,1456,1718,3174,"(4.697144,-74.140516)"
2018,Agosto,Brasil,76,17,37,54,"(0.814836,-77.662532)"
2019,Diciembre,Panamá,591,438,592,1030,"(3.541112,-76.384584)"
2017,Febrero,Zimbabue,716,1,0,1,"(4.697144,-74.140516)"
2014,Marzo,Portugal,620,0,2,2,"(11.360009,-72.129330)"
2020,Noviembre,Federación de Rusia,643,1,1,2,"(10.971302,-74.765397)"
2015,Agosto,Tanzania,834,1,4,5,"(4.697144,-74.140516)"
2018,Octubre,Chile,152,4439,5552,9991,"(4.697144,-74.140516)"
2012,Febrero,Japón,392,7,10,17,"(0.814836,-77.662532)"
2015,Noviembre,Jordania,400,2,5,7,"(4.697144,-74.140516)"
2022,Junio,Singapur,702,3,5,8,"(6.171601,-75.427454)"
2023,Mayo,Turquía,792,6,18,24,"(6.171601,-75.427454)"
2020,Septiembre,Reino Unido de Gran Bretaña e Irlanda del Norte,826,1,3,4,"(10.445761,-75.516429)"
2022,Mayo,Portugal,620,0,2,2,"(4.452882,-75.766298)"
2018,Abril,Desconocido,99999,19,23,42,"(10.445761,-75.516429)"
2023,Abril,Marruecos,504,26,47,73,"(4.697144,-74.140516)"
2014,Junio,Alemania,276,5,4,9,"(12.586067,-81.702563)"
2019,Noviembre,Myanmar,104,0,1,1,"(3.541112,-76.384584)"
2017,Enero,Países Bajos,528,10,9,19,"(8.635765,-77.346578)"
2023,Abril,Malta,470,5,4,9,"(4.697144,-74.140516)"
2021,Agosto,Estonia,233,4,1,5,"(4.697144,-74.140516)"
2017,Julio,Alemania,276,10,17,27,"(8.635765,-77.346578)"
2022,Marzo,Bélgica,56,55,68,123,"(10.445761,-75.516429)"
2019,Diciembre,Croacia,191,0,1,1,"(0.814836,-77.662532)"
2012,Enero,Dinamarca,208,1,14,15,"(3.541112,-76.384584)"
2018,Julio,India,356,0,1,1,"(11.117806,-74.232622)"
2014,Junio,Líbano,422,1,1,2,"(10.886611,-74.776708)"
2022,Enero,Surinam,740,2,3,5,"(6.171601,-75.427454)"
2017,Junio,Costa de Marfil,384,1,5,6,"(4.697144,-74.140516)"
2018,Enero,Eslovaquia,703,53,68,121,"(4.697144,-74.140516)"
2019,Abril,Chipre,196,1,0,1,"(0.814836,-77.662532)"
2013,Junio,Argentina,32,3,4,7,"(-4.197703,-69.941278)"
2021,Marzo,República Árabe Siria,760,0,1,1,"(4.697144,-74.140516)"
2022,Julio,Guyana,328,0,1,1,"(7.818934,-72.453226)"
2013,Agosto,Hungría,348,22,22,44,"(4.697144,-74.140516)"
2014,Mayo,Panamá,591,2,4,6,"(7.818934,-72.453226)"
2012,Julio,Reino Unido de Gran Bretaña e Irlanda del Norte,826,1,0,1,"(0.814836,-77.662532)"
2016,Julio,Sudáfrica,710,0,2,2,"(11.247723,-74.213989)"
2012,Noviembre,Alemania,276,1,2,3,"(4.815061,-75.736532)"
2016,Marzo,India,356,0,3,3,"(0.25129,-76.875963)"
2022,Julio,Perú,604,52,27,79,"(11.117806,-74.232622)"
2016,Abril,Bolivia,68,1,0,1,"(-4.197703,-69.941278)"
2019,Abril,Portugal,620,36,38,74,"(10.445761,-75.516429)"
2012,Abril,Francia,250,1,2,3,"(12.586067,-81.702563)"
2015,Febrero,Alemania,276,54,138,192,"(10.445761,-75.516429)"
2013,Enero,El Salvador,222,70,106,176,"(6.171601,-75.427454)"
2018,Junio,El Salvador,222,0,2,2,"(7.818934,-72.453226)"
2012,Abril,Dominica,212,0,1,1,"(7.818934,-72.453226)"
2018,Noviembre,Alemania,276,0,2,2,"(8.36068,-72.409396)"
2013,Enero,Filipinas,608,1,3,4,"(3.541112,-76.384584)"
2019,Octubre,Venezuela,862,10,11,21,"(7.128456,-73.183637)"
2016,Mayo,Suiza,756,35,64,99,"(6.171601,-75.427454)"
2012,Septiembre,Reino Unido de Gran Bretaña e Irlanda del Norte,826,1,5,6,"(4.697144,-74.140516)"
2023,Junio,Venezuela,862,504,390,894,"(7.927209,-72.507910)"
2018,Noviembre,Nigeria,566,0,2,2,"(10.445761,-75.516429)"
2014,Marzo,Azerbaiyán,31,1,5,6,"(4.697144,-74.140516)"
2023,Marzo,Israel,376,0,2,2,"(-4.223468,-69.945098)"
2017,Abril,Mauricio,480,1,0,1,"(6.171601,-75.427454)"
2017,Julio,Turquía,792,0,8,8,"(3.541112,-76.384584)"
2017,Diciembre,Bolivia,68,988,842,1830,"(4.697144,-74.140516)"
2017,Enero,Honduras,340,0,2,2,"(12.5744111,-81.703935)"
2017,Diciembre,Arabia Saudita,682,0,2,2,"(10.445761,-75.516429)"
2019,Mayo,Bélgica,56,16,23,39,"(10.445761,-75.516429)"
2013,Noviembre,Australia,36,272,388,660,"(4.697144,-74.140516)"
2023,Junio,Eslovenia,705,6,21,27,"(4.697144,-74.140516)"
2015,Enero,Uruguay,858,3,7,10,"(7.818934,-72.453226)"
2012,Febrero,Argentina,32,1,3,4,"(4.815061,-75.736532)"
2022,Septiembre,Kenia,404,3,3,6,"(6.171601,-75.427454)"
2012,Agosto,Islas Aland/Provincia de Finlandia,248,0,2,2,"(4.697144,-74.140516)"
2018,Julio,Bahamas,44,5,1,6,"(3.541112,-76.384584)"
2015,Noviembre,Uruguay,858,6,3,9,"(10.408582,-75.538003)"
2020,Julio,Honduras,340,0,1,1,"(4.697144,-74.140516)"
2014,Mayo,Bélgica,56,4,11,15,"(3.541112,-76.384584)"
2017,Febrero,Jordania,400,0,1,1,"(10.445761,-75.516429)"
2017,Junio,Portugal,620,4,7,11,"(7.818934,-72.453226)"
2019,Agosto,Líbano,422,16,30,46,"(4.697144,-74.140516)"
2013,Agosto,Australia,36,3,11,14,"(10.886611,-74.776708)"
2023,Marzo,Argentina,32,2,1,3,"(8.635765,-77.346578)"
2016,Septiembre,Federación de Rusia,643,168,185,353,"(4.697144,-74.140516)"
2018,Abril,Madagascar,450,2,1,3,"(4.697144,-74.140516)"
2015,Octubre,Argentina,32,2,7,9,"(4.815061,-75.736532)"
2017,Agosto,Estonia,233,4,4,8,"(4.697144,-74.140516)"
2019,Diciembre,Jamaica,388,1,0,1,"(-4.197703,-69.941278)"
2022,Febrero,Venezuela,862,567,598,1165,"(6.171601,-75.427454)"
2017,Marzo,Federación de Rusia,643,12,8,20,"(10.445761,-75.516429)"
2013,Abril,Curazao,99999,5,8,13,"(6.171601,-75.427454)"
2022,Febrero,Ecuador,218,0,1,1,"(-0.193180,-74.784874)"
2021,Febrero,España,724,2,12,14,"(10.886611,-74.776708)"
2015,Marzo,Reino Unido de Gran Bretaña e Irlanda del Norte,826,2,4,6,"(11.247723,-74.213989)"
2023,Marzo,Santa Lucia,662,1,0,1,"(6.171601,-75.427454)"
2015,Abril,Jamaica,388,0,1,1,"(10.408582,-75.538003)"
2015,Julio,Dinamarca,208,19,44,63,"(3.541112,-76.384584)"
2013,Mayo,República Checa,203,0,1,1,"(3.541112,-76.384584)"
2022,Abril,República de Corea,410,4,6,10,"(10.445761,-75.516429)"
2018,Junio,Portugal,620,15,32,47,"(6.171601,-75.427454)"
2014,Julio,República de Corea,410,1,3,4,"(10.445761,-75.516429)"
2015,Octubre,Bermudas/Territorio Británico de Ultramar,60,0,1,1,"(10.886611,-74.776708)"
2019,Enero,Serbia,688,27,63,90,"(4.697144,-74.140516)"
2016,Diciembre,Suecia,752,1,0,1,"(4.815061,-75.736532)"
2018,Agosto,Venezuela,862,1625,1634,3259,"(7.088729,-70.740253)"
2014,Julio,Malasia,458,3,4,7,"(-4.197703,-69.941278)"
2019,Septiembre,Rumania,642,0,1,1,"(10.971302,-74.765397)"
2022,Julio,Grecia,300,5,9,14,"(10.445761,-75.516429)"
2022,Octubre,Bosnia y Herzegovina,70,1,0,1,"(10.445761,-75.516429)"
2013,Marzo,Chile,152,0,3,3,"(6.185799,-67.483929)"
2022,Abril,Ucrania,804,0,3,3,"(11.247723,-74.213989)"
2015,Septiembre,Japón,392,0,1,1,"(8.635765,-77.346578)"
2016,Diciembre,República de Corea,410,4,3,7,"(-4.197703,-69.941278)"
2016,Septiembre,India,356,0,19,19,"(10.886611,-74.776708)"
2013,Junio,Países Bajos,528,0,1,1,"(11.360009,-72.129330)"
2013,Septiembre,Rumania,642,4,3,7,"(6.171601,-75.427454)"
2012,Enero,Italia,380,1,1,2,"(0.25129,-76.875963)"
2020,Diciembre,Ucrania,804,0,1,1,"(10.408582,-75.538003)"
2019,Mayo,Ecuador,218,0,10,10,"(-4.223468,-69.945098)"
2023,Junio,Bosnia y Herzegovina,70,2,4,6,"(6.171601,-75.427454)"
2014,Julio,Suecia,752,5,9,14,"(3.541112,-76.384584)"
2022,Noviembre,Croacia,191,0,9,9,"(10.445761,-75.516429)"
2018,Enero,Federación de Rusia,643,0,3,3,"(11.247723,-74.213989)"
2020,Diciembre,Suiza,756,2,2,4,"(11.247723,-74.213989)"
2023,Marzo,Bolivia,68,4,3,7,"(12.586067,-81.702563)"
2017,Abril,Brasil,76,23,20,43,"(10.886611,-74.776708)"
2022,Diciembre,Perú,604,3474,3976,7450,"(4.697144,-74.140516)"
2019,Abril,Panamá,591,11,10,21,"(7.128456,-73.183637)"
2014,Mayo,Tailandia,764,0,2,2,"(6.171601,-75.427454)"
2023,Enero,Rumania,642,0,3,3,"(8.635765,-77.346578)"
2014,Mayo,Perú,604,275,455,730,"(6.171601,-75.427454)"
2014,Septiembre,Estados Unidos de América,840,13,56,69,"(10.408582,-75.538003)"
2017,Diciembre,República Dominicana,214,1,0,1,"(-4.223468,-69.945098)"
2022,Noviembre,Panamá,591,14,26,40,"(7.927209,-72.507910)"
2016,Octubre,Nicaragua,558,1,0,1,"(0.814836,-77.662532)"
2018,Julio,Australia,36,3,21,24,"(10.886611,-74.776708)"
2017,Octubre,Chipre,196,1,0,1,"(0.814836,-77.662532)"
2021,Julio,Portugal,620,3,3,6,"(7.916725,-72.462544)"
2015,Noviembre,India,356,0,3,3,"(7.927209,-72.507910)"
2012,Junio,Islas Caimán/Territorio Británico de Ultramar,136,4,7,11,"(12.586067,-81.702563)"
2016,Enero,Chile,152,0,1,1,"(1.813928,-78.763924)"
2016,Noviembre,Chipre,196,1,4,5,"(4.697144,-74.140516)"
2016,Abril,Venezuela,862,68,108,176,"(10.445761,-75.516429)"
2019,Enero,Filipinas,608,0,11,11,"(9.402978,-75.681599)"
2017,Febrero,Hungría,348,3,0,3,"(10.408582,-75.538003)"
2019,Marzo,China,156,525,1109,1634,"(4.697144,-74.140516)"
2018,Noviembre,Federación de Rusia,643,0,2,2,"(4.815061,-75.736532)"
2018,Noviembre,El Salvador,222,0,1,1,"(7.128456,-73.183637)"
2015,Mayo,Estados Unidos de América,840,53,106,159,"(0.814836,-77.662532)"
2015,Marzo,Trinidad y Tobago,780,3,11,14,"(3.541112,-76.384584)"
2018,Marzo,Arabia Saudita,682,0,10,10,"(4.697144,-74.140516)"
2022,Febrero,Azerbaiyán,31,3,9,12,"(4.697144,-74.140516)"
2023,Marzo,Perú,604,0,13,13,"(10.408582,-75.538003)"
2013,Septiembre,Dinamarca,208,1,2,3,"(6.171601,-75.427454)"
2019,Abril,República Dominicana,214,3,2,5,"(7.128456,-73.183637)"
2014,Noviembre,Cuba,192,0,3,3,"(12.586067,-81.702563)"
2021,Enero,Uruguay,858,38,72,110,"(4.697144,-74.140516)"
2013,Mayo,Chile,152,7,30,37,"(7.818934,-72.453226)"
2019,Enero,India,356,0,1,1,"(3.893038,-77.067921)"
2022,Octubre,Malawi,454,1,0,1,"(4.815061,-75.736532)"
2019,Mayo,Bulgaria,100,0,1,1,"(3.541112,-76.384584)"
2015,Febrero,Panamá,591,5,10,15,"(7.818934,-72.453226)"
2022,Junio,Nicaragua,558,79,78,157,"(4.697144,-74.140516)"
2022,Mayo,Venezuela,862,0,6,6,"(10.408582,-75.538003)"
2022,Agosto,China,156,3,0,3,"(7.128456,-73.183637)"
2023,Enero,Etiopia,231,0,1,1,"(10.408582,-75.538003)"
2023,Abril,Ucrania,804,1,0,1,"(-4.223468,-69.945098)"
2016,Febrero,Estados Unidos de América,840,650,1090,1740,"(10.886611,-74.776708)"
2019,Agosto,Túnez,788,2,4,6,"(4.697144,-74.140516)"
2019,Noviembre,Finlandia,246,54,92,146,"(4.697144,-74.140516)"
2015,Marzo,Dominica,212,0,1,1,"(6.171601,-75.427454)"
2017,Marzo,Grecia,300,1,6,7,"(3.541112,-76.384584)"
2013,Mayo,Australia,36,4,4,8,"(11.247723,-74.213989)"
2015,Octubre,Israel,376,2,3,5,"(8.635765,-77.346578)"
2012,Abril,Bélgica,56,78,241,319,"(4.697144,-74.140516)"
2012,Febrero,Bélgica,56,16,21,37,"(10.445761,-75.516429)"
2021,Enero,Tailandia,764,3,1,4,"(4.697144,-74.140516)"
2015,Junio,Noruega,578,0,2,2,"(10.408582,-75.538003)"
2019,Diciembre,República de Belarús,112,2,0,2,"(6.171601,-75.427454)"
2015,Marzo,Bolivia,68,1,1,2,"(12.586067,-81.702563)"
2016,Febrero,República de Irlanda,372,7,19,26,"(10.445761,-75.516429)"
2013,Junio,Croacia,191,0,3,3,"(10.408582,-75.538003)"
2016,Diciembre,Antigua y Barbuda,28,0,2,2,"(6.171601,-75.427454)"
2022,Septiembre,Portugal,620,0,1,1,"(11.117806,-74.232622)"
2013,Abril,República de Corea,410,9,17,26,"(6.171601,-75.427454)"
2022,Agosto,Francia,250,0,1,1,"(7.128456,-73.183637)"
2013,Abril,Líbano,422,2,2,4,"(6.171601,-75.427454)"
2013,Octubre,Países Bajos,528,17,21,38,"(6.171601,-75.427454)"
2015,Septiembre,Luxemburgo,442,0,1,1,"(4.815061,-75.736532)"
2020,Enero,Haití,332,1,0,1,"(7.128456,-73.183637)"
2022,Junio,Noruega,578,15,18,33,"(10.445761,-75.516429)"
2013,Abril,Brasil,76,24,21,45,"(12.586067,-81.702563)"
2013,Mayo,Israel,376,0,1,1,"(12.586067,-81.702563)"
2018,Enero,Italia,380,122,363,485,"(6.171601,-75.427454)"
2013,Noviembre,Austria,40,8,16,24,"(10.445761,-75.516429)"
2021,Marzo,República Dominicana,214,0,4,4,"(7.128456,-73.183637)"
2020,Febrero,Venezuela,862,32,25,57,"(10.408582,-75.538003)"
2014,Agosto,República Dominicana,214,0,1,1,"(-4.197703,-69.941278)"
2017,Diciembre,México,484,686,1162,1848,"(6.171601,-75.427454)"
2021,Junio,Qatar,634,0,2,2,"(6.171601,-75.427454)"
2022,Junio,México,484,1878,3014,4892,"(6.171601,-75.427454)"
2023,Enero,Venezuela,862,0,17,17,"(3.893038,-77.067921)"
2023,Marzo,República Dominicana,214,2,3,5,"(11.117806,-74.232622)"
2013,Julio,Filipinas,608,21,82,103,"(4.697144,-74.140516)"
2019,Junio,Guatemala,320,1,1,2,"(10.408582,-75.538003)"
2018,Septiembre,Austria,40,0,1,1,"(11.360009,-72.129330)"
2017,Julio,Sudáfrica,710,4,4,8,"(10.408582,-75.538003)"
2012,Julio,Paraguay,600,0,1,1,"(7.818934,-72.453226)"
2012,Octubre,Filipinas,608,0,6,6,"(11.247723,-74.213989)"
2014,Enero,Italia,380,1,2,3,"(4.815061,-75.736532)"
2013,Junio,Países Bajos,528,1,2,3,"(8.635765,-77.346578)"
2015,Marzo,Desconocido,99999,1,5,6,"(10.445761,-75.516429)"
2012,Julio,Costa Rica,188,0,2,2,"(4.815061,-75.736532)"
2021,Septiembre,Bolivia,68,79,55,134,"(10.445761,-75.516429)"
2019,Marzo,Sri Lanka,144,1,8,9,"(4.697144,-74.140516)"
2014,Junio,Argentina,32,4,5,9,"(7.128456,-73.183637)"
2019,Abril,Nueva Zelanda,554,8,9,17,"(10.445761,-75.516429)"
2020,Marzo,México,484,557,1151,1708,"(6.171601,-75.427454)"
2012,Junio,Noruega,578,2,0,2,"(4.815061,-75.736532)"
2019,Agosto,Brasil,76,140,124,264,"(-4.197703,-69.941278)"
2017,Noviembre,Israel,376,106,426,532,"(4.697144,-74.140516)"
2018,Noviembre,Cuba,192,0,3,3,"(7.818934,-72.453226)"
2014,Diciembre,Paraguay,600,1,0,1,"(0.25129,-76.875963)"
2012,Octubre,Filipinas,608,0,38,38,"(10.408582,-75.538003)"
2019,Junio,El Salvador,222,1,1,2,"(7.818934,-72.453226)"
2018,Junio,Paraguay,600,3,11,14,"(10.886611,-74.776708)"
2015,Junio,San Cristóbal y Nevis,659,0,3,3,"(6.171601,-75.427454)"
2013,Diciembre,Jamaica,388,0,2,2,"(10.445761,-75.516429)"
2022,Julio,Irán,364,0,1,1,"(4.452882,-75.766298)"
2013,Agosto,Chile,152,1,0,1,"(4.815061,-75.736532)"
2021,Octubre,Italia,380,0,2,2,"(7.128456,-73.183637)"
2022,Enero,Filipinas,608,1,0,1,"(0.814836,-77.662532)"
2016,Diciembre,Australia,36,22,25,47,"(8.635765,-77.346578)"
2022,Agosto,México,484,4,4,8,"(11.360009,-72.129330)"
2021,Diciembre,Bulgaria,100,2,4,6,"(10.445761,-75.516429)"
2016,Noviembre,Perú,604,7,9,16,"(11.360009,-72.129330)"
2022,Octubre,Japón,392,0,1,1,"(7.927209,-72.507910)"
2021,Noviembre,Uruguay,858,0,2,2,"(-4.197703,-69.941278)"
2017,Enero,México,484,102,212,314,"(10.445761,-75.516429)"
2021,Julio,Marruecos,504,1,0,1,"(6.171601,-75.427454)"
2019,Marzo,Burkina Faso,854,0,1,1,"(4.697144,-74.140516)"
2022,Junio,Marruecos,504,0,1,1,"(0.25129,-76.875963)"
2012,Noviembre,Yugoslavia,99999,2,1,3,"(4.697144,-74.140516)"
2019,Agosto,México,484,221,282,503,"(10.445761,-75.516429)"
2012,Agosto,Nicaragua,558,0,1,1,"(10.408582,-75.538003)"
2014,Junio,Polonia,616,1,0,1,"(10.886611,-74.776708)"
2018,Julio,Eslovenia,705,1,0,1,"(3.541112,-76.384584)"
2022,Septiembre,Eslovaquia,703,1,2,3,"(3.541112,-76.384584)"
2015,Marzo,Perú,604,170,259,429,"(3.541112,-76.384584)"
2012,Octubre,Nueva Zelanda,554,0,1,1,"(7.818934,-72.453226)"
2014,Octubre,España,724,2,3,5,"(7.128456,-73.183637)"
2014,Febrero,Uruguay,858,132,265,397,"(4.697144,-74.140516)"
2016,Octubre,Vietnam,704,1,1,2,"(6.171601,-75.427454)"
2012,Junio,Ecuador,218,72,74,146,"(10.445761,-75.516429)"
2017,Septiembre,Israel,376,24,51,75,"(10.445761,-75.516429)"
2022,Junio,El Salvador,222,177,179,356,"(10.445761,-75.516429)"
2016,Diciembre,Brasil,76,1,2,3,"(7.128456,-73.183637)"
2019,Agosto,Belice,84,19,26,45,"(4.697144,-74.140516)"
2013,Marzo,Reino Unido de Gran Bretaña e Irlanda del Norte,826,1,1,2,"(12.5744111,-81.703935)"
2014,Julio,Portugal,620,0,1,1,"(-4.197703,-69.941278)"
2019,Marzo,Alemania,276,5,9,14,"(0.25129,-76.875963)"
2014,Septiembre,Malta,470,2,5,7,"(4.697144,-74.140516)"
2013,Noviembre,Ecuador,218,1,11,12,"(10.886611,-74.776708)"
2013,Julio,República Dominicana,214,2,8,10,"(0.814836,-77.662532)"
2018,Abril,Uruguay,858,18,16,34,"(12.586067,-81.702563)"
2015,Abril,Bahamas,44,1,1,2,"(10.886611,-74.776708)"
2017,Febrero,Tanzania,834,0,2,2,"(4.697144,-74.140516)"
2023,Junio,Malasia,458,0,1,1,"(3.541112,-76.384584)"
2017,Marzo,Panamá,591,26,39,65,"(4.452882,-75.766298)"
2023,Junio,Liechtenstein,438,2,2,4,"(4.697144,-74.140516)"
2019,Diciembre,Afganistán,4,1,7,8,"(4.697144,-74.140516)"
2018,Agosto,Surinam,740,2,1,3,"(7.128456,-73.183637)"
2013,Abril,Estados Unidos de América,840,76,118,194,"(4.452882,-75.766298)"
2017,Febrero,Canadá,124,1222,2061,3283,"(4.697144,-74.140516)"
2013,Marzo,España,724,0,6,6,"(4.815061,-75.736532)"
2020,Diciembre,Perú,604,1,6,7,"(4.815061,-75.736532)"
2018,Septiembre,República Dominicana,214,5,5,10,"(12.586067,-81.702563)"
2018,Abril,Hungría,348,4,3,7,"(3.541112,-76.384584)"
2015,Enero,Panamá,591,781,1012,1793,"(4.697144,-74.140516)"
2022,Junio,Croacia,191,15,43,58,"(4.697144,-74.140516)"
2015,Febrero,Turquía,792,64,298,362,"(4.697144,-74.140516)"
2013,Marzo,Bolivia,68,1,0,1,"(7.128456,-73.183637)"
2012,Marzo,Austria,40,2,3,5,"(11.360009,-72.129330)"
2017,Mayo,Cuba,192,0,1,1,"(4.452882,-75.766298)"
2014,Noviembre,Croacia,191,0,7,7,"(10.445761,-75.516429)"
2019,Enero,Canadá,124,17,22,39,"(4.815061,-75.736532)"
2019,Abril,Argentina,32,1,0,1,"(11.117806,-74.232622)"
2016,Junio,Polonia,616,3,4,7,"(-4.197703,-69.941278)"
2022,Octubre,República Democrática del Congo,180,1,5,6,"(4.697144,-74.140516)"
2014,Julio,Costa Rica,188,80,76,156,"(10.445761,-75.516429)"
2022,Noviembre,Estados Unidos de América,840,135,215,350,"(4.452882,-75.766298)"
2015,Julio,Nueva Zelanda,554,18,18,36,"(0.814836,-77.662532)"
2016,Diciembre,República Dominicana,214,18,64,82,"(10.445761,-75.516429)"
2019,Agosto,Nicaragua,558,15,26,41,"(6.171601,-75.427454)"
2022,Agosto,Reino Unido de Gran Bretaña e Irlanda del Norte,826,5,7,12,"(11.117806,-74.232622)"
2016,Septiembre,Desconocido,99999,0,1,1,"(10.886611,-74.776708)"
2014,Junio,Estados Unidos de América,840,23,31,54,"(7.818934,-72.453226)"
2014,Noviembre,Turquía,792,3,21,24,"(6.171601,-75.427454)"
2017,Agosto,Suiza,756,1,1,2,"(7.818934,-72.453226)"
2017,Abril,Nicaragua,558,0,1,1,"(10.408582,-75.538003)"
2012,Diciembre,Chile,152,11,27,38,"(10.886611,-74.776708)"
2018,Diciembre,Ecuador,218,3432,3973,7405,"(4.697144,-74.140516)"
2017,Abril,Suiza,756,20,22,42,"(0.814836,-77.662532)"
2012,Noviembre,Bolivia,68,7,3,10,"(10.886611,-74.776708)"
2015,Octubre,Perú,604,5306,5895,11201,"(4.697144,-74.140516)"
2013,Octubre,Taiwán,158,3,1,4,"(10.445761,-75.516429)"
2013,Enero,Grecia,300,0,2,2,"(10.445761,-75.516429)"
2018,Junio,Noruega,578,22,17,39,"(10.445761,-75.516429)"
2022,Julio,Estonia,233,3,5,8,"(6.171601,-75.427454)"
2012,Septiembre,Portugal,620,83,303,386,"(4.697144,-74.140516)"
2015,Abril,Eslovenia,705,0,1,1,"(10.886611,-74.776708)"
2015,Abril,Turquía,792,0,10,10,"(7.927209,-72.507910)"
2015,Mayo,Paraguay,600,2,1,3,"(10.886611,-74.776708)"
2018,Enero,Australia,36,6,8,14,"(-4.223468,-69.945098)"
2019,Noviembre,Reino Unido de Gran Bretaña e Irlanda del Norte,826,1,1,2,"(12.5744111,-81.703935)"
2016,Junio,Guatemala,320,0,1,1,"(10.408582,-75.538003)"
2018,Marzo,Suiza,756,7,8,15,"(10.886611,-74.776708)"
2023,Enero,Panamá,591,158,180,338,"(4.815061,-75.736532)"
2019,Julio,Perú,604,15,25,40,"(10.408582,-75.538003)"
2014,Octubre,China,156,1,0,1,"(7.927209,-72.507910)"
2021,Octubre,Suecia,752,2,2,4,"(10.886611,-74.776708)"
2017,Abril,República Checa,203,6,10,16,"(10.445761,-75.516429)"
2019,Agosto,Marruecos,504,3,2,5,"(6.171601,-75.427454)"
2017,Junio,Paraguay,600,5,0,5,"(0.814836,-77.662532)"
2017,Marzo,España,724,2,1,3,"(8.635765,-77.346578)"
2021,Marzo,Austria,40,1,1,2,"(10.886611,-74.776708)"
2022,Octubre,Nicaragua,558,0,1,1,"(12.5744111,-81.703935)"
2012,Julio,Australia,36,4,4,8,"(8.635765,-77.346578)"
2019,Agosto,Dinamarca,208,1,0,1,"(0.814836,-77.662532)"
2019,Enero,Federación de Rusia,643,2,2,4,"(-4.223468,-69.945098)"
2020,Agosto,Italia,380,2,0,2,"(0.814836,-77.662532)"
2020,Noviembre,Egipto,818,0,8,8,"(4.697144,-74.140516)"
2014,Diciembre,Georgia,268,0,1,1,"(9.402978,-75.681599)"
2019,Abril,El Salvador,222,126,192,319,"(6.171601,-75.427454)"
2022,Octubre,Azerbaiyán,31,0,2,2,"(10.445761,-75.516429)"
2018,Junio,Canadá,124,183,391,574,"(6.171601,-75.427454)"
2016,Febrero,México,484,261,780,1041,"(6.171601,-75.427454)"
2017,Julio,Uzbekistán,860,0,1,1,"(4.697144,-74.140516)"
2017,Diciembre,Venezuela,862,32150,34305,66455,"(7.818934,-72.453226)"
2018,Diciembre,Federación de Rusia,643,2,1,3,"(7.818934,-72.453226)"
2013,Agosto,Israel,376,1,5,6,"(8.635765,-77.346578)"
2015,Enero,Uruguay,858,101,63,164,"(12.586067,-81.702563)"
2012,Abril,Alemania,276,1,2,3,"(0.25129,-76.875963)"
2019,Agosto,Brasil,76,2,1,3,"(8.635765,-77.346578)"
2013,Diciembre,Bulgaria,100,0,1,1,"(3.893038,-77.067921)"
2019,Septiembre,Austria,40,10,23,33,"(10.445761,-75.516429)"
2017,Enero,Dinamarca,208,0,1,1,"(3.893038,-77.067921)"
2017,Septiembre,Ucrania,804,0,2,2,"(3.893038,-77.067921)"
2019,Abril,Chile,152,2,2,4,"(0.25129,-76.875963)"
2017,Marzo,Marruecos,504,1,1,2,"(10.445761,-75.516429)"
2012,Enero,Paraguay,600,2,2,4,"(0.814836,-77.662532)"
2022,Diciembre,Noruega,578,149,224,373,"(4.697144,-74.140516)"
2017,Mayo,Canadá,124,137,159,296,"(10.445761,-75.516429)"
2012,Octubre,Bélgica,56,0,1,1,"(11.360009,-72.129330)"
2015,Febrero,Lituania,440,2,2,4,"(0.814836,-77.662532)"
2018,Diciembre,Venezuela,862,259,251,511,"(10.445761,-75.516429)"
2019,Noviembre,Jamaica,388,0,1,1,"(10.971302,-74.765397)"
2019,Octubre,España,724,21,50,71,"(10.886611,-74.776708)"
2019,Julio,Haití,332,2,6,8,"(6.171601,-75.427454)"
2016,Marzo,Polonia,616,2,5,7,"(10.886611,-74.776708)"
2018,Enero,Estados Unidos de América,840,13,15,28,"(-4.197703,-69.941278)"
2013,Enero,República de Corea,410,182,398,580,"(4.697144,-74.140516)"
2016,Enero,Ecuador,218,4,1,5,"(4.452882,-75.766298)"
2016,Mayo,Suecia,752,3,7,10,"(10.408582,-75.538003)"
2014,Enero,Nigeria,566,0,6,6,"(4.697144,-74.140516)"
2012,Agosto,Bulgaria,100,1,0,1,"(0.814836,-77.662532)"
2019,Noviembre,Francia,250,9,24,33,"(10.886611,-74.776708)"
2014,Junio,Sudán,736,1,0,1,"(4.697144,-74.140516)"
2014,Noviembre,Guatemala,320,25,52,77,"(3.541112,-76.384584)"
2022,Diciembre,Ecuador,218,0,1,1,"(0.812436,-77.847006)"
2012,Enero,Australia,36,30,70,100,"(6.171601,-75.427454)"
2021,Febrero,Austria,40,4,8,12,"(6.171601,-75.427454)"
2019,Junio,República Dominicana,214,925,1010,1935,"(4.697144,-74.140516)"
2013,Octubre,Filipinas,608,0,32,32,"(3.893038,-77.067921)"
2014,Junio,Filipinas,608,30,62,92,"(4.697144,-74.140516)"
2021,Marzo,Argentina,32,1,0,1,"(-4.197703,-69.941278)"
2018,Julio,China,156,10,15,25,"(10.886611,-74.776708)"
2019,Octubre,Reino Unido de Gran Bretaña e Irlanda del Norte,826,0,1,1,"(3.893038,-77.067921)"
2015,Septiembre,Reino Unido de Gran Bretaña e Irlanda del Norte,826,42,128,170,"(6.171601,-75.427454)"
2013,Septiembre,Japón,392,1,2,3,"(8.635765,-77.346578)"
2017,Noviembre,Honduras,340,2,3,5,"(4.815061,-75.736532)"
2017,Agosto,Italia,380,0,1,1,"(13.3387613,-81.372937)"
2017,Febrero,Ecuador,218,2,2,4,"(4.815061,-75.736532)"
2014,Marzo,Ecuador,218,0,1,1,"(11.528919,-72.919681)"
2023,Enero,Bulgaria,100,7,16,23,"(6.171601,-75.427454)"
2012,Octubre,Costa Rica,188,400,686,1086,"(4.697144,-74.140516)"
2018,Diciembre,Irán,364,0,1,1,"(6.171601,-75.427454)"
2016,Noviembre,Venezuela,862,0,1,1,"(-4.197703,-69.941278)"
2022,Julio,Uruguay,858,499,565,1064,"(4.697144,-74.140516)"
2019,Marzo,Australia,36,3,3,6,"(-4.223468,-69.945098)"
2013,Septiembre,Argentina,32,6,2,8,"(0.25129,-76.875963)"
2023,Marzo,Israel,376,0,1,1,"(10.408582,-75.538003)"
2015,Abril,Sudáfrica,710,1,0,1,"(0.814836,-77.662532)"
2017,Julio,Austria,40,4,7,11,"(10.408582,-75.538003)"
2019,Septiembre,República de Moldavia,498,1,0,1,"(10.445761,-75.516429)"
2012,Septiembre,Argentina,32,714,628,1342,"(10.445761,-75.516429)"
2021,Diciembre,Estonia,233,0,1,1,"(10.886611,-74.776708)"
2013,Marzo,Israel,376,0,6,6,"(-4.197703,-69.941278)"
2014,Mayo,República de Irlanda,372,9,21,30,"(6.171601,-75.427454)"
2017,Diciembre,Guyana,328,0,1,1,"(3.541112,-76.384584)"
2013,Marzo,Rumania,642,1,0,1,"(4.815061,-75.736532)"
2013,Abril,España,724,1,2,3,"(7.088729,-70.740253)"
2015,Enero,Brasil,76,44,46,90,"(0.814836,-77.662532)"
2016,Agosto,Ghana,288,0,2,2,"(6.171601,-75.427454)"
2021,Diciembre,Taiwán,158,21,37,58,"(4.697144,-74.140516)"
2014,Agosto,Uganda,800,0,2,2,"(4.697144,-74.140516)"
2012,Enero,Libia,434,0,1,1,"(6.171601,-75.427454)"
2015,Marzo,Honduras,340,0,1,1,"(13.3387613,-81.372937)"
2018,Octubre,Francia,250,5,6,11,"(7.818934,-72.453226)"
2014,Noviembre,Finlandia,246,1,6,7,"(6.171601,-75.427454)"
2016,Junio,Australia,36,0,1,1,"(6.185799,-67.483929)"
2023,Mayo,Perú,604,5,8,13,"(0.25129,-76.875963)"
2021,Diciembre,Portugal,620,2,5,7,"(7.088729,-70.740253)"
2020,Marzo,China,156,0,3,3,"(8.36068,-72.409396)"
2023,Mayo,Qatar,634,9,6,15,"(6.171601,-75.427454)"
2018,Octubre,Chile,152,57,150,207,"(6.171601,-75.427454)"
2014,Junio,Desconocido,99999,0,1,1,"(8.635765,-77.346578)"
2023,Junio,República de Corea,410,1,0,1,"(4.815061,-75.736532)"
2023,Marzo,San Cristóbal y Nevis,659,0,1,1,"(0.814836,-77.662532)"
2013,Febrero,Croacia,191,15,19,34,"(4.697144,-74.140516)"
2012,Abril,Honduras,340,8,11,19,"(3.541112,-76.384584)"
2015,Noviembre,Países Bajos,528,257,379,636,"(6.171601,-75.427454)"
2021,Marzo,China,156,3,21,24,"(6.171601,-75.427454)"
2017,Diciembre,República de Corea,410,2,3,5,"(10.886611,-74.776708)"
2016,Diciembre,Nueva Zelanda,554,0,2,2,"(-4.197703,-69.941278)"
2022,Agosto,Bolivia,68,2,2,4,"(4.815061,-75.736532)"
2019,Mayo,Perú,604,64,58,122,"(-4.223468,-69.945098)"
2023,Marzo,Estados Unidos de América,840,3,4,7,"(13.3387613,-81.372937)"
2015,Noviembre,Noruega,578,4,8,12,"(3.541112,-76.384584)"
2012,Mayo,Francia,250,4,13,17,"(11.360009,-72.129330)"
2016,Febrero,Estados Unidos de América,840,0,5,5,"(-4.223468,-69.945098)"
2016,Mayo,Kazajistán,398,4,1,5,"(4.697144,-74.140516)"
2016,Agosto,Chile,152,1,0,1,"(8.635765,-77.346578)"
2017,Noviembre,Alemania,276,16,27,43,"(10.886611,-74.776708)"
2013,Marzo,Isla de Man,833,4,6,10,"(10.886611,-74.776708)"
2015,Agosto,Ecuador,218,0,1,1,"(6.185799,-67.483929)"
2022,Marzo,Suiza,756,1,0,1,"(0.25129,-76.875963)"
2015,Abril,Suiza,756,15,11,26,"(10.445761,-75.516429)"
2023,Marzo,Mozambique,508,0,2,2,"(6.171601,-75.427454)"
2017,Mayo,Honduras,340,18,11,29,"(12.586067,-81.702563)"
2023,Enero,Bermudas/Territorio Británico de Ultramar,60,1,1,2,"(3.541112,-76.384584)"
2013,Agosto,Finlandia,246,1,0,1,"(11.360009,-72.129330)"
2013,Enero,Ecuador,218,1,0,1,"(4.452882,-75.766298)"
2013,Abril,Jamaica,388,1,0,1,"(4.815061,-75.736532)"
2013,Septiembre,Alemania,276,18,27,45,"(10.408582,-75.538003)"
2023,Abril,Reino Unido de Gran Bretaña e Irlanda del Norte,826,2,7,9,"(11.247723,-74.213989)"
2012,Diciembre,Argentina,32,0,1,1,"(6.228046,-77.404104)"
2013,Julio,Guyana,328,2,2,4,"(6.171601,-75.427454)"
2013,Enero,Italia,380,4,12,16,"(10.408582,-75.538003)"
2022,Julio,Ecuador,218,3,2,5,"(7.128456,-73.183637)"
2017,Noviembre,Brasil,76,7089,7755,14844,"(4.697144,-74.140516)"
2014,Octubre,República de Irlanda,372,9,7,16,"(0.814836,-77.662532)"
2023,Junio,Emiratos Árabes,784,0,1,1,"(6.171601,-75.427454)"
2021,Octubre,Nigeria,566,2,6,8,"(4.697144,-74.140516)"
2013,Febrero,Finlandia,246,0,1,1,"(7.818934,-72.453226)"
2020,Febrero,Santa Lucia,662,1,1,2,"(10.445761,-75.516429)"
2020,Enero,Desconocido,99999,1,0,1,"(7.818934,-72.453226)"
2023,Marzo,Togo,768,1,0,1,"(4.697144,-74.140516)"
2023,Enero,Letonia,428,14,23,37,"(4.697144,-74.140516)"
2022,Mayo,Nigeria,566,1,7,8,"(10.445761,-75.516429)"
2014,Marzo,Eslovenia,705,0,3,3,"(10.445761,-75.516429)"
2014,Agosto,Rumania,642,0,2,2,"(10.408582,-75.538003)"
2014,Mayo,Irán,364,0,1,1,"(-4.197703,-69.941278)"
2015,Noviembre,Perú,604,163,303,466,"(3.541112,-76.384584)"
2015,Mayo,Austria,40,7,5,12,"(0.814836,-77.662532)"
2017,Febrero,Chile,152,1,3,4,"(11.247723,-74.213989)"
2014,Abril,República Democrática Popular  Lao,418,1,0,1,"(6.171601,-75.427454)"
2017,Agosto,Italia,380,127,318,445,"(10.445761,-75.516429)"
2019,Mayo,Noruega,578,2,2,4,"(12.586067,-81.702563)"
2016,Octubre,Reino Unido de Gran Bretaña e Irlanda del Norte,826,0,3,3,"(11.247723,-74.213989)"
2014,Noviembre,España,724,1,3,4,"(11.247723,-74.213989)"
2023,Febrero,República de Corea,410,5,16,21,"(10.445761,-75.516429)"
2022,Mayo,México,484,0,3,3,"(6.185799,-67.483929)"
2019,Octubre,Singapur,702,2,0,2,"(6.171601,-75.427454)"
2017,Julio,Perú,604,10,14,24,"(11.360009,-72.129330)"
2014,Abril,Afganistán,4,1,2,3,"(6.171601,-75.427454)"
2019,Diciembre,Lituania,440,1,2,3,"(3.541112,-76.384584)"
2023,Marzo,República Del Congo,178,1,0,1,"(4.697144,-74.140516)"
2015,Julio,Perú,604,175,161,336,"(12.586067,-81.702563)"
2015,Octubre,Australia,36,6,4,10,"(-4.197703,-69.941278)"
2013,Julio,Bolivia,68,340,479,819,"(4.697144,-74.140516)"
2023,Marzo,Ecuador,218,2,5,7,"(7.088729,-70.740253)"
2015,Junio,Polonia,616,5,8,13,"(10.445761,-75.516429)"
2014,Octubre,Canadá,124,0,5,5,"(11.360009,-72.129330)"
2013,Diciembre,Suecia,752,1,3,4,"(7.128456,-73.183637)"
2019,Septiembre,Venezuela,862,0,1,1,"(11.247723,-74.213989)"
2017,Febrero,Canadá,124,5,5,10,"(7.818934,-72.453226)"
2013,Diciembre,Dinamarca,208,2,2,4,"(-4.197703,-69.941278)"
2014,Febrero,Rumania,642,0,4,4,"(10.408582,-75.538003)"
2017,Noviembre,Reino Unido de Gran Bretaña e Irlanda del Norte,826,0,1,1,"(7.927209,-72.507910)"
2017,Junio,Burkina Faso,854,0,1,1,"(10.886611,-74.776708)"
2019,Mayo,República Dominicana,214,0,2,2,"(0.25129,-76.875963)"
2017,Julio,Trinidad y Tobago,780,5,11,16,"(3.541112,-76.384584)"
2013,Septiembre,Francia,250,8,9,17,"(-4.197703,-69.941278)"
2013,Mayo,Suiza,756,2,3,5,"(-4.197703,-69.941278)"
2016,Junio,Uruguay,858,1,2,3,"(7.128456,-73.183637)"
2016,Enero,España,724,225,538,763,"(6.171601,-75.427454)"
2017,Julio,Francia,250,1,7,8,"(7.128456,-73.183637)"
2014,Noviembre,Líbano,422,3,7,10,"(11.360009,-72.129330)"
2021,Diciembre,Uruguay,858,5,32,37,"(3.541112,-76.384584)"
2021,Junio,Israel,376,45,242,287,"(4.697144,-74.140516)"
2015,Julio,Ucrania,804,0,2,2,"(9.402978,-75.681599)"
2018,Junio,Níger,562,1,0,1,"(4.697144,-74.140516)"
2019,Abril,Ghana,288,1,2,3,"(10.445761,-75.516429)"
2022,Octubre,Bangladesh,50,2,4,6,"(6.171601,-75.427454)"
2021,Julio,España,724,20,28,48,"(10.886611,-74.776708)"
2019,Julio,Brasil,76,4429,5417,9846,"(4.697144,-74.140516)"
2022,Octubre,Jamaica,388,47,78,125,"(4.697144,-74.140516)"
2013,Enero,Honduras,340,110,127,237,"(4.697144,-74.140516)"
2016,Mayo,Australia,36,30,51,81,"(0.814836,-77.662532)"
2013,Junio,Canadá,124,0,3,3,"(12.586067,-81.702563)"
2015,Septiembre,Cuba,192,41,59,100,"(6.171601,-75.427454)"
2023,Junio,Bahamas,44,7,8,15,"(4.697144,-74.140516)"
2022,Junio,Ecuador,218,4,1,5,"(0.812436,-77.847006)"
2015,Marzo,Noruega,578,1,2,3,"(-4.197703,-69.941278)"
2023,Abril,China,156,0,1,1,"(-4.197703,-69.941278)"
2017,Noviembre,España,724,9,8,17,"(10.408582,-75.538003)"
2016,Noviembre,Emiratos Árabes,784,1,15,16,"(4.697144,-74.140516)"
2021,Abril,República de Irlanda,372,0,1,1,"(10.886611,-74.776708)"
2012,Octubre,República Dominicana,214,3,3,6,"(11.360009,-72.129330)"
2016,Julio,Kuwait,414,2,6,8,"(4.697144,-74.140516)"
2014,Agosto,República de Armenia,51,1,2,3,"(4.697144,-74.140516)"
2013,Marzo,Israel,376,8,25,33,"(10.445761,-75.516429)"
2023,Febrero,Islandia,352,1,0,1,"(7.916725,-72.462544)"
2022,Febrero,Brasil,76,0,1,1,"(3.866713,-67.927521)"
2022,Septiembre,Granada,308,0,3,3,"(10.445761,-75.516429)"
2013,Octubre,Nepal,524,0,1,1,"(6.171601,-75.427454)"
2012,Junio,Países Bajos,528,0,1,1,"(6.171601,-75.427454)"
2019,Julio,Reino Unido de Gran Bretaña e Irlanda del Norte,826,2,9,11,"(4.815061,-75.736532)"
2013,Enero,Costa Rica,188,7,12,19,"(4.815061,-75.736532)"
2016,Octubre,Estados Unidos de América,840,2,0,2,"(0.25129,-76.875963)"
2016,Abril,Venezuela,862,659,771,1430,"(6.171601,-75.427454)"
2023,Enero,Nicaragua,558,1,0,1,"(7.128456,-73.183637)"
2016,Noviembre,Italia,380,65,232,297,"(6.171601,-75.427454)"
2022,Mayo,Polonia,616,11,18,29,"(10.445761,-75.516429)"
2021,Agosto,República Dominicana,214,281,362,643,"(6.171601,-75.427454)"
2014,Junio,Brasil,76,0,6,6,"(6.185799,-67.483929)"
2019,Octubre,Panamá,591,19,22,41,"(7.128456,-73.183637)"
2017,Enero,Reino Unido de Gran Bretaña e Irlanda del Norte,826,1,2,3,"(13.3387613,-81.372937)"
2015,Septiembre,República Dominicana,214,0,2,2,"(7.818934,-72.453226)"
2022,Julio,El Salvador,222,866,964,1830,"(4.697144,-74.140516)"
2015,Agosto,Sierra Leona,694,0,1,1,"(10.445761,-75.516429)"
2014,Mayo,República de Irlanda,372,0,1,1,"(4.815061,-75.736532)"
2019,Diciembre,Perú,604,268,183,451,"(12.586067,-81.702563)"
2014,Junio,Bélgica,56,1,15,16,"(10.886611,-74.776708)"
2014,Mayo,Hungría,348,0,1,1,"(-4.197703,-69.941278)"
2022,Febrero,Honduras,340,3,5,8,"(7.128456,-73.183637)"
2019,Julio,Etiopia,231,1,2,3,"(3.541112,-76.384584)"
2019,Agosto,Suecia,752,0,1,1,"(0.25129,-76.875963)"
2015,Enero,Letonia,428,6,10,16,"(4.697144,-74.140516)"
2019,Abril,Kazajistán,398,1,0,1,"(10.445761,-75.516429)"
2019,Mayo,Haití,332,12,34,46,"(4.697144,-74.140516)"
2013,Octubre,Alemania,276,1,1,2,"(10.971302,-74.765397)"
2022,Octubre,Lituania,440,0,2,2,"(10.408582,-75.538003)"
2014,Septiembre,Mauricio,480,0,1,1,"(4.697144,-74.140516)"
2018,Octubre,Filipinas,608,1,40,41,"(10.408582,-75.538003)"
2019,Octubre,Ucrania,804,6,12,18,"(6.171601,-75.427454)"
2018,Noviembre,China,156,29,29,58,"(10.445761,-75.516429)"
2017,Agosto,Venezuela,862,0,1,1,"(7.102626,-77.762647)"
2015,Diciembre,Noruega,578,1,3,4,"(12.5744111,-81.703935)"
2012,Agosto,Turkmenistán,795,1,0,1,"(4.697144,-74.140516)"
2020,Febrero,Omán,512,0,1,1,"(10.445761,-75.516429)"
2012,Agosto,Australia,36,1,4,5,"(7.818934,-72.453226)"
2023,Marzo,Polonia,616,33,38,71,"(6.171601,-75.427454)"
2013,Enero,Trinidad y Tobago,780,18,26,44,"(4.697144,-74.140516)"
2016,Junio,Rumania,642,40,49,89,"(4.697144,-74.140516)"
2013,Enero,España,724,3,7,10,"(10.408582,-75.538003)"
2021,Diciembre,Francia,250,0,2,2,"(10.971302,-74.765397)"
2019,Marzo,Montenegro,499,1,0,1,"(6.171601,-75.427454)"
2014,Octubre,Francia,250,1,0,1,"(7.088729,-70.740253)"
2017,Noviembre,Canadá,124,0,6,6,"(4.815061,-75.736532)"
2016,Diciembre,Taiwán,158,7,10,17,"(6.171601,-75.427454)"
2016,Abril,Surinam,740,9,10,19,"(4.697144,-74.140516)"
2012,Mayo,Suiza,756,2,6,8,"(7.818934,-72.453226)"
2017,Agosto,Francia,250,2,9,11,"(7.818934,-72.453226)"
2021,Noviembre,Croacia,191,1,0,1,"(3.541112,-76.384584)"
2017,Octubre,Alemania,276,1,2,3,"(7.128456,-73.183637)"
2017,Septiembre,Reino Unido de Gran Bretaña e Irlanda del Norte,826,1,2,3,"(0.25129,-76.875963)"
2016,Enero,Ecuador,218,0,2,2,"(4.815061,-75.736532)"
2015,Noviembre,El Salvador,222,1,0,1,"(7.818934,-72.453226)"
2017,Marzo,Austria,40,0,1,1,"(0.25129,-76.875963)"
2018,Noviembre,Países Bajos,528,0,1,1,"(4.697144,-74.140516)"
2022,Julio,Santa Lucia,662,0,3,3,"(6.171601,-75.427454)"
2019,Marzo,Portugal,620,0,1,1,"(0.812436,-77.847006)"
2021,Febrero,Guatemala,320,79,126,205,"(4.697144,-74.140516)"
2013,Diciembre,Nueva Zelanda,554,0,1,1,"(7.818934,-72.453226)"
2018,Abril,Filipinas,608,0,1,1,"(11.360009,-72.129330)"
2013,Julio,Bélgica,56,0,4,4,"(7.818934,-72.453226)"
2022,Agosto,España,724,738,1122,1860,"(6.171601,-75.427454)"
2022,Septiembre,Taiwán,158,0,1,1,"(10.886611,-74.776708)"
2018,Junio,Jamaica,388,10,20,30,"(4.697144,-74.140516)"
2017,Enero,Singapur,702,23,22,45,"(4.697144,-74.140516)"
2021,Febrero,Venezuela,862,1,0,1,"(-4.197703,-69.941278)"
2017,Junio,Panamá,591,0,1,1,"(8.36068,-72.409396)"
2017,Noviembre,Ecuador,218,2,2,4,"(7.128456,-73.183637)"
2021,Febrero,Nicaragua,558,1,1,2,"(4.815061,-75.736532)"
2021,Enero,Austria,40,3,0,3,"(10.445761,-75.516429)"
2017,Abril,Venezuela,862,108,108,216,"(7.088729,-70.740253)"
2018,Abril,España,724,7,14,21,"(4.815061,-75.736532)"
2022,Septiembre,Bélgica,56,1,1,2,"(8.635765,-77.346578)"
2017,Septiembre,Austria,40,131,277,408,"(4.697144,-74.140516)"
2022,Junio,Barbados,52,2,2,4,"(3.541112,-76.384584)"
2015,Octubre,Túnez,788,1,4,5,"(4.697144,-74.140516)"
2012,Septiembre,Australia,36,3,18,21,"(10.886611,-74.776708)"
2022,Septiembre,Alemania,276,0,3,3,"(3.893038,-77.067921)"
2023,Enero,Uganda,800,1,2,3,"(4.697144,-74.140516)"
2021,Marzo,Costa Rica,188,76,96,172,"(6.171601,-75.427454)"
2015,Enero,India,356,0,1,1,"(9.402978,-75.681599)"
2013,Diciembre,Barbados,52,3,0,3,"(6.171601,-75.427454)"
2015,Septiembre,Noruega,578,1,1,2,"(12.586067,-81.702563)"
2022,Septiembre,Estados Unidos de América,840,2,2,4,"(7.088729,-70.740253)"
2019,Noviembre,Cuba,192,0,1,1,"(7.818934,-72.453226)"
2021,Abril,Nigeria,566,1,0,1,"(3.541112,-76.384584)"
2012,Enero,Bahamas,44,2,3,5,"(4.697144,-74.140516)"
2019,Enero,Alemania,276,7,7,14,"(0.25129,-76.875963)"
2022,Agosto,Panamá,591,160,185,345,"(10.886611,-74.776708)"
2019,Septiembre,Portugal,620,0,1,1,"(-4.197703,-69.941278)"
2013,Mayo,Belice,84,2,0,2,"(6.171601,-75.427454)"
2012,Octubre,Guatemala,320,4,2,6,"(4.815061,-75.736532)"
2017,Junio,Bolivia,68,9,11,20,"(12.586067,-81.702563)"
2017,Agosto,Panamá,591,1296,1507,2803,"(4.697144,-74.140516)"
2018,Julio,Alemania,276,1,1,2,"(3.893038,-77.067921)"
2016,Agosto,Surinam,740,27,19,46,"(6.171601,-75.427454)"
2013,Marzo,China,156,2,9,11,"(3.541112,-76.384584)"
2020,Noviembre,España,724,9,16,25,"(10.886611,-74.776708)"
2015,Diciembre,Lituania,440,2,0,2,"(0.814836,-77.662532)"
2018,Marzo,Indonesia,360,3,15,18,"(10.445761,-75.516429)"
2019,Junio,Bermudas/Territorio Británico de Ultramar,60,0,2,2,"(6.171601,-75.427454)"
2022,Noviembre,Ecuador,218,69,51,120,"(1.813928,-78.763924)"
2018,Mayo,Desconocido,99999,1,5,6,"(6.171601,-75.427454)"
2014,Junio,Austria,40,0,1,1,"(1.813928,-78.763924)"
2021,Agosto,Santa Sede/Ciudad del Vaticano,336,0,1,1,"(4.697144,-74.140516)"
2017,Septiembre,República de Irlanda,372,3,1,4,"(3.541112,-76.384584)"
2016,Noviembre,Grecia,300,23,79,102,"(4.697144,-74.140516)"
2013,Mayo,Venezuela,862,117,178,295,"(10.445761,-75.516429)"
2019,Enero,Islas Caimán/Territorio Británico de Ultramar,136,1,1,2,"(12.586067,-81.702563)"
2017,Mayo,Croacia,191,0,1,1,"(0.814836,-77.662532)"
2015,Diciembre,República Dominicana,214,11,26,37,"(10.886611,-74.776708)"
2017,Octubre,Malasia,458,24,33,57,"(4.697144,-74.140516)"
2019,Enero,Ucrania,804,0,1,1,"(10.971302,-74.765397)"
2016,Noviembre,Canadá,124,115,299,414,"(6.171601,-75.427454)"
2018,Abril,Ecuador,218,17,16,33,"(0.812436,-77.847006)"
2015,Diciembre,Costa Rica,188,249,287,536,"(6.171601,-75.427454)"
2017,Febrero,Dinamarca,208,9,17,26,"(3.541112,-76.384584)"
2013,Noviembre,Bolivia,68,30,38,68,"(10.445761,-75.516429)"
2012,Octubre,Rumania,642,32,51,83,"(4.697144,-74.140516)"
2017,Septiembre,Sierra Leona,694,0,1,1,"(10.445761,-75.516429)"
2018,Agosto,Bermudas/Territorio Británico de Ultramar,60,0,2,2,"(6.171601,-75.427454)"
2023,Enero,Noruega,578,5,26,31,"(3.541112,-76.384584)"
2016,Noviembre,Jamaica,388,0,1,1,"(10.408582,-75.538003)"
2017,Julio,China,156,0,3,3,"(11.360009,-72.129330)"
2019,Mayo,Perú,604,19,47,66,"(-0.193180,-74.784874)"
2017,Octubre,Panamá,591,4,10,14,"(8.635765,-77.346578)"
2015,Julio,Arabia Saudita,682,0,1,1,"(6.171601,-75.427454)"
2013,Septiembre,Ucrania,804,20,26,46,"(4.697144,-74.140516)"
2019,Junio,Brasil,76,0,3,3,"(7.818934,-72.453226)"
2015,Septiembre,Dinamarca,208,5,21,26,"(6.171601,-75.427454)"
2021,Septiembre,Ecuador,218,193,128,321,"(10.445761,-75.516429)"
2022,Marzo,Turquía,792,4,10,14,"(10.445761,-75.516429)"
2021,Diciembre,Lituania,440,7,10,17,"(6.171601,-75.427454)"
2012,Noviembre,Federación de Rusia,643,5,1,6,"(10.445761,-75.516429)"
2019,Diciembre,España,724,3,2,5,"(0.25129,-76.875963)"
2019,Enero,República de Armenia,51,1,1,2,"(10.445761,-75.516429)"
2015,Septiembre,Lituania,440,19,13,32,"(4.697144,-74.140516)"
2014,Octubre,Australia,36,1,1,2,"(11.247723,-74.213989)"
2016,Enero,Guatemala,320,3,3,6,"(4.815061,-75.736532)"
2014,Julio,Costa de Marfil,384,0,1,1,"(6.171601,-75.427454)"
2019,Octubre,Panamá,591,23,34,57,"(12.586067,-81.702563)"
2019,Junio,Venezuela,862,206,225,431,"(3.541112,-76.384584)"
2017,Diciembre,Alemania,276,4,8,12,"(12.586067,-81.702563)"
2018,Julio,Barbados,52,14,1,15,"(10.445761,-75.516429)"
2021,Octubre,Guyana,328,3,2,5,"(10.886611,-74.776708)"
2014,Julio,Lituania,440,1,1,2,"(0.814836,-77.662532)"
2016,Febrero,Paraguay,600,4,9,13,"(10.886611,-74.776708)"
2013,Julio,Japón,392,1,1,2,"(12.586067,-81.702563)"
2014,Septiembre,Serbia,688,9,2,11,"(4.697144,-74.140516)"
2013,Mayo,Honduras,340,2,6,8,"(10.886611,-74.776708)"
2023,Abril,Guatemala,320,8,5,13,"(11.117806,-74.232622)"
2012,Julio,Noruega,578,3,4,7,"(10.408582,-75.538003)"
2016,Mayo,Venezuela,862,670,820,1490,"(6.171601,-75.427454)"
2013,Agosto,Jamaica,388,0,1,1,"(10.886611,-74.776708)"
2014,Diciembre,Guyana,328,0,2,2,"(6.171601,-75.427454)"
2012,Abril,Hungría,348,1,1,2,"(6.171601,-75.427454)"
2016,Noviembre,Canadá,124,2,3,5,"(12.586067,-81.702563)"
2013,Febrero,Alemania,276,40,113,153,"(6.171601,-75.427454)"
2016,Diciembre,Costa Rica,188,82,116,198,"(3.541112,-76.384584)"
2015,Julio,Filipinas,608,1,1,2,"(7.818934,-72.453226)"
2020,Febrero,Chipre,196,5,7,12,"(4.697144,-74.140516)"
2012,Agosto,Austria,40,0,1,1,"(11.247723,-74.213989)"
2019,Junio,Lituania,440,5,9,14,"(6.171601,-75.427454)"
2015,Marzo,Ucrania,804,0,1,1,"(1.813928,-78.763924)"
2017,Marzo,Uruguay,858,1,1,2,"(0.25129,-76.875963)"
2020,Marzo,Antigua y Barbuda,28,0,1,1,"(6.171601,-75.427454)"
2013,Diciembre,Liechtenstein,438,1,1,2,"(8.635765,-77.346578)"
2021,Junio,Israel,376,1,5,6,"(10.886611,-74.776708)"
2012,Enero,Kenia,404,7,13,20,"(4.697144,-74.140516)"
2015,Mayo,Ecuador,218,0,7,7,"(3.893038,-77.067921)"
2021,Noviembre,Portugal,620,2,16,18,"(3.541112,-76.384584)"
2023,Enero,Haití,332,2,0,2,"(10.886611,-74.776708)"
2023,Enero,India,356,0,153,153,"(3.893038,-77.067921)"
2012,Mayo,Luxemburgo,442,4,4,8,"(4.697144,-74.140516)"
2020,Enero,Letonia,428,3,1,4,"(0.814836,-77.662532)"
2022,Septiembre,Hong Kong,344,2,4,6,"(6.171601,-75.427454)"
2019,Abril,Federación de Rusia,643,0,2,2,"(7.128456,-73.183637)"
2012,Julio,Finlandia,246,33,52,85,"(4.697144,-74.140516)"
2021,Noviembre,Barbados,52,0,3,3,"(6.171601,-75.427454)"
2017,Febrero,Noruega,578,2,2,4,"(4.815061,-75.736532)"
2021,Octubre,Nueva Zelanda,554,0,1,1,"(10.408582,-75.538003)"
2022,Febrero,Países Bajos,528,2,3,5,"(8.635765,-77.346578)"
2023,Febrero,Estonia,233,0,1,1,"(0.814836,-77.662532)"
2020,Diciembre,Estados Unidos de América,840,5,4,9,"(11.247723,-74.213989)"
2019,Agosto,San Marino,674,0,1,1,"(4.697144,-74.140516)"
2023,Mayo,Reino Unido de Gran Bretaña e Irlanda del Norte,826,22,33,55,"(0.814836,-77.662532)"
2023,Mayo,Belice,84,0,1,1,"(8.364293,-72.405710)"
2012,Octubre,Hungría,348,0,1,1,"(6.171601,-75.427454)"
2015,Febrero,Bélgica,56,0,1,1,"(12.5744111,-81.703935)"
2014,Enero,Venezuela,862,2,5,7,"(12.586067,-81.702563)"
2014,Marzo,China,156,3,2,5,"(10.445761,-75.516429)"
2018,Noviembre,Trinidad y Tobago,780,5,5,10,"(3.541112,-76.384584)"
2021,Junio,Estados Unidos de América,840,3319,7864,11183,"(6.171601,-75.427454)"
2020,Enero,Hungría,348,1,1,2,"(10.408582,-75.538003)"
2022,Mayo,Croacia,191,1,1,2,"(10.408582,-75.538003)"
2019,Noviembre,Israel,376,1,8,9,"(10.886611,-74.776708)"
2012,Abril,Países Bajos,528,21,37,58,"(11.528919,-72.919681)"
2013,Febrero,Federación de Rusia,643,20,38,58,"(4.697144,-74.140516)"
2020,Febrero,Paraguay,600,3,1,4,"(10.408582,-75.538003)"
2016,Julio,India,356,0,3,3,"(0.814836,-77.662532)"
2014,Mayo,Alemania,276,981,1743,2724,"(4.697144,-74.140516)"
2018,Abril,Australia,36,1,1,2,"(11.247723,-74.213989)"
2017,Enero,Bélgica,56,4,2,6,"(10.886611,-74.776708)"
2016,Septiembre,Trinidad y Tobago,780,1,2,3,"(7.128456,-73.183637)"
2018,Octubre,Guatemala,320,0,1,1,"(0.25129,-76.875963)"
2020,Septiembre,Turquía,792,2,35,37,"(4.697144,-74.140516)"
2023,Abril,Myanmar,104,0,1,1,"(10.445761,-75.516429)"
2017,Julio,Andorra,20,1,0,1,"(6.171601,-75.427454)"
2020,Marzo,Singapur,702,8,6,14,"(4.697144,-74.140516)"
2015,Septiembre,Países Bajos,528,10,22,32,"(10.445761,-75.516429)"
2016,Febrero,Letonia,428,0,1,1,"(9.402978,-75.681599)"
2015,Abril,Bolivia,68,1,3,4,"(11.360009,-72.129330)"
2017,Mayo,Argentina,32,7,12,19,"(-4.197703,-69.941278)"
2019,Febrero,Venezuela,862,3526,3603,7130,"(0.814836,-77.662532)"
2021,Diciembre,Haití,332,3,2,5,"(10.445761,-75.516429)"
2012,Marzo,Reino Unido de Gran Bretaña e Irlanda del Norte,826,9,16,25,"(0.814836,-77.662532)"
2018,Junio,Brasil,76,4746,5864,10610,"(4.697144,-74.140516)"
2017,Octubre,Polonia,616,1,13,14,"(10.408582,-75.538003)"
2017,Julio,República de Corea,410,12,11,23,"(10.445761,-75.516429)"
2020,Marzo,Ecuador,218,27,46,73,"(7.818934,-72.453226)"
2018,Septiembre,El Salvador,222,0,1,1,"(10.408582,-75.538003)"
2022,Mayo,Taiwán,158,18,23,41,"(4.697144,-74.140516)"
2018,Septiembre,El Salvador,222,2,2,4,"(4.815061,-75.736532)"
2016,Junio,República de Irlanda,372,2,20,22,"(6.171601,-75.427454)"
2015,Mayo,Montenegro,499,1,2,3,"(10.445761,-75.516429)"
2015,Noviembre,Uruguay,858,70,64,134,"(10.445761,-75.516429)"
2023,Junio,Kazajistán,398,1,0,1,"(10.886611,-74.776708)"
2020,Febrero,República Dominicana,214,1,2,3,"(4.452882,-75.766298)"
2022,Noviembre,Brasil,76,1,2,3,"(8.36068,-72.409396)"
2022,Octubre,Panamá,591,1,0,1,"(0.814836,-77.662532)"
2018,Noviembre,Austria,40,0,3,3,"(-4.197703,-69.941278)"
2020,Octubre,Federación de Rusia,643,23,38,61,"(4.697144,-74.140516)"
2022,Enero,Estados Unidos de América,840,2,3,5,"(8.36068,-72.409396)"
2017,Junio,Bolivia,68,681,661,1342,"(4.697144,-74.140516)"
2014,Abril,Alemania,276,8,3,11,"(12.586067,-81.702563)"
2015,Enero,Honduras,340,5,4,9,"(7.927209,-72.507910)"
2013,Agosto,Rwanda,646,2,0,2,"(3.541112,-76.384584)"
2017,Febrero,Brasil,76,213,249,462,"(6.171601,-75.427454)"
2017,Julio,Bulgaria,100,5,6,11,"(10.445761,-75.516429)"
2017,Marzo,Venezuela,862,540,692,1232,"(6.171601,-75.427454)"
2022,Julio,Guatemala,320,7,42,49,"(10.408582,-75.538003)"
2019,Mayo,Brasil,76,405,276,681,"(10.408582,-75.538003)"
2017,Junio,Ghana,288,6,6,12,"(4.697144,-74.140516)"
2013,Febrero,Dinamarca,208,1,0,1,"(-4.197703,-69.941278)"
2015,Marzo,China,156,0,1,1,"(4.815061,-75.736532)"
2023,Junio,Jamaica,388,1,2,3,"(10.886611,-74.776708)"
2022,Mayo,Guyana,328,7,8,15,"(4.697144,-74.140516)"
2016,Septiembre,República Dominicana,214,5,6,11,"(4.815061,-75.736532)"
2014,Julio,Eslovaquia,703,1,0,1,"(10.886611,-74.776708)"
2012,Abril,Japón,392,0,1,1,"(11.360009,-72.129330)"
2014,Agosto,Chile,152,36,49,85,"(0.814836,-77.662532)"
2017,Junio,Guyana,328,0,2,2,"(3.541112,-76.384584)"
2012,Febrero,Japón,392,0,1,1,"(7.927209,-72.507910)"
2023,Febrero,Reino Unido de Gran Bretaña e Irlanda del Norte,826,0,1,1,"(7.088729,-70.740253)"
2013,Marzo,Países Bajos,528,107,146,253,"(6.171601,-75.427454)"
2018,Marzo,Perú,604,643,474,1117,"(10.445761,-75.516429)"
2017,Noviembre,Kirguistán,417,1,1,2,"(4.697144,-74.140516)"
2022,Marzo,República de Corea,410,0,1,1,"(9.402978,-75.681599)"
2014,Octubre,Líbano,422,0,1,1,"(8.635765,-77.346578)"
2015,Julio,Turquía,792,27,118,145,"(4.697144,-74.140516)"
2015,Febrero,Letonia,428,0,1,1,"(3.541112,-76.384584)"
2015,Octubre,Brasil,76,0,1,1,"(1.813928,-78.763924)"
2018,Agosto,Cuba,192,0,4,4,"(0.814836,-77.662532)"
2017,Enero,Perú,604,2958,3509,6467,"(4.697144,-74.140516)"
2018,Mayo,Estados Unidos de América,840,0,1,1,"(6.185799,-67.483929)"
2014,Septiembre,Portugal,620,0,3,3,"(10.886611,-74.776708)"
2015,Marzo,Chile,152,10,27,37,"(7.818934,-72.453226)"
2021,Febrero,Montenegro,499,0,1,1,"(10.445761,-75.516429)"
2019,Mayo,Argentina,32,2,13,15,"(11.360009,-72.129330)"
2023,Enero,Rwanda,646,0,1,1,"(3.541112,-76.384584)"
2012,Septiembre,Australia,36,18,43,61,"(6.171601,-75.427454)"
2015,Julio,Federación de Rusia,643,5,6,11,"(6.171601,-75.427454)"
2017,Junio,Brasil,76,41,67,108,"(3.541112,-76.384584)"
2019,Noviembre,Bolivia,68,0,1,1,"(7.088729,-70.740253)"
2018,Septiembre,Dinamarca,208,1,2,3,"(10.408582,-75.538003)"
2021,Diciembre,Trinidad y Tobago,780,15,27,42,"(4.697144,-74.140516)"
2014,Octubre,India,356,0,1,1,"(3.893038,-77.067921)"
2021,Junio,Panamá,591,16,26,42,"(4.815061,-75.736532)"
2017,Abril,Argentina,32,0,1,1,"(11.528919,-72.919681)"
2022,Mayo,Líbano,422,1,0,1,"(6.171601,-75.427454)"
2018,Abril,Uganda,800,0,1,1,"(4.697144,-74.140516)"
2018,Abril,Nueva Zelanda,554,0,1,1,"(13.3387613,-81.372937)"
2019,Septiembre,Serbia,688,13,21,34,"(4.697144,-74.140516)"
2018,Febrero,Malasia,458,23,14,37,"(4.697144,-74.140516)"
2015,Septiembre,Cuba,192,0,2,2,"(7.128456,-73.183637)"
2019,Agosto,México,484,2,1,3,"(4.452882,-75.766298)"
2022,Mayo,Suecia,752,9,10,19,"(10.445761,-75.516429)"
2017,Enero,Vietnam,704,0,1,1,"(3.541112,-76.384584)"
2016,Octubre,Estados Unidos de América,840,0,2,2,"(10.971302,-74.765397)"
2014,Marzo,Mónaco,492,1,2,3,"(4.697144,-74.140516)"
2014,Octubre,Alemania,276,0,1,1,"(6.185799,-67.483929)"
2019,Septiembre,República de Irlanda,372,2,8,10,"(0.814836,-77.662532)"
2017,Octubre,Panamá,591,13,15,28,"(7.128456,-73.183637)"
2015,Diciembre,Líbano,422,0,1,1,"(6.171601,-75.427454)"
2018,Agosto,Nueva Zelanda,554,8,11,19,"(10.408582,-75.538003)"
2017,Diciembre,Canadá,124,0,2,2,"(11.360009,-72.129330)"
2020,Marzo,Francia,250,1,0,1,"(12.586067,-81.702563)"
2019,Octubre,Albania,8,0,1,1,"(10.445761,-75.516429)"
2023,Mayo,República Dominicana,214,6,6,12,"(4.815061,-75.736532)"
2022,Junio,Bulgaria,100,18,20,38,"(4.697144,-74.140516)"
2014,Noviembre,Paraguay,600,1,0,1,"(-4.197703,-69.941278)"
2022,Junio,República Dominicana,214,0,1,1,"(7.927209,-72.507910)"
2016,Junio,Francia,250,56,73,129,"(10.445761,-75.516429)"
2019,Julio,Perú,604,1541,1107,2648,"(10.445761,-75.516429)"
2012,Junio,Chile,152,37,68,105,"(6.171601,-75.427454)"
2018,Junio,Sierra Leona,694,0,1,1,"(6.171601,-75.427454)"
2015,Marzo,Guyana,328,1,0,1,"(7.128456,-73.183637)"
2022,Agosto,Suiza,756,0,1,1,"(7.916725,-72.462544)"
2015,Agosto,Panamá,591,5,6,11,"(0.814836,-77.662532)"
2022,Abril,Vietnam,704,2,0,2,"(10.445761,-75.516429)"
2019,Septiembre,Taiwán,158,1,1,2,"(7.818934,-72.453226)"
2022,Mayo,Bélgica,56,0,1,1,"(7.128456,-73.183637)"
2022,Agosto,Ecuador,218,4,4,8,"(8.36068,-72.409396)"
2013,Noviembre,El Salvador,222,1,3,4,"(10.886611,-74.776708)"
2017,Marzo,Dominica,212,0,2,2,"(3.541112,-76.384584)"
2022,Noviembre,Argentina,32,5,9,14,"(7.128456,-73.183637)"
2019,Octubre,Omán,512,0,6,6,"(4.697144,-74.140516)"
2022,Abril,Ucrania,804,2,6,8,"(10.408582,-75.538003)"
2018,Marzo,Indonesia,360,0,1,1,"(0.814836,-77.662532)"
2015,Septiembre,Australia,36,19,20,39,"(0.814836,-77.662532)"
2019,Febrero,Italia,380,5,9,14,"(12.586067,-81.702563)"
2015,Mayo,Kazajistán,398,1,1,2,"(10.445761,-75.516429)"
2022,Diciembre,Uruguay,858,37,22,59,"(12.586067,-81.702563)"
2020,Febrero,Cuba,192,249,396,646,"(4.697144,-74.140516)"
2022,Septiembre,Cuba,192,0,1,1,"(7.128456,-73.183637)"
2013,Mayo,República Checa,203,0,1,1,"(11.360009,-72.129330)"
2022,Enero,Chile,152,82,75,157,"(10.445761,-75.516429)"
2015,Marzo,Bolivia,68,0,1,1,"(7.927209,-72.507910)"
2012,Enero,República Democrática del Congo,180,0,2,2,"(4.697144,-74.140516)"
2016,Septiembre,Reino Unido de Gran Bretaña e Irlanda del Norte,826,8,10,18,"(-4.197703,-69.941278)"
2013,Noviembre,Estados Unidos de América,840,9,19,28,"(11.360009,-72.129330)"
2015,Junio,Honduras,340,2,1,3,"(7.818934,-72.453226)"
2012,Marzo,Eslovaquia,703,0,1,1,"(1.813928,-78.763924)"
2022,Diciembre,Nueva Zelanda,554,1,2,3,"(7.128456,-73.183637)"
2020,Febrero,Guatemala,320,21,39,60,"(3.541112,-76.384584)"
2012,Octubre,Nueva Zelanda,554,4,4,8,"(10.445761,-75.516429)"
2018,Mayo,Estados Unidos de América,840,19,21,40,"(-4.223468,-69.945098)"
2017,Mayo,Italia,380,1,2,3,"(13.3387613,-81.372937)"
2012,Abril,Jamaica,388,0,1,1,"(7.818934,-72.453226)"
2016,Noviembre,Federación de Rusia,643,9,15,24,"(10.445761,-75.516429)"
2014,Noviembre,Luxemburgo,442,0,2,2,"(10.445761,-75.516429)"
2014,Marzo,Suiza,756,5,9,14,"(10.408582,-75.538003)"
2014,Febrero,Malta,470,2,10,12,"(4.697144,-74.140516)"
2014,Mayo,Trinidad y Tobago,780,2,5,7,"(10.445761,-75.516429)"
2017,Septiembre,Argentina,32,5,10,15,"(11.360009,-72.129330)"
2013,Junio,Croacia,191,0,9,9,"(3.541112,-76.384584)"
2015,Noviembre,Suiza,756,2,6,8,"(8.635765,-77.346578)"
2018,Junio,Uruguay,858,9,12,21,"(0.814836,-77.662532)"
2021,Agosto,Etiopia,231,1,28,29,"(4.697144,-74.140516)"
2018,Mayo,Bulgaria,100,1,2,3,"(0.814836,-77.662532)"
2019,Marzo,China,156,7,12,19,"(10.886611,-74.776708)"
2022,Enero,Costa Rica,188,0,8,8,"(1.813928,-78.763924)"
2019,Junio,Croacia,191,0,1,1,"(10.408582,-75.538003)"
2023,Marzo,Bolivia,68,0,1,1,"(0.25129,-76.875963)"
2016,Octubre,República de Irlanda,372,5,8,13,"(10.408582,-75.538003)"
2013,Diciembre,Portugal,620,0,3,3,"(7.818934,-72.453226)"
2018,Mayo,Paraguay,600,190,145,335,"(4.697144,-74.140516)"
2019,Octubre,Uruguay,858,158,115,273,"(10.445761,-75.516429)"
2021,Agosto,República de Irlanda,372,14,47,61,"(4.697144,-74.140516)"
2017,Agosto,Brasil,76,2,0,2,"(7.088729,-70.740253)"
2018,Marzo,Estados Unidos de América,840,1,7,8,"(0.25129,-76.875963)"
2014,Enero,República de Moldavia,498,3,3,6,"(4.697144,-74.140516)"
2015,Abril,Costa Rica,188,8,14,22,"(12.586067,-81.702563)"
2019,Agosto,China,156,1,2,3,"(10.408582,-75.538003)"
2016,Abril,Cuba,192,9,23,32,"(10.445761,-75.516429)"
2012,Octubre,Australia,36,14,22,36,"(10.445761,-75.516429)"
2016,Enero,Alemania,276,0,2,2,"(11.360009,-72.129330)"
2013,Febrero,República Dominicana,214,0,1,1,"(12.586067,-81.702563)"
2023,Febrero,República Dominicana,214,0,1,1,"(0.25129,-76.875963)"
2013,Diciembre,República de Irlanda,372,1,4,5,"(3.541112,-76.384584)"
2023,Mayo,Portugal,620,0,1,1,"(6.18189,-67.47535)"
2020,Marzo,Alemania,276,15,6,21,"(-4.223468,-69.945098)"
2019,Junio,Portugal,620,3,13,16,"(10.886611,-74.776708)"
2021,Agosto,Luxemburgo,442,8,31,39,"(4.697144,-74.140516)"
2015,Octubre,Estados Unidos de América,840,3,5,8,"(7.818934,-72.453226)"
2022,Junio,Nicaragua,558,2,0,2,"(7.927209,-72.507910)"
2014,Diciembre,Surinam,740,1,2,3,"(6.171601,-75.427454)"
2013,Enero,Australia,36,5,8,13,"(-4.197703,-69.941278)"
2015,Noviembre,Argentina,32,1,7,8,"(-4.197703,-69.941278)"
2019,Febrero,Italia,380,1,1,2,"(7.927209,-72.507910)"
2017,Noviembre,Venezuela,862,6,17,23,"(11.528919,-72.919681)"
2015,Septiembre,México,484,0,4,4,"(10.971302,-74.765397)"
2019,Diciembre,Ucrania,804,1,6,7,"(10.408582,-75.538003)"
2022,Septiembre,Costa Rica,188,1,1,2,"(0.25129,-76.875963)"
2017,Junio,Cuba,192,14,22,36,"(10.445761,-75.516429)"
2022,Mayo,Azerbaiyán,31,2,20,22,"(4.697144,-74.140516)"
2022,Abril,Alemania,276,1,0,1,"(0.25129,-76.875963)"
2013,Febrero,Austria,40,3,6,9,"(3.541112,-76.384584)"
2019,Enero,Brasil,76,11,35,46,"(10.886611,-74.776708)"
2021,Junio,Paraguay,600,2,3,5,"(3.541112,-76.384584)"
2023,Enero,Suiza,756,22,37,59,"(3.541112,-76.384584)"
2022,Septiembre,Italia,380,24,52,76,"(3.541112,-76.384584)"
2016,Octubre,Ucrania,804,0,5,5,"(10.886611,-74.776708)"
2013,Octubre,Países Bajos,528,0,5,5,"(4.815061,-75.736532)"
2013,Abril,Noruega,578,1,1,2,"(-4.197703,-69.941278)"
2019,Diciembre,Angola,24,1,1,2,"(4.697144,-74.140516)"
2018,Noviembre,Francia,250,4,3,7,"(7.818934,-72.453226)"
2023,Junio,Etiopia,231,0,2,2,"(10.408582,-75.538003)"
2018,Enero,Argentina,32,0,1,1,"(1.813928,-78.763924)"
2022,Diciembre,Bermudas/Territorio Británico de Ultramar,60,2,2,4,"(10.445761,-75.516429)"
2012,Enero,Isla de Man,833,12,13,25,"(3.541112,-76.384584)"
2022,Mayo,Brasil,76,3046,4080,7126,"(4.697144,-74.140516)"
2015,Mayo,Venezuela,862,0,9,9,"(11.247723,-74.213989)"
2018,Abril,India,356,2,6,8,"(3.541112,-76.384584)"
2015,Enero,España,724,0,3,3,"(11.247723,-74.213989)"
2014,Octubre,Venezuela,862,57,138,195,"(10.886611,-74.776708)"
2012,Mayo,España,724,7,6,13,"(12.586067,-81.702563)"
2016,Septiembre,Brasil,76,0,1,1,"(7.088729,-70.740253)"
2023,Febrero,Bosnia y Herzegovina,70,3,5,8,"(4.697144,-74.140516)"
2016,Julio,Ecuador,218,231,212,443,"(10.445761,-75.516429)"
2019,Septiembre,Guatemala,320,12,19,31,"(10.886611,-74.776708)"
2015,Noviembre,Portugal,620,2,1,3,"(12.586067,-81.702563)"
2014,Enero,Haití,332,13,16,29,"(4.697144,-74.140516)"
2019,Junio,Kuwait,414,0,1,1,"(10.886611,-74.776708)"
2017,Mayo,República Árabe Siria,760,0,1,1,"(0.814836,-77.662532)"
2020,Enero,Ecuador,218,1,3,4,"(-4.223468,-69.945098)"
2017,Noviembre,Nicaragua,558,3,3,6,"(4.815061,-75.736532)"
2023,Abril,Nueva Zelanda,554,0,1,1,"(4.815061,-75.736532)"
2021,Julio,Guatemala,320,1,0,1,"(6.185799,-67.483929)"
2022,Octubre,Chile,152,3,7,10,"(4.452882,-75.766298)"
2015,Junio,Finlandia,246,1,3,4,"(3.541112,-76.384584)"
2015,Mayo,Alemania,276,0,2,2,"(7.128456,-73.183637)"
2012,Octubre,Italia,380,0,1,1,"(-4.197703,-69.941278)"
2012,Noviembre,Cuba,192,12,20,32,"(6.171601,-75.427454)"
2012,Julio,Chipre,196,3,0,3,"(4.697144,-74.140516)"
2013,Febrero,Canadá,124,354,321,675,"(12.586067,-81.702563)"
2022,Noviembre,Nueva Zelanda,554,1,4,5,"(3.541112,-76.384584)"
2017,Febrero,Estados Unidos de América,840,35,57,92,"(10.408582,-75.538003)"
2014,Abril,Brasil,76,1,1,2,"(7.128456,-73.183637)"
2012,Septiembre,República Dominicana,214,200,398,598,"(4.697144,-74.140516)"
2015,Diciembre,Suiza,756,3,4,7,"(7.818934,-72.453226)"
2019,Junio,Guinea Ecuatorial,226,1,0,1,"(6.171601,-75.427454)"
2018,Junio,República Democrática del Congo,180,5,3,8,"(4.697144,-74.140516)"
2023,Febrero,Portugal,620,0,3,3,"(8.635765,-77.346578)"
2017,Septiembre,Polonia,616,147,177,324,"(4.697144,-74.140516)"
2018,Octubre,Australia,36,13,26,39,"(0.814836,-77.662532)"
2017,Octubre,Grecia,300,33,76,109,"(4.697144,-74.140516)"
2018,Febrero,Ecuador,218,166,253,419,"(7.818934,-72.453226)"
2017,Julio,Bahamas,44,6,6,12,"(6.171601,-75.427454)"
2020,Noviembre,República Checa,203,1,0,1,"(3.541112,-76.384584)"
2016,Febrero,Austria,40,4,2,6,"(10.886611,-74.776708)"
2014,Mayo,Canadá,124,33,73,106,"(10.445761,-75.516429)"
2016,Junio,Ecuador,218,3,5,8,"(7.927209,-72.507910)"
2017,Junio,Nigeria,566,0,4,4,"(10.445761,-75.516429)"
2016,Julio,República de Corea,410,3,6,9,"(3.541112,-76.384584)"
2015,Enero,Uruguay,858,0,1,1,"(0.25129,-76.875963)"
2022,Diciembre,Taiwán,158,0,2,2,"(10.886611,-74.776708)"
2014,Octubre,República Checa,203,0,1,1,"(3.541112,-76.384584)"
2014,Febrero,Reino Unido de Gran Bretaña e Irlanda del Norte,826,0,2,2,"(4.815061,-75.736532)"
2017,Mayo,Nueva Zelanda,554,2,4,6,"(3.541112,-76.384584)"
2015,Noviembre,Países Bajos,528,3,8,11,"(8.635765,-77.346578)"
2021,Octubre,Italia,380,0,1,1,"(-4.197703,-69.941278)"
2019,Junio,República de Irlanda,372,2,7,9,"(3.541112,-76.384584)"
2012,Junio,Reino Unido de Gran Bretaña e Irlanda del Norte,826,0,1,1,"(12.586067,-81.702563)"
2021,Enero,Rumania,642,0,2,2,"(10.971302,-74.765397)"
2020,Diciembre,Estados Unidos de América,840,1,5,6,"(10.408582,-75.538003)"
2019,Octubre,Francia,250,77,113,190,"(3.541112,-76.384584)"
2022,Septiembre,Turquía,792,1,5,6,"(11.360009,-72.129330)"
2016,Septiembre,Grecia,300,0,1,1,"(3.893038,-77.067921)"
2015,Enero,Islandia,352,1,1,2,"(3.541112,-76.384584)"
2022,Octubre,Ucrania,804,2,44,46,"(3.893038,-77.067921)"
2013,Diciembre,Desconocido,99999,0,2,2,"(0.814836,-77.662532)"
2017,Enero,Argentina,32,572,408,980,"(12.586067,-81.702563)"
2019,Septiembre,Honduras,340,7,9,16,"(10.886611,-74.776708)"
2023,Enero,Italia,380,1,1,2,"(6.18189,-67.47535)"
2017,Octubre,Austria,40,1,0,1,"(7.818934,-72.453226)"
2023,Enero,Perú,604,34,42,76,"(0.25129,-76.875963)"
2018,Agosto,Panamá,591,2,2,4,"(7.818934,-72.453226)"
2022,Junio,República de Irlanda,372,1,4,5,"(3.541112,-76.384584)"
2014,Abril,Venezuela,862,15,33,48,"(6.185799,-67.483929)"
2023,Mayo,Canadá,124,2,3,5,"(4.452882,-75.766298)"
2016,Marzo,Cuba,192,112,217,329,"(4.697144,-74.140516)"
2015,Julio,Venezuela,862,16,16,32,"(4.815061,-75.736532)"
2019,Enero,Turquía,792,0,2,2,"(7.818934,-72.453226)"
2013,Abril,Luxemburgo,442,3,13,16,"(4.697144,-74.140516)"
2016,Diciembre,España,724,583,867,1450,"(3.541112,-76.384584)"
2023,Junio,Ecuador,218,3,7,10,"(7.088729,-70.740253)"
2017,Noviembre,Bolivia,68,0,1,1,"(0.25129,-76.875963)"
2016,Febrero,Ecuador,218,2848,3635,6483,"(4.697144,-74.140516)"
2017,Septiembre,Filipinas,608,1,13,14,"(3.541112,-76.384584)"
2019,Noviembre,Argentina,32,2,0,2,"(4.452882,-75.766298)"
2020,Febrero,Guyana,328,1,3,4,"(6.171601,-75.427454)"
2012,Abril,México,484,4,14,18,"(10.408582,-75.538003)"
2018,Diciembre,China,156,6,10,16,"(10.408582,-75.538003)"
2022,Diciembre,Costa de Marfil,384,0,1,1,"(6.171601,-75.427454)"
2021,Febrero,República Dominicana,214,111,164,275,"(6.171601,-75.427454)"
2017,Agosto,Nicaragua,558,1,3,4,"(4.815061,-75.736532)"
2013,Septiembre,Egipto,818,0,3,3,"(10.445761,-75.516429)"
2022,Diciembre,Hungría,348,13,9,22,"(6.171601,-75.427454)"
2019,Agosto,Belice,84,1,0,1,"(12.586067,-81.702563)"
2019,Septiembre,Letonia,428,1,6,7,"(10.445761,-75.516429)"
2017,Marzo,Honduras,340,0,1,1,"(8.635765,-77.346578)"
2013,Enero,Chile,152,2,2,4,"(-4.197703,-69.941278)"
2013,Diciembre,Italia,380,544,1674,2218,"(4.697144,-74.140516)"
2012,Noviembre,Argelia,12,0,3,3,"(4.697144,-74.140516)"
2013,Enero,Nueva Zelanda,554,6,5,11,"(10.445761,-75.516429)"
2016,Junio,Filipinas,608,0,1,1,"(4.452882,-75.766298)"
2023,Marzo,Grecia,300,2,1,3,"(3.541112,-76.384584)"
2020,Enero,Suiza,756,5,5,10,"(7.818934,-72.453226)"
2019,Diciembre,Suecia,752,32,37,69,"(3.541112,-76.384584)"
2017,Abril,Haití,332,0,2,2,"(10.445761,-75.516429)"
2022,Marzo,Indonesia,360,1,4,5,"(10.445761,-75.516429)"
2020,Marzo,Taiwán,158,0,1,1,"(10.886611,-74.776708)"
2022,Enero,Myanmar,104,0,1,1,"(10.445761,-75.516429)"
2017,Marzo,República Democrática de Timor Oriental,626,0,2,2,"(4.697144,-74.140516)"
2019,Abril,Argelia,12,0,1,1,"(6.171601,-75.427454)"
2019,Enero,Suiza,756,4,5,9,"(4.815061,-75.736532)"
2018,Marzo,Santa Lucia,662,0,2,2,"(3.541112,-76.384584)"
2023,Febrero,Israel,376,0,1,1,"(8.36068,-72.409396)"
2014,Abril,Federación de Rusia,643,0,1,1,"(10.408582,-75.538003)"
2019,Agosto,Suecia,752,2,7,9,"(0.814836,-77.662532)"
2012,Noviembre,Uruguay,858,19,42,61,"(6.171601,-75.427454)"
2017,Agosto,Bolivia,68,0,2,2,"(0.25129,-76.875963)"
2023,Enero,Italia,380,8,13,21,"(4.815061,-75.736532)"
2015,Noviembre,Surinam,740,1,2,3,"(10.886611,-74.776708)"
2015,Junio,Australia,36,20,39,59,"(10.445761,-75.516429)"
2018,Agosto,Francia,250,2931,3908,6839,"(4.697144,-74.140516)"
2018,Enero,Brasil,76,103,119,222,"(3.541112,-76.384584)"
2021,Marzo,Bahamas,44,2,5,7,"(4.697144,-74.140516)"
2016,Febrero,Costa Rica,188,0,1,1,"(7.927209,-72.507910)"
2021,Julio,España,724,11,13,24,"(11.360009,-72.129330)"
2018,Junio,Turquía,792,2,3,5,"(0.814836,-77.662532)"
2012,Abril,Madagascar,450,1,0,1,"(10.445761,-75.516429)"
2019,Febrero,Bulgaria,100,4,14,18,"(6.171601,-75.427454)"
2014,Junio,Francia,250,14,15,29,"(-4.197703,-69.941278)"
2016,Diciembre,Turquía,792,0,1,1,"(9.402978,-75.681599)"
2020,Diciembre,Rumania,642,0,1,1,"(10.971302,-74.765397)"
2023,Mayo,Letonia,428,6,6,12,"(6.171601,-75.427454)"
2018,Agosto,India,356,0,1,1,"(-4.197703,-69.941278)"
2018,Marzo,Belice,84,1,0,1,"(3.541112,-76.384584)"
2019,Marzo,Bolivia,68,11,67,78,"(0.814836,-77.662532)"
2018,Septiembre,Madagascar,450,1,0,1,"(6.171601,-75.427454)"
2021,Diciembre,Micronesia,583,0,1,1,"(3.541112,-76.384584)"
2017,Noviembre,Canadá,124,62,69,131,"(3.541112,-76.384584)"
2016,Octubre,Guyana,328,0,1,1,"(7.818934,-72.453226)"
2022,Noviembre,Estados Unidos de América,840,1939,2739,4679,"(3.541112,-76.384584)"
2012,Noviembre,Belice,84,0,2,2,"(6.171601,-75.427454)"
2020,Enero,Hong Kong,344,1,2,3,"(6.171601,-75.427454)"
2012,Febrero,México,484,81,209,290,"(6.171601,-75.427454)"
2013,Noviembre,Eslovaquia,703,1,0,1,"(-4.197703,-69.941278)"
2023,Febrero,Kuwait,414,0,2,2,"(10.445761,-75.516429)"
2018,Febrero,Albania,8,0,2,2,"(6.171601,-75.427454)"
2018,Octubre,Egipto,818,0,1,1,"(10.886611,-74.776708)"
2021,Junio,Polonia,616,39,61,100,"(4.697144,-74.140516)"
2017,Julio,Emiratos Árabes,784,0,2,2,"(6.171601,-75.427454)"
2022,Agosto,Singapur,702,1,5,6,"(10.445761,-75.516429)"
2012,Diciembre,Países Bajos,528,0,1,1,"(7.927209,-72.507910)"
2013,Febrero,Honduras,340,0,2,2,"(7.818934,-72.453226)"
2014,Septiembre,Kuwait,414,1,0,1,"(4.697144,-74.140516)"
2022,Noviembre,Malasia,458,0,1,1,"(6.171601,-75.427454)"
2023,Febrero,Nicaragua,558,3,0,3,"(8.364293,-72.405710)"
2016,Septiembre,Canadá,124,2,1,3,"(4.452882,-75.766298)"
2022,Agosto,Montenegro,499,3,4,7,"(4.697144,-74.140516)"
2015,Abril,República de Corea,410,0,3,3,"(4.815061,-75.736532)"
2018,Septiembre,Austria,40,3,8,11,"(3.541112,-76.384584)"
2017,Mayo,Costa Rica,188,234,170,404,"(12.586067,-81.702563)"
2017,Agosto,Indonesia,360,0,9,9,"(10.445761,-75.516429)"
2016,Octubre,Argentina,32,0,1,1,"(8.36068,-72.409396)"
2016,Junio,Panamá,591,11,26,37,"(7.128456,-73.183637)"
2019,Noviembre,Países Bajos,528,2,2,4,"(7.128456,-73.183637)"
2019,Septiembre,Alemania,276,3,9,12,"(-4.223468,-69.945098)"
2018,Noviembre,República de Irlanda,372,10,29,39,"(10.445761,-75.516429)"
2012,Noviembre,Costa Rica,188,1,0,1,"(11.360009,-72.129330)"
2023,Marzo,Andorra,20,1,7,8,"(4.697144,-74.140516)"
2016,Noviembre,Islas Caimán/Territorio Británico de Ultramar,136,2,2,4,"(4.697144,-74.140516)"
2018,Mayo,Zimbabue,716,1,2,3,"(4.697144,-74.140516)"
2015,Mayo,Portugal,620,1,5,6,"(11.360009,-72.129330)"
2017,Julio,Austria,40,2,1,3,"(4.815061,-75.736532)"
2013,Julio,Reino Unido de Gran Bretaña e Irlanda del Norte,826,2,1,3,"(12.586067,-81.702563)"
2019,Noviembre,Austria,40,1,6,7,"(10.408582,-75.538003)"
2019,Agosto,Francia,250,2,3,5,"(7.128456,-73.183637)"
2017,Diciembre,Grecia,300,0,1,1,"(0.814836,-77.662532)"
2014,Marzo,Nueva Zelanda,554,1,0,1,"(4.815061,-75.736532)"
2022,Agosto,San  Vicente y las Granadinas,670,1,2,3,"(4.697144,-74.140516)"
2017,Marzo,China,156,10,22,32,"(3.541112,-76.384584)"
2014,Julio,Chile,152,1,1,2,"(4.815061,-75.736532)"
2015,Enero,Hungría,348,1,1,2,"(11.360009,-72.129330)"
2022,Septiembre,Federación de Rusia,643,31,20,51,"(6.171601,-75.427454)"
2012,Junio,Uruguay,858,0,2,2,"(4.452882,-75.766298)"
2019,Agosto,Estados Unidos de América,840,16,7,23,"(11.360009,-72.129330)"
2017,Noviembre,Jamaica,388,26,30,56,"(4.697144,-74.140516)"
2014,Julio,Qatar,634,0,1,1,"(6.171601,-75.427454)"
2012,Enero,Taiwán,158,29,28,57,"(4.697144,-74.140516)"
2016,Mayo,México,484,3,4,7,"(7.927209,-72.507910)"
2016,Junio,Georgia,268,1,6,7,"(4.697144,-74.140516)"
2012,Junio,Federación de Rusia,643,32,48,80,"(4.697144,-74.140516)"
2013,Enero,Guatemala,320,1,1,2,"(8.635765,-77.346578)"
2017,Enero,Uruguay,858,60,66,126,"(6.171601,-75.427454)"
2021,Enero,Venezuela,862,0,4,4,"(6.228046,-77.404104)"
2021,Septiembre,Costa Rica,188,698,767,1466,"(4.697144,-74.140516)"
2017,Noviembre,Guyana,328,0,2,2,"(3.541112,-76.384584)"
2016,Julio,Islas Caimán/Territorio Británico de Ultramar,136,2,2,4,"(12.586067,-81.702563)"
2013,Junio,Luxemburgo,442,1,6,7,"(4.697144,-74.140516)"
2014,Abril,República de Belarús,112,1,2,3,"(4.697144,-74.140516)"
2012,Diciembre,Grecia,300,0,3,3,"(6.171601,-75.427454)"
2012,Julio,Grecia,300,0,1,1,"(7.818934,-72.453226)"
2023,Marzo,Bulgaria,100,0,1,1,"(8.635765,-77.346578)"
2018,Mayo,México,484,0,3,3,"(11.117806,-74.232622)"
2023,Febrero,Argentina,32,9,10,19,"(7.916725,-72.462544)"
2014,Agosto,Italia,380,6,14,20,"(10.886611,-74.776708)"
2015,Julio,Ecuador,218,0,17,17,"(10.408582,-75.538003)"
2021,Diciembre,Países Bajos,528,1,1,2,"(0.814836,-77.662532)"
2016,Diciembre,Haití,332,1,2,3,"(10.445761,-75.516429)"
2019,Abril,Trinidad y Tobago,780,0,3,3,"(3.541112,-76.384584)"
2014,Septiembre,Andorra,20,0,2,2,"(10.408582,-75.538003)"
2019,Septiembre,Países Bajos,528,0,2,2,"(8.066966,-76.735404)"
2014,Octubre,República Checa,203,0,1,1,"(6.171601,-75.427454)"
2021,Octubre,México,484,3,5,8,"(4.452882,-75.766298)"
2018,Abril,Finlandia,246,1,1,2,"(0.25129,-76.875963)"
2014,Agosto,México,484,3056,5769,8825,"(4.697144,-74.140516)"
2016,Julio,Desconocido,99999,0,4,4,"(10.445761,-75.516429)"
2014,Junio,Reino Unido de Gran Bretaña e Irlanda del Norte,826,1,1,2,"(4.452882,-75.766298)"
2019,Diciembre,Letonia,428,23,15,38,"(4.697144,-74.140516)"
2019,Enero,República Checa,203,0,1,1,"(7.818934,-72.453226)"
2021,Octubre,Luxemburgo,442,1,1,2,"(10.445761,-75.516429)"
2012,Abril,Turquía,792,0,3,3,"(6.171601,-75.427454)"
2015,Noviembre,República de Irlanda,372,0,1,1,"(7.927209,-72.507910)"
2022,Mayo,Bulgaria,100,0,1,1,"(3.893038,-77.067921)"
2021,Septiembre,República Checa,203,4,2,6,"(6.171601,-75.427454)"
2017,Enero,Francia,250,90,162,252,"(3.541112,-76.384584)"
2023,Enero,Ecuador,218,3,7,10,"(7.088729,-70.740253)"
2022,Febrero,Etiopia,231,0,1,1,"(10.445761,-75.516429)"
2012,Diciembre,Bélgica,56,2,1,3,"(8.635765,-77.346578)"
2023,Febrero,Brasil,76,1,0,1,"(7.088729,-70.740253)"
2015,Marzo,Sudán,736,0,1,1,"(4.697144,-74.140516)"
2016,Marzo,Bélgica,56,8,10,18,"(10.445761,-75.516429)"
2023,Marzo,Hungría,348,1,1,2,"(4.815061,-75.736532)"
2018,Septiembre,Surinam,740,16,24,40,"(4.697144,-74.140516)"
2021,Mayo,Ecuador,218,0,4,4,"(10.408582,-75.538003)"
2016,Septiembre,Taiwán,158,2,2,4,"(10.408582,-75.538003)"
2016,Mayo,Portugal,620,1,2,3,"(7.818934,-72.453226)"
2014,Septiembre,República Dominicana,214,1,3,4,"(7.128456,-73.183637)"
2022,Junio,Liberia,430,2,0,2,"(10.445761,-75.516429)"
2015,Septiembre,Lituania,440,5,1,6,"(6.171601,-75.427454)"
2018,Mayo,Italia,380,3,5,8,"(10.408582,-75.538003)"
2015,Agosto,Honduras,340,18,35,53,"(3.541112,-76.384584)"
2022,Julio,Ecuador,218,1,0,1,"(-4.197703,-69.941278)"
2012,Febrero,Países Bajos,528,143,227,370,"(4.697144,-74.140516)"
2014,Abril,Filipinas,608,0,1,1,"(1.813928,-78.763924)"
2013,Julio,Lituania,440,0,1,1,"(11.360009,-72.129330)"
2012,Marzo,Nicaragua,558,9,10,19,"(6.171601,-75.427454)"
2021,Mayo,Dinamarca,208,1,4,5,"(6.171601,-75.427454)"
2018,Agosto,Indonesia,360,0,1,1,"(10.408582,-75.538003)"
2017,Marzo,Singapur,702,18,45,63,"(4.697144,-74.140516)"
2017,Diciembre,Perú,604,6,8,14,"(0.25129,-76.875963)"
2017,Febrero,Japón,392,201,515,716,"(4.697144,-74.140516)"
2017,Mayo,Dominica,212,2,1,3,"(4.697144,-74.140516)"
2016,Agosto,Uruguay,858,71,80,151,"(10.445761,-75.516429)"
2017,Agosto,Chile,152,5,13,18,"(10.886611,-74.776708)"
2018,Abril,Australia,36,7,22,29,"(10.886611,-74.776708)"
2017,Octubre,Venezuela,862,14,28,42,"(10.408582,-75.538003)"
2019,Diciembre,República de Moldavia,498,5,4,9,"(4.697144,-74.140516)"
2015,Marzo,Panamá,591,3,3,6,"(0.814836,-77.662532)"
2023,Abril,Rumania,642,12,18,30,"(10.445761,-75.516429)"
2017,Septiembre,Francia,250,1,0,1,"(12.586067,-81.702563)"
2013,Junio,Singapur,702,5,0,5,"(6.171601,-75.427454)"
2015,Diciembre,Guyana,328,3,9,12,"(4.697144,-74.140516)"
2019,Marzo,Finlandia,246,0,1,1,"(-4.223468,-69.945098)"
2021,Septiembre,Ucrania,804,0,1,1,"(9.402978,-75.681599)"
2017,Diciembre,Países Bajos,528,2,3,5,"(0.25129,-76.875963)"
2023,Febrero,Rwanda,646,0,3,3,"(4.697144,-74.140516)"
2018,Abril,Francia,250,53,96,149,"(3.541112,-76.384584)"
2016,Febrero,Ucrania,804,0,1,1,"(4.452882,-75.766298)"
2019,Mayo,Costa de Marfil,384,2,1,3,"(4.697144,-74.140516)"
2013,Julio,Grecia,300,0,9,9,"(3.541112,-76.384584)"
2014,Julio,Serbia,688,7,7,14,"(4.697144,-74.140516)"
2020,Febrero,Alemania,276,0,3,3,"(7.128456,-73.183637)"
2019,Noviembre,Lituania,440,0,1,1,"(9.402978,-75.681599)"
2019,Febrero,Eslovaquia,703,1,1,2,"(10.886611,-74.776708)"
2023,Febrero,El Salvador,222,0,1,1,"(0.25129,-76.875963)"
2013,Marzo,Países Bajos,528,3,5,8,"(-4.197703,-69.941278)"
2019,Enero,Ucrania,804,1,10,11,"(10.408582,-75.538003)"
2019,Mayo,Brasil,76,2,1,3,"(7.818934,-72.453226)"
2020,Octubre,Perú,604,0,8,8,"(-4.197703,-69.941278)"
2019,Mayo,Suiza,756,41,84,125,"(6.171601,-75.427454)"
2013,Octubre,Grecia,300,0,6,6,"(10.445761,-75.516429)"
2016,Mayo,Filipinas,608,0,11,11,"(3.893038,-77.067921)"
2012,Septiembre,Mozambique,508,0,2,2,"(4.697144,-74.140516)"
2014,Mayo,Perú,604,7,33,40,"(10.886611,-74.776708)"
2012,Abril,España,724,4,6,10,"(7.927209,-72.507910)"
2019,Marzo,Taiwán,158,1,1,2,"(10.886611,-74.776708)"
2014,Mayo,Rumania,642,0,2,2,"(10.408582,-75.538003)"
2013,Mayo,Cuba,192,0,2,2,"(4.452882,-75.766298)"
2013,Julio,Estados Unidos de América,840,4,4,8,"(11.247723,-74.213989)"
2021,Julio,Costa Rica,188,3,13,16,"(4.815061,-75.736532)"
2022,Diciembre,Panamá,591,0,1,1,"(10.971302,-74.765397)"
2020,Marzo,Nueva Zelanda,554,1,0,1,"(11.247723,-74.213989)"
2015,Julio,Dinamarca,208,3,1,4,"(8.635765,-77.346578)"
2014,Octubre,Estados Unidos de América,840,1,3,4,"(13.3387613,-81.372937)"
2021,Mayo,Venezuela,862,0,1,1,"(7.088729,-70.740253)"
2013,Enero,Perú,604,1,7,8,"(10.408582,-75.538003)"
2022,Octubre,Bulgaria,100,5,10,15,"(6.171601,-75.427454)"
2015,Diciembre,Bulgaria,100,18,17,35,"(4.697144,-74.140516)"
2014,Junio,Estados Unidos de América,840,30,51,81,"(7.927209,-72.507910)"
2019,Agosto,Palestina,99999,3,2,5,"(4.697144,-74.140516)"
2022,Junio,Italia,380,0,3,3,"(7.128456,-73.183637)"
2022,Diciembre,Suiza,756,0,1,1,"(7.128456,-73.183637)"
2014,Junio,Nicaragua,558,0,1,1,"(8.635765,-77.346578)"
2013,Junio,Italia,380,0,3,3,"(7.128456,-73.183637)"
2023,Febrero,Libia,434,0,1,1,"(4.697144,-74.140516)"
2014,Julio,Nicaragua,558,14,10,24,"(10.445761,-75.516429)"
2014,Julio,Costa Rica,188,0,2,2,"(11.360009,-72.129330)"
2013,Noviembre,Egipto,818,2,7,9,"(4.697144,-74.140516)"
2015,Noviembre,Japón,392,2,11,13,"(10.445761,-75.516429)"
2013,Octubre,Finlandia,246,1,1,2,"(7.818934,-72.453226)"
2012,Junio,Estados Unidos de América,840,0,2,2,"(1.813928,-78.763924)"
2019,Diciembre,Dinamarca,208,0,1,1,"(4.452882,-75.766298)"
2014,Septiembre,Canadá,124,5,24,29,"(10.886611,-74.776708)"
2014,Octubre,Grecia,300,0,1,1,"(7.818934,-72.453226)"
2022,Agosto,Bahamas,44,33,19,52,"(4.697144,-74.140516)"
2023,Mayo,Austria,40,1,2,3,"(8.635765,-77.346578)"
2012,Agosto,Mozambique,508,1,6,7,"(4.697144,-74.140516)"
2019,Septiembre,Myanmar,104,0,1,1,"(9.402978,-75.681599)"
2022,Enero,Suiza,756,1,1,2,"(11.247723,-74.213989)"
2012,Mayo,San  Vicente y las Granadinas,670,1,0,1,"(6.171601,-75.427454)"
2017,Julio,Estonia,233,7,7,14,"(4.697144,-74.140516)"
2015,Abril,Guyana,328,1,3,4,"(6.171601,-75.427454)"
2017,Julio,Venezuela,862,108,141,249,"(10.445761,-75.516429)"
2017,Junio,Guatemala,320,55,121,176,"(6.171601,-75.427454)"
2019,Enero,Costa de Marfil,384,2,1,3,"(4.697144,-74.140516)"
2018,Octubre,Sudán,736,1,0,1,"(4.697144,-74.140516)"
2017,Noviembre,Indonesia,360,20,25,45,"(4.697144,-74.140516)"
2012,Agosto,Alemania,276,1,1,2,"(7.927209,-72.507910)"
2018,Marzo,Italia,380,6,6,12,"(7.088729,-70.740253)"
2013,Septiembre,El Salvador,222,0,2,2,"(10.408582,-75.538003)"
2019,Noviembre,Bolivia,68,2,2,4,"(7.818934,-72.453226)"
2017,Agosto,Nicaragua,558,4,6,10,"(10.886611,-74.776708)"
2022,Noviembre,Costa Rica,188,2,2,4,"(0.814836,-77.662532)"
2023,Mayo,Pakistán,586,2,4,6,"(6.171601,-75.427454)"
2023,Marzo,Croacia,191,0,6,6,"(10.408582,-75.538003)"
2017,Junio,Estados Unidos de América,840,0,19,19,"(11.247723,-74.213989)"
2022,Julio,Honduras,340,20,21,41,"(10.886611,-74.776708)"
2018,Mayo,Venezuela,862,0,2,2,"(11.247723,-74.213989)"
2014,Enero,Estonia,233,2,2,4,"(0.814836,-77.662532)"
2017,Junio,Brasil,76,399,297,696,"(12.586067,-81.702563)"
2021,Abril,Uruguay,858,18,51,69,"(4.697144,-74.140516)"
2018,Noviembre,Argentina,32,344,263,607,"(12.586067,-81.702563)"
2016,Enero,República Checa,203,4,8,12,"(0.814836,-77.662532)"
2019,Febrero,China,156,50,54,104,"(10.445761,-75.516429)"
2016,Junio,China,156,0,4,4,"(10.408582,-75.538003)"
2017,Noviembre,Uruguay,858,0,1,1,"(11.360009,-72.129330)"
2013,Mayo,Aruba,533,4,1,5,"(4.697144,-74.140516)"
2018,Diciembre,Suiza,756,1,1,2,"(-4.223468,-69.945098)"
2018,Septiembre,Líbano,422,1,0,1,"(0.814836,-77.662532)"
2017,Junio,Argentina,32,10,14,24,"(7.818934,-72.453226)"
2016,Mayo,Uruguay,858,0,3,3,"(-4.197703,-69.941278)"
2014,Septiembre,Portugal,620,242,512,754,"(4.697144,-74.140516)"
2019,Diciembre,Italia,380,0,1,1,"(8.066966,-76.735404)"
2014,Febrero,Israel,376,2,42,44,"(6.171601,-75.427454)"
2022,Junio,Indonesia,360,0,1,1,"(3.541112,-76.384584)"
2012,Enero,Uruguay,858,1,1,2,"(8.635765,-77.346578)"
2012,Noviembre,Surinam,740,3,15,18,"(4.697144,-74.140516)"
2012,Agosto,Francia,250,13,20,33,"(7.818934,-72.453226)"
2019,Julio,Argentina,32,0,1,1,"(7.128456,-73.183637)"
2019,Mayo,Australia,36,296,522,818,"(4.697144,-74.140516)"
2017,Agosto,Islas Caimán/Territorio Británico de Ultramar,136,0,2,2,"(10.445761,-75.516429)"
2012,Septiembre,Taiwán,158,1,4,5,"(4.815061,-75.736532)"
2021,Septiembre,Federación de Rusia,643,0,4,4,"(11.247723,-74.213989)"
2018,Marzo,Chipre,196,1,1,2,"(6.171601,-75.427454)"
2012,Octubre,Angola,24,1,1,2,"(4.697144,-74.140516)"
2020,Noviembre,China,156,39,99,138,"(4.697144,-74.140516)"
2014,Marzo,Cuba,192,2,0,2,"(10.408582,-75.538003)"
2022,Septiembre,Ecuador,218,7,10,17,"(7.916725,-72.462544)"
2012,Abril,Venezuela,862,28,45,73,"(6.185799,-67.483929)"
2021,Mayo,India,356,0,1,1,"(3.541112,-76.384584)"
2013,Abril,India,356,0,6,6,"(10.886611,-74.776708)"
2020,Febrero,Trinidad y Tobago,780,1,1,2,"(12.586067,-81.702563)"
2014,Octubre,Australia,36,0,1,1,"(4.452882,-75.766298)"
2014,Octubre,Costa Rica,188,1,2,3,"(10.408582,-75.538003)"
2018,Mayo,Italia,380,4,4,8,"(-4.223468,-69.945098)"
2022,Noviembre,Venezuela,862,1994,1661,3655,"(7.916725,-72.462544)"
2015,Octubre,Venezuela,862,26,50,76,"(6.185799,-67.483929)"
2018,Octubre,Australia,36,32,98,130,"(6.171601,-75.427454)"
2023,Junio,Italia,380,2,11,13,"(11.117806,-74.232622)"
2014,Diciembre,Chile,152,0,5,5,"(-4.197703,-69.941278)"
2017,Diciembre,Suiza,756,0,2,2,"(11.117806,-74.232622)"
2018,Noviembre,Estados Unidos de América,840,32,66,98,"(0.814836,-77.662532)"
2022,Junio,Alemania,276,1,1,2,"(11.117806,-74.232622)"
2019,Abril,Australia,36,0,1,1,"(-4.197703,-69.941278)"
2022,Septiembre,Canadá,124,0,1,1,"(12.5744111,-81.703935)"
2014,Julio,República de Corea,410,1,1,2,"(-4.197703,-69.941278)"
2018,Septiembre,Bahamas,44,0,1,1,"(10.408582,-75.538003)"
2015,Julio,Kuwait,414,0,3,3,"(3.541112,-76.384584)"
2019,Junio,Bulgaria,100,1,2,3,"(0.814836,-77.662532)"
2013,Mayo,Perú,604,221,390,611,"(6.171601,-75.427454)"
2012,Noviembre,Ecuador,218,4,6,10,"(10.886611,-74.776708)"
2019,Julio,Ecuador,218,46,77,123,"(6.171601,-75.427454)"
2016,Enero,Islas Caimán/Territorio Británico de Ultramar,136,1,2,3,"(10.445761,-75.516429)"
2022,Octubre,Rumania,642,0,1,1,"(9.402978,-75.681599)"
2014,Febrero,Perú,604,503,608,1111,"(6.171601,-75.427454)"
2016,Octubre,Brasil,76,855,613,1468,"(10.445761,-75.516429)"
2017,Noviembre,Brasil,76,27,27,54,"(0.814836,-77.662532)"
2015,Abril,España,724,2,0,2,"(0.25129,-76.875963)"
2022,Octubre,Grecia,300,36,77,113,"(4.697144,-74.140516)"
2017,Octubre,Georgia,268,0,1,1,"(10.445761,-75.516429)"
2019,Noviembre,Países Bajos,528,7,1,8,"(8.635765,-77.346578)"
2023,Abril,Malasia,458,10,8,18,"(4.697144,-74.140516)"
2023,Enero,Estados Unidos de América,840,6954,9540,16494,"(10.445761,-75.516429)"
2021,Noviembre,Filipinas,608,0,24,24,"(3.893038,-77.067921)"
2016,Mayo,Letonia,428,2,1,3,"(3.541112,-76.384584)"
2012,Septiembre,Suiza,756,9,16,25,"(0.814836,-77.662532)"
2016,Enero,Lituania,440,27,17,44,"(4.697144,-74.140516)"
2013,Agosto,Alemania,276,1,0,1,"(7.927209,-72.507910)"
2015,Junio,México,484,12,35,47,"(7.818934,-72.453226)"
2012,Marzo,España,724,1,0,1,"(7.088729,-70.740253)"
2018,Septiembre,República Dominicana,214,0,2,2,"(-4.197703,-69.941278)"
2013,Enero,Países Bajos,528,3,4,7,"(10.886611,-74.776708)"
2014,Agosto,Chile,152,1,2,3,"(0.25129,-76.875963)"
2017,Marzo,Guyana,328,1,0,1,"(10.886611,-74.776708)"
2014,Marzo,Turquía,792,1,0,1,"(8.635765,-77.346578)"
2016,Julio,Reino Unido de Gran Bretaña e Irlanda del Norte,826,18,23,41,"(-4.197703,-69.941278)"
2018,Noviembre,Rumania,642,16,20,36,"(10.445761,-75.516429)"
2017,Junio,Portugal,620,0,1,1,"(12.586067,-81.702563)"
2016,Marzo,Francia,250,92,180,272,"(6.171601,-75.427454)"
2015,Febrero,Sri Lanka,144,0,3,3,"(4.697144,-74.140516)"
2015,Mayo,San  Vicente y las Granadinas,670,0,1,1,"(7.927209,-72.507910)"
2015,Julio,República Dominicana,214,1,6,7,"(7.927209,-72.507910)"
2016,Abril,República CentroÁfricana,140,1,1,2,"(4.697144,-74.140516)"
2012,Mayo,Honduras,340,0,7,7,"(13.3387613,-81.372937)"
2019,Enero,Ecuador,218,0,2,2,"(11.117806,-74.232622)"
2021,Enero,Perú,604,3,3,6,"(7.128456,-73.183637)"
2015,Marzo,Australia,36,1,1,2,"(-4.223468,-69.945098)"
2022,Diciembre,Vietnam,704,10,18,28,"(4.697144,-74.140516)"
2012,Enero,Estados Unidos de América,840,13,19,32,"(11.360009,-72.129330)"
2016,Mayo,Croacia,191,1,0,1,"(10.886611,-74.776708)"
2018,Abril,Guyana,328,2,1,3,"(7.818934,-72.453226)"
2020,Marzo,Cuba,192,1,3,4,"(4.815061,-75.736532)"
2021,Diciembre,China,156,4,3,7,"(3.541112,-76.384584)"
2012,Febrero,Luxemburgo,442,0,1,1,"(8.635765,-77.346578)"
2013,Julio,Alemania,276,7,15,22,"(7.818934,-72.453226)"
2015,Febrero,Suiza,756,2,1,3,"(8.635765,-77.346578)"
2015,Agosto,Reino Unido de Gran Bretaña e Irlanda del Norte,826,0,6,6,"(11.247723,-74.213989)"
2019,Julio,Francia,250,367,530,897,"(6.171601,-75.427454)"
2020,Febrero,Chile,152,522,399,921,"(10.408582,-75.538003)"
2023,Febrero,Serbia,688,4,4,8,"(10.445761,-75.516429)"
2023,Enero,Albania,8,1,0,1,"(4.452882,-75.766298)"
2016,Diciembre,Bermudas/Territorio Británico de Ultramar,60,2,1,3,"(4.697144,-74.140516)"
2016,Noviembre,China,156,15,21,36,"(10.445761,-75.516429)"
2016,Octubre,Paraguay,600,165,183,348,"(4.697144,-74.140516)"
2013,Septiembre,Alemania,276,7,13,20,"(-4.197703,-69.941278)"
2014,Mayo,Ecuador,218,160,210,370,"(7.818934,-72.453226)"
2020,Febrero,México,484,3,2,5,"(-4.197703,-69.941278)"
2019,Diciembre,Canadá,124,339,666,1005,"(6.171601,-75.427454)"
2018,Mayo,Perú,604,1,0,1,"(4.452882,-75.766298)"
2012,Abril,Filipinas,608,1,9,10,"(3.541112,-76.384584)"
2020,Febrero,Países Bajos,528,4,9,13,"(7.818934,-72.453226)"
2021,Julio,Grecia,300,4,0,4,"(3.541112,-76.384584)"
2016,Octubre,Ucrania,804,0,1,1,"(8.066966,-76.735404)"
2023,Junio,Ucrania,804,0,58,58,"(3.893038,-77.067921)"
2017,Marzo,Hong Kong,344,0,1,1,"(6.171601,-75.427454)"
2017,Diciembre,Bulgaria,100,38,27,65,"(4.697144,-74.140516)"
2016,Junio,Venezuela,862,0,2,2,"(-0.193180,-74.784874)"
2022,Noviembre,México,484,2493,3560,6053,"(6.171601,-75.427454)"
2023,Marzo,Brasil,76,1,4,5,"(11.360009,-72.129330)"
2014,Diciembre,Países Bajos,528,7,7,14,"(7.128456,-73.183637)"
2018,Agosto,Japón,392,1,7,8,"(10.886611,-74.776708)"
2016,Abril,Eslovenia,705,2,2,4,"(6.171601,-75.427454)"
2019,Julio,Australia,36,14,18,32,"(3.541112,-76.384584)"
2013,Noviembre,Eslovaquia,703,0,1,1,"(3.541112,-76.384584)"
2023,Marzo,Polonia,616,3,2,5,"(4.815061,-75.736532)"
2015,Abril,Palestina,99999,0,2,2,"(4.697144,-74.140516)"
2017,Noviembre,Irán,364,0,2,2,"(6.171601,-75.427454)"
2019,Julio,Filipinas,608,5,15,20,"(3.541112,-76.384584)"
2018,Marzo,España,724,5,4,9,"(-4.223468,-69.945098)"
2012,Noviembre,China,156,169,526,695,"(4.697144,-74.140516)"
2017,Enero,San Cristóbal y Nevis,659,0,1,1,"(12.586067,-81.702563)"
2014,Mayo,Arabia Saudita,682,2,7,9,"(4.697144,-74.140516)"
2013,Diciembre,Panamá,591,44,92,136,"(4.815061,-75.736532)"
2021,Septiembre,República de Belarús,112,1,0,1,"(10.445761,-75.516429)"
2020,Junio,Turquía,792,0,1,1,"(4.697144,-74.140516)"
2021,Julio,Israel,376,0,1,1,"(4.815061,-75.736532)"
2022,Mayo,República de Moldavia,498,0,1,1,"(0.814836,-77.662532)"
2016,Abril,Costa Rica,188,5,5,10,"(0.814836,-77.662532)"
2016,Junio,Austria,40,3,9,12,"(10.445761,-75.516429)"
2020,Agosto,Bolivia,68,0,1,1,"(4.697144,-74.140516)"
2014,Octubre,Emiratos Árabes,784,0,2,2,"(10.886611,-74.776708)"
2015,Octubre,Desconocido,99999,2,3,5,"(10.445761,-75.516429)"
2015,Julio,Chile,152,2,1,3,"(13.3387613,-81.372937)"
2012,Octubre,México,484,18,59,77,"(10.886611,-74.776708)"
2016,Febrero,República Dominicana,214,0,1,1,"(-4.197703,-69.941278)"
2015,Agosto,Nicaragua,558,0,2,2,"(10.408582,-75.538003)"
2021,Marzo,Canadá,124,1,0,1,"(12.5744111,-81.703935)"
2013,Septiembre,Nigeria,566,0,1,1,"(7.818934,-72.453226)"
2023,Abril,Venezuela,862,0,1,1,"(1.813928,-78.763924)"
2018,Septiembre,Desconocido,99999,90,154,244,"(4.697144,-74.140516)"
2017,Octubre,Nueva Zelanda,554,4,4,8,"(8.635765,-77.346578)"
2022,Julio,Federación de Rusia,643,0,5,5,"(11.247723,-74.213989)"
2017,Mayo,Jamaica,388,1,4,5,"(10.445761,-75.516429)"
2015,Octubre,Ucrania,804,0,11,11,"(10.408582,-75.538003)"
2022,Abril,Federación de Rusia,643,0,1,1,"(10.971302,-74.765397)"
2022,Marzo,Ucrania,804,7,7,14,"(10.445761,-75.516429)"
2017,Mayo,Irán,364,7,20,27,"(4.697144,-74.140516)"
2016,Febrero,Bélgica,56,1,3,4,"(-4.197703,-69.941278)"
2014,Septiembre,Nueva Zelanda,554,0,1,1,"(8.635765,-77.346578)"
2016,Noviembre,Ecuador,218,3,12,15,"(10.408582,-75.538003)"
2012,Enero,Grecia,300,0,1,1,"(10.886611,-74.776708)"
2014,Marzo,Belice,84,0,2,2,"(3.541112,-76.384584)"
2016,Agosto,Filipinas,608,0,14,14,"(9.402978,-75.681599)"
2013,Marzo,Panamá,591,23,25,48,"(12.586067,-81.702563)"
2019,Febrero,Chile,152,15,55,70,"(7.927209,-72.507910)"
2022,Diciembre,Portugal,620,1,4,5,"(4.815061,-75.736532)"
2012,Febrero,Malta,470,1,2,3,"(4.697144,-74.140516)"
2021,Octubre,Filipinas,608,0,54,54,"(10.408582,-75.538003)"
2018,Julio,Paraguay,600,2,6,8,"(10.886611,-74.776708)"
2013,Diciembre,República Árabe Siria,760,0,1,1,"(4.697144,-74.140516)"
2016,Octubre,Georgia,268,0,1,1,"(10.408582,-75.538003)"
2020,Septiembre,Italia,380,2,9,11,"(6.171601,-75.427454)"
2020,Agosto,Portugal,620,1,0,1,"(7.818934,-72.453226)"
2019,Agosto,Estados Unidos de América,840,5591,7426,13020,"(10.445761,-75.516429)"
2013,Mayo,Ecuador,218,1859,2872,4731,"(4.697144,-74.140516)"
2023,Marzo,Suiza,756,1,1,2,"(-4.223468,-69.945098)"
2021,Enero,Nicaragua,558,2,2,4,"(3.541112,-76.384584)"
2022,Agosto,Suecia,752,1,0,1,"(7.916725,-72.462544)"
2019,Mayo,Nueva Zelanda,554,0,2,2,"(10.886611,-74.776708)"
2022,Junio,República de Armenia,51,1,1,2,"(10.445761,-75.516429)"
2015,Julio,Estados Unidos de América,840,0,5,5,"(12.5744111,-81.703935)"
2014,Febrero,Perú,604,223,170,393,"(12.586067,-81.702563)"
2023,Junio,Japón,392,117,341,459,"(4.697144,-74.140516)"
2017,Noviembre,Jamaica,388,3,12,15,"(6.171601,-75.427454)"
2023,Mayo,Hong Kong,344,4,6,10,"(3.541112,-76.384584)"
2015,Marzo,Lituania,440,1,1,2,"(7.818934,-72.453226)"
2022,Diciembre,Granada,308,0,2,2,"(10.886611,-74.776708)"
2015,Enero,Portugal,620,1,0,1,"(12.586067,-81.702563)"
2019,Mayo,Bélgica,56,0,1,1,"(4.815061,-75.736532)"
2015,Marzo,Taiwán,158,1,1,2,"(10.445761,-75.516429)"
2018,Agosto,Argentina,32,0,1,1,"(0.812436,-77.847006)"
2015,Agosto,República Dominicana,214,2,11,13,"(4.815061,-75.736532)"
2015,Marzo,Singapur,702,1,0,1,"(-4.197703,-69.941278)"
2023,Febrero,Malta,470,0,2,2,"(3.541112,-76.384584)"
2018,Mayo,República Dominicana,214,55,67,122,"(10.445761,-75.516429)"
2020,Marzo,Macedonia,807,1,2,3,"(6.171601,-75.427454)"
2021,Julio,Filipinas,608,0,27,27,"(10.971302,-74.765397)"
2018,Octubre,Rumania,642,4,7,11,"(10.445761,-75.516429)"
2016,Julio,China,156,0,1,1,"(7.927209,-72.507910)"
2023,Febrero,Anguila/Territorio Británico de Ultramar,660,2,1,3,"(3.541112,-76.384584)"
2015,Enero,San Cristóbal y Nevis,659,0,1,1,"(10.445761,-75.516429)"
2015,Agosto,Israel,376,0,1,1,"(10.408582,-75.538003)"
2013,Febrero,Guyana,328,7,1,8,"(4.697144,-74.140516)"
2018,Abril,Países Bajos,528,11,22,33,"(10.886611,-74.776708)"
2015,Junio,Ucrania,804,0,2,2,"(10.445761,-75.516429)"
2022,Abril,Guatemala,320,257,227,484,"(10.445761,-75.516429)"
2014,Octubre,Argelia,12,2,5,7,"(4.697144,-74.140516)"
2016,Enero,Belice,84,3,6,9,"(4.697144,-74.140516)"
2018,Noviembre,Trinidad y Tobago,780,2,20,22,"(10.445761,-75.516429)"
2019,Diciembre,Bolivia,68,0,1,1,"(7.128456,-73.183637)"
2017,Noviembre,Ucrania,804,0,7,7,"(10.408582,-75.538003)"
2016,Octubre,Cuba,192,0,1,1,"(11.360009,-72.129330)"
2023,Febrero,España,724,5,8,13,"(11.247723,-74.213989)"
2014,Julio,Mauritania,478,0,4,4,"(4.697144,-74.140516)"
2019,Junio,Cabo Verde,132,0,1,1,"(6.171601,-75.427454)"
2017,Septiembre,Suecia,752,9,19,28,"(6.171601,-75.427454)"
2018,Julio,Japón,392,0,2,2,"(-4.223468,-69.945098)"
2023,Marzo,Reino Unido de Gran Bretaña e Irlanda del Norte,826,14,24,38,"(10.886611,-74.776708)"
2020,Abril,Austria,40,0,1,1,"(4.697144,-74.140516)"
2023,Abril,Reino Unido de Gran Bretaña e Irlanda del Norte,826,2,3,5,"(8.364293,-72.405710)"
2023,Junio,Guatemala,320,2,2,4,"(7.128456,-73.183637)"
2022,Julio,Finlandia,246,8,8,16,"(6.171601,-75.427454)"
2016,Junio,Austria,40,7,8,15,"(0.814836,-77.662532)"
2019,Septiembre,Dinamarca,208,66,121,187,"(4.697144,-74.140516)"
2016,Noviembre,Federación de Rusia,643,4,12,16,"(10.886611,-74.776708)"
2019,Diciembre,Francia,250,285,493,778,"(6.171601,-75.427454)"
2014,Julio,Panamá,591,2,2,4,"(7.102626,-77.762647)"
2022,Marzo,Macedonia,807,0,1,1,"(3.541112,-76.384584)"
2023,Febrero,Bután,64,1,0,1,"(6.171601,-75.427454)"
2022,Abril,Nueva Zelanda,554,1,1,2,"(10.408582,-75.538003)"
2016,Mayo,Polonia,616,0,11,11,"(10.408582,-75.538003)"
2023,Enero,Portugal,620,0,6,6,"(7.927209,-72.507910)"
2016,Enero,Japón,392,2,8,10,"(10.886611,-74.776708)"
2013,Mayo,Kenia,404,2,1,3,"(4.697144,-74.140516)"
2013,Febrero,Austria,40,4,20,24,"(6.171601,-75.427454)"
2022,Marzo,Francia,250,9,9,18,"(-4.197703,-69.941278)"
2021,Abril,España,724,77,178,255,"(6.171601,-75.427454)"
2021,Junio,Guatemala,320,6,9,15,"(10.886611,-74.776708)"
2017,Agosto,Nueva Zelanda,554,0,1,1,"(10.886611,-74.776708)"
2018,Noviembre,Serbia,688,14,38,52,"(4.697144,-74.140516)"
2020,Septiembre,Portugal,620,6,21,27,"(4.697144,-74.140516)"
2013,Abril,Kuwait,414,0,1,1,"(4.697144,-74.140516)"
2014,Octubre,República de Corea,410,0,6,6,"(4.815061,-75.736532)"
2016,Febrero,Bolivia,68,31,26,57,"(12.586067,-81.702563)"
2022,Octubre,Argentina,32,147,111,258,"(11.117806,-74.232622)"
2022,Mayo,San Cristóbal y Nevis,659,0,3,3,"(3.541112,-76.384584)"
2016,Mayo,Costa Rica,188,4,5,9,"(4.815061,-75.736532)"
2023,Marzo,Surinam,740,11,11,22,"(4.697144,-74.140516)"
2015,Julio,Honduras,340,0,2,2,"(12.586067,-81.702563)"
2016,Julio,Argelia,12,0,1,1,"(10.886611,-74.776708)"
2019,Julio,Grecia,300,49,80,129,"(4.697144,-74.140516)"
2014,Octubre,Nigeria,566,2,12,14,"(6.171601,-75.427454)"
2016,Octubre,Bosnia y Herzegovina,70,1,1,2,"(4.697144,-74.140516)"
2015,Abril,Costa Rica,188,0,1,1,"(8.635765,-77.346578)"
2015,Noviembre,Países Bajos,528,4,3,7,"(-4.197703,-69.941278)"
2019,Agosto,China,156,0,1,1,"(-4.223468,-69.945098)"
2017,Noviembre,Ecuador,218,0,2,2,"(3.866713,-67.927521)"
2020,Febrero,Bután,64,1,0,1,"(6.171601,-75.427454)"
2018,Febrero,México,484,0,2,2,"(-4.223468,-69.945098)"
2018,Mayo,Suiza,756,4,5,9,"(10.886611,-74.776708)"
2014,Octubre,China,156,3,3,6,"(10.886611,-74.776708)"
2017,Octubre,Grecia,300,1,0,1,"(7.818934,-72.453226)"
2014,Noviembre,Bangladesh,50,1,0,1,"(10.445761,-75.516429)"
2018,Octubre,Egipto,818,1,3,4,"(6.171601,-75.427454)"
2014,Julio,China,156,1,0,1,"(11.360009,-72.129330)"
2019,Julio,Chile,152,564,392,956,"(10.445761,-75.516429)"
2020,Septiembre,Venezuela,862,1,0,1,"(10.408582,-75.538003)"
2015,Septiembre,Finlandia,246,0,1,1,"(0.814836,-77.662532)"
2023,Enero,Suecia,752,9,10,19,"(0.814836,-77.662532)"
2019,Febrero,Reino Unido de Gran Bretaña e Irlanda del Norte,826,115,247,362,"(6.171601,-75.427454)"
2019,Marzo,Canadá,124,0,1,1,"(11.247723,-74.213989)"
2013,Agosto,Austria,40,5,8,13,"(10.408582,-75.538003)"
2014,Julio,República Árabe Siria,760,0,6,6,"(4.697144,-74.140516)"
2013,Mayo,Federación de Rusia,643,0,8,8,"(10.886611,-74.776708)"
2015,Agosto,Ecuador,218,41,80,121,"(6.171601,-75.427454)"
2015,Julio,República Dominicana,214,40,55,95,"(10.445761,-75.516429)"
2012,Septiembre,República Checa,203,22,32,54,"(4.697144,-74.140516)"
2022,Marzo,Hong Kong,344,2,3,5,"(6.171601,-75.427454)"
2012,Marzo,Tailandia,764,1,1,2,"(10.886611,-74.776708)"
2021,Octubre,Palestina,99999,0,1,1,"(4.697144,-74.140516)"
2021,Enero,México,484,2,5,7,"(7.128456,-73.183637)"
2015,Julio,Panamá,591,1,15,16,"(10.408582,-75.538003)"
2019,Octubre,Rwanda,646,1,1,2,"(4.697144,-74.140516)"
2022,Junio,Rumania,642,0,11,11,"(3.893038,-77.067921)"
2022,Septiembre,República Checa,203,3,8,11,"(6.171601,-75.427454)"
2018,Mayo,Venezuela,862,1195,1319,2514,"(6.171601,-75.427454)"
2017,Junio,Serbia,688,1,0,1,"(3.541112,-76.384584)"
2018,Junio,Costa Rica,188,2,0,2,"(10.408582,-75.538003)"
2013,Mayo,Italia,380,0,3,3,"(4.815061,-75.736532)"
2014,Octubre,Reino Unido de Gran Bretaña e Irlanda del Norte,826,0,1,1,"(4.815061,-75.736532)"
2018,Junio,Eslovaquia,703,4,0,4,"(0.814836,-77.662532)"
2023,Junio,Desconocido,99999,0,2,2,"(6.171601,-75.427454)"
2014,Agosto,Jamaica,388,7,14,21,"(6.171601,-75.427454)"
2018,Julio,Islas Turcas y Caicos/Territorio Británico de Ultramar,796,1,0,1,"(10.886611,-74.776708)"
2013,Diciembre,Dinamarca,208,1,1,2,"(11.360009,-72.129330)"
2019,Septiembre,Canadá,124,1,1,2,"(8.635765,-77.346578)"
2015,Enero,Francia,250,2,9,11,"(12.586067,-81.702563)"
2018,Agosto,Estados Unidos de América,840,21,12,33,"(7.818934,-72.453226)"
2022,Marzo,El Salvador,222,42,91,133,"(6.171601,-75.427454)"
2023,Enero,Bolivia,68,786,788,1576,"(4.697144,-74.140516)"
2017,Diciembre,Vietnam,704,1,0,1,"(10.886611,-74.776708)"
2015,Noviembre,Dinamarca,208,0,1,1,"(7.128456,-73.183637)"
2018,Noviembre,Líbano,422,12,24,36,"(4.697144,-74.140516)"
2019,Septiembre,Canadá,124,0,1,1,"(8.36068,-72.409396)"
2019,Junio,Serbia,688,5,10,15,"(6.171601,-75.427454)"
2012,Diciembre,Perú,604,0,1,1,"(4.452882,-75.766298)"
2013,Enero,Reino Unido de Gran Bretaña e Irlanda del Norte,826,17,32,49,"(10.445761,-75.516429)"
2016,Mayo,Afganistán,4,0,2,2,"(4.697144,-74.140516)"
2019,Junio,Perú,604,2,4,6,"(4.815061,-75.736532)"
2017,Marzo,Cuba,192,0,1,1,"(4.452882,-75.766298)"
2020,Enero,Brasil,76,1,0,1,"(11.528919,-72.919681)"
2012,Octubre,Cuba,192,0,1,1,"(11.360009,-72.129330)"
2014,Mayo,Uruguay,858,2,4,6,"(10.886611,-74.776708)"
2019,Mayo,Guyana,328,1,0,1,"(7.128456,-73.183637)"
2017,Abril,Bulgaria,100,0,3,3,"(10.445761,-75.516429)"
2016,Febrero,China,156,1,1,2,"(7.927209,-72.507910)"
2015,Octubre,República de Belarús,112,11,12,23,"(4.697144,-74.140516)"
2022,Junio,Perú,604,1,0,1,"(-3.790089,-70.356599)"
2015,Octubre,Dinamarca,208,8,11,19,"(10.445761,-75.516429)"
2023,Abril,Qatar,634,0,3,3,"(4.697144,-74.140516)"
2012,Enero,República Dominicana,214,30,49,79,"(6.171601,-75.427454)"
2015,Marzo,República de Belarús,112,3,7,10,"(4.697144,-74.140516)"
2014,Julio,Nepal,524,1,3,4,"(4.697144,-74.140516)"
2015,Septiembre,Sudán,736,0,1,1,"(4.697144,-74.140516)"
2013,Junio,Japón,392,82,400,482,"(4.697144,-74.140516)"
2014,Mayo,Polonia,616,0,1,1,"(10.971302,-74.765397)"
2017,Noviembre,El Salvador,222,806,1142,1948,"(4.697144,-74.140516)"
2019,Junio,Qatar,634,0,2,2,"(10.445761,-75.516429)"
2021,Agosto,Bahréin,48,2,3,5,"(4.697144,-74.140516)"
2023,Abril,Cuba,192,7,8,15,"(10.445761,-75.516429)"
2018,Julio,China,156,0,2,2,"(10.408582,-75.538003)"
2017,Diciembre,Honduras,340,1,8,9,"(10.408582,-75.538003)"
2018,Diciembre,República Democrática del Congo,180,0,3,3,"(4.697144,-74.140516)"
2017,Enero,Ecuador,218,5,10,15,"(10.886611,-74.776708)"
2022,Abril,México,484,389,389,778,"(10.445761,-75.516429)"
2023,Junio,Andorra,20,1,0,1,"(-4.223468,-69.945098)"
2023,Marzo,Nueva Zelanda,554,1,0,1,"(8.364293,-72.405710)"
2013,Mayo,Estonia,233,1,0,1,"(3.541112,-76.384584)"
2022,Marzo,Honduras,340,277,278,555,"(4.697144,-74.140516)"
2019,Noviembre,México,484,5223,8218,13443,"(4.697144,-74.140516)"
2017,Diciembre,República de Corea,410,3,2,5,"(12.586067,-81.702563)"
2023,Abril,Guatemala,320,30,49,79,"(3.541112,-76.384584)"
2016,Julio,Venezuela,862,8,16,24,"(3.866713,-67.927521)"
2022,Junio,Lituania,440,28,30,58,"(4.697144,-74.140516)"
2013,Diciembre,China,156,0,2,2,"(0.814836,-77.662532)"
2022,Marzo,Venezuela,862,257,248,505,"(10.886611,-74.776708)"
2019,Mayo,Chipre,196,0,1,1,"(6.171601,-75.427454)"
2017,Mayo,Turquía,792,0,2,2,"(11.360009,-72.129330)"
2013,Diciembre,Panamá,591,68,131,199,"(10.886611,-74.776708)"
2017,Agosto,Ecuador,218,61,110,171,"(6.171601,-75.427454)"
2015,Agosto,El Salvador,222,113,125,238,"(3.541112,-76.384584)"
2013,Marzo,Italia,380,0,1,1,"(4.452882,-75.766298)"
2013,Octubre,México,484,2371,5217,7588,"(4.697144,-74.140516)"
2016,Marzo,Italia,380,53,196,249,"(6.171601,-75.427454)"
2012,Enero,Islas del Canal,238,0,1,1,"(4.697144,-74.140516)"
2012,Abril,Argentina,32,53,185,238,"(6.171601,-75.427454)"
2012,Agosto,Canadá,124,0,4,4,"(11.360009,-72.129330)"
2017,Septiembre,Paraguay,600,5,5,10,"(4.815061,-75.736532)"
2017,Marzo,Guatemala,320,0,3,3,"(7.818934,-72.453226)"
2021,Noviembre,Costa Rica,188,29,32,61,"(10.886611,-74.776708)"
2013,Julio,Israel,376,6,27,33,"(10.445761,-75.516429)"
2015,Enero,Alemania,276,3,0,3,"(7.927209,-72.507910)"
2019,Agosto,Namibia,516,1,0,1,"(10.445761,-75.516429)"
2016,Mayo,Cuba,192,0,1,1,"(0.25129,-76.875963)"
2014,Julio,República Dominicana,214,6,13,19,"(0.814836,-77.662532)"
2019,Marzo,Macedonia,807,3,7,10,"(4.697144,-74.140516)"
2013,Octubre,Suiza,756,27,41,68,"(6.171601,-75.427454)"
2015,Septiembre,Aruba,533,1,0,1,"(7.128456,-73.183637)"
2015,Junio,Sudáfrica,710,1,4,5,"(10.886611,-74.776708)"
2020,Febrero,Suecia,752,19,58,77,"(6.171601,-75.427454)"
2017,Mayo,Eslovaquia,703,1,1,2,"(6.171601,-75.427454)"
2014,Julio,Pakistán,586,0,4,4,"(6.171601,-75.427454)"
2013,Julio,Países Bajos,528,14,6,20,"(10.408582,-75.538003)"
2019,Enero,Albania,8,0,3,3,"(6.171601,-75.427454)"
2014,Julio,Kenia,404,0,3,3,"(3.541112,-76.384584)"
2012,Noviembre,Federación de Rusia,643,3,0,3,"(6.171601,-75.427454)"
2015,Septiembre,Pakistán,586,0,1,1,"(0.814836,-77.662532)"
2018,Noviembre,Haití,332,2,2,4,"(10.445761,-75.516429)"
2016,Diciembre,Alemania,276,62,78,140,"(0.814836,-77.662532)"
2023,Marzo,Costa Rica,188,0,7,7,"(3.893038,-77.067921)"
2022,Agosto,Bélgica,56,1,0,1,"(4.452882,-75.766298)"
2017,Octubre,Eslovaquia,703,0,1,1,"(6.171601,-75.427454)"
2013,Abril,Suecia,752,2,2,4,"(11.360009,-72.129330)"
2014,Octubre,Pakistán,586,0,1,1,"(10.971302,-74.765397)"
2019,Febrero,República de Irlanda,372,15,36,51,"(6.171601,-75.427454)"
2019,Julio,Guatemala,320,1,2,3,"(12.586067,-81.702563)"
2013,Septiembre,Filipinas,608,19,100,119,"(4.697144,-74.140516)"
2023,Marzo,Argentina,32,172,340,512,"(6.171601,-75.427454)"
2014,Febrero,Alemania,276,3,4,7,"(12.586067,-81.702563)"
2022,Mayo,Georgia,268,17,60,77,"(4.697144,-74.140516)"
2017,Octubre,China,156,3,6,9,"(-4.197703,-69.941278)"
2017,Agosto,Arabia Saudita,682,0,1,1,"(10.445761,-75.516429)"
2023,Abril,Croacia,191,4,14,18,"(6.171601,-75.427454)"
2018,Julio,Panamá,591,394,218,612,"(3.541112,-76.384584)"
2015,Febrero,Polonia,616,171,253,424,"(4.697144,-74.140516)"
2014,Febrero,Grecia,300,0,7,7,"(10.408582,-75.538003)"
2021,Octubre,Francia,250,100,172,272,"(6.171601,-75.427454)"
2015,Junio,Chipre,196,2,1,3,"(10.445761,-75.516429)"
2020,Febrero,Canadá,124,2,4,6,"(-4.223468,-69.945098)"
2018,Octubre,Líbano,422,1,2,3,"(10.886611,-74.776708)"
2017,Junio,Kazajistán,398,1,0,1,"(6.171601,-75.427454)"
2012,Mayo,Guatemala,320,167,331,498,"(4.697144,-74.140516)"
2017,Junio,Portugal,620,4,2,6,"(0.814836,-77.662532)"
2017,Julio,Brasil,76,3,108,111,"(11.247723,-74.213989)"
2016,Noviembre,Serbia,688,6,16,22,"(4.697144,-74.140516)"
2012,Mayo,Panamá,591,2,11,13,"(7.128456,-73.183637)"
2019,Agosto,Ucrania,804,0,3,3,"(9.402978,-75.681599)"
2012,Enero,España,724,19,65,84,"(7.818934,-72.453226)"
2019,Septiembre,China,156,1,0,1,"(12.586067,-81.702563)"
2013,Junio,Lituania,440,1,2,3,"(10.445761,-75.516429)"
2018,Octubre,Argelia,12,1,1,2,"(6.171601,-75.427454)"
2022,Febrero,India,356,0,2,2,"(4.452882,-75.766298)"
2017,Febrero,Bulgaria,100,0,1,1,"(12.586067,-81.702563)"
2017,Noviembre,Italia,380,0,1,1,"(-0.193180,-74.784874)"
2019,Febrero,China,156,469,778,1247,"(4.697144,-74.140516)"
2020,Febrero,República Democrática del Congo,180,1,3,4,"(4.697144,-74.140516)"
2015,Agosto,Estados Unidos de América,840,3,8,11,"(11.360009,-72.129330)"
2015,Agosto,Italia,380,52,158,210,"(10.445761,-75.516429)"
2019,Agosto,Guatemala,320,1,7,8,"(10.408582,-75.538003)"
2023,Abril,Bulgaria,100,0,10,10,"(3.893038,-77.067921)"
2019,Mayo,Italia,380,0,1,1,"(11.117806,-74.232622)"
2020,Junio,Italia,380,0,1,1,"(7.818934,-72.453226)"
2019,Febrero,Grecia,300,1,0,1,"(10.886611,-74.776708)"
2016,Febrero,Federación de Rusia,643,3,5,8,"(-4.197703,-69.941278)"
2023,Marzo,Bosnia y Herzegovina,70,1,0,1,"(3.541112,-76.384584)"
2017,Diciembre,Argentina,32,103,134,237,"(3.541112,-76.384584)"
2017,Febrero,Hungría,348,4,10,14,"(6.171601,-75.427454)"
2021,Agosto,Myanmar,104,0,1,1,"(11.247723,-74.213989)"
2019,Mayo,Cuba,192,0,1,1,"(-4.197703,-69.941278)"
2019,Julio,Malta,470,0,2,2,"(10.445761,-75.516429)"
2012,Febrero,Rwanda,646,0,1,1,"(4.697144,-74.140516)"
2013,Febrero,Reino Unido de Gran Bretaña e Irlanda del Norte,826,0,2,2,"(3.541112,-76.384584)"
2023,Enero,Chile,152,42,75,117,"(7.818934,-72.453226)"
2014,Enero,Chile,152,64,58,122,"(12.586067,-81.702563)"
2023,Abril,Portugal,620,0,1,1,"(6.18189,-67.47535)"
2012,Julio,Irán,364,0,1,1,"(3.541112,-76.384584)"
2015,Diciembre,Chile,152,1,1,2,"(-4.197703,-69.941278)"
2013,Marzo,Haití,332,1,1,2,"(10.445761,-75.516429)"
2021,Noviembre,Puerto Rico/Territorio de Estados Unidos,630,0,2,3,"(4.697144,-74.140516)"
2017,Noviembre,Uruguay,858,0,2,2,"(4.815061,-75.736532)"
2016,Enero,Antigua y Barbuda,28,1,1,2,"(10.445761,-75.516429)"
2014,Octubre,Mauritania,478,0,2,2,"(4.697144,-74.140516)"
2020,Marzo,Arabia Saudita,682,0,2,2,"(6.171601,-75.427454)"
2012,Enero,Países Bajos,528,7,14,21,"(3.541112,-76.384584)"
2022,Septiembre,Dinamarca,208,72,131,203,"(4.697144,-74.140516)"
2014,Febrero,Ecuador,218,1,0,1,"(-4.197703,-69.941278)"
2013,Diciembre,Filipinas,608,1,1,2,"(0.814836,-77.662532)"
2017,Noviembre,Guyana,328,1,0,1,"(7.818934,-72.453226)"
2014,Febrero,Federación de Rusia,643,1,1,2,"(3.541112,-76.384584)"
2015,Julio,Islandia,352,3,3,6,"(4.697144,-74.140516)"
2012,Diciembre,Cuba,192,2,1,3,"(7.927209,-72.507910)"
2022,Marzo,Polonia,616,190,262,452,"(4.697144,-74.140516)"
2022,Julio,Guatemala,320,1,3,4,"(7.818934,-72.453226)"
2019,Mayo,Brasil,76,2,5,7,"(11.360009,-72.129330)"
2022,Abril,Belice,84,1,2,3,"(6.171601,-75.427454)"
2022,Junio,Panamá,591,0,1,1,"(12.5744111,-81.703935)"
2012,Octubre,República de Irlanda,372,2,10,12,"(10.445761,-75.516429)"
2014,Octubre,Panamá,591,444,588,1032,"(6.171601,-75.427454)"
2018,Abril,Suiza,756,2,4,6,"(10.886611,-74.776708)"
2017,Mayo,Reino Unido de Gran Bretaña e Irlanda del Norte,826,4,6,10,"(10.886611,-74.776708)"
2022,Enero,Noruega,578,2,1,3,"(4.815061,-75.736532)"
2015,Agosto,República de Corea,410,28,44,72,"(6.171601,-75.427454)"
2016,Abril,Angola,24,0,4,4,"(4.697144,-74.140516)"
2022,Octubre,India,356,112,428,540,"(4.697144,-74.140516)"
2016,Junio,Honduras,340,0,3,3,"(0.814836,-77.662532)"
2012,Noviembre,Liechtenstein,438,1,2,3,"(4.697144,-74.140516)"
2020,Noviembre,Perú,604,18,42,60,"(3.541112,-76.384584)"
2013,Febrero,Filipinas,608,2,24,26,"(10.408582,-75.538003)"
2012,Octubre,Francia,250,2,4,6,"(4.815061,-75.736532)"
2012,Enero,Nueva Zelanda,554,1,0,1,"(10.445761,-75.516429)"
2023,Marzo,República de Corea,410,0,2,2,"(10.408582,-75.538003)"
2014,Febrero,Irán,364,2,11,13,"(4.697144,-74.140516)"
2022,Enero,Panamá,591,1734,1484,3219,"(6.171601,-75.427454)"
2015,Julio,Montenegro,499,1,1,2,"(3.541112,-76.384584)"
2016,Febrero,Dinamarca,208,6,20,26,"(6.171601,-75.427454)"
2022,Marzo,Bolivia,68,1,4,5,"(0.814836,-77.662532)"
2013,Junio,Reino Unido de Gran Bretaña e Irlanda del Norte,826,2,1,3,"(0.814836,-77.662532)"
2022,Diciembre,Anguila/Territorio Británico de Ultramar,660,1,2,3,"(3.541112,-76.384584)"
2023,Junio,Portugal,620,1,2,3,"(8.36068,-72.409396)"
2023,Junio,Kazajistán,398,1,1,2,"(10.445761,-75.516429)"
2015,Abril,Alemania,276,2,6,8,"(11.360009,-72.129330)"
2023,Enero,Bahamas,44,1,9,10,"(4.697144,-74.140516)"
2015,Junio,Bolivia,68,1,1,2,"(11.360009,-72.129330)"
2017,Octubre,Nueva Zelanda,554,8,13,21,"(3.541112,-76.384584)"
2020,Octubre,Letonia,428,0,1,1,"(6.171601,-75.427454)"
2019,Mayo,Guyana,328,1,0,1,"(12.586067,-81.702563)"
2015,Junio,Portugal,620,2,6,8,"(10.886611,-74.776708)"
2019,Febrero,Guatemala,320,2,3,5,"(0.814836,-77.662532)"
2020,Marzo,Rumania,642,25,38,63,"(4.697144,-74.140516)"
2019,Octubre,Islas Caimán/Territorio Británico de Ultramar,136,0,0,1,"(12.586067,-81.702563)"
2016,Enero,Polonia,616,2,19,21,"(10.408582,-75.538003)"
2018,Agosto,España,724,3,10,13,"(11.360009,-72.129330)"
2016,Mayo,Perú,604,0,2,2,"(10.971302,-74.765397)"
2023,Abril,Canadá,124,3,4,7,"(4.452882,-75.766298)"
2015,Septiembre,El Salvador,222,92,102,194,"(3.541112,-76.384584)"
2023,Enero,Ecuador,218,11,22,33,"(11.360009,-72.129330)"
2018,Mayo,Panamá,591,403,442,845,"(10.445761,-75.516429)"
2019,Abril,República de Armenia,51,0,1,1,"(10.445761,-75.516429)"
2015,Enero,Federación de Rusia,643,4,12,16,"(7.818934,-72.453226)"
2016,Octubre,Croacia,191,3,1,4,"(6.171601,-75.427454)"
2015,Febrero,Ucrania,804,1,1,2,"(10.408582,-75.538003)"
2017,Noviembre,Costa Rica,188,0,2,2,"(4.452882,-75.766298)"
2016,Julio,Nigeria,566,2,0,2,"(0.814836,-77.662532)"
2013,Diciembre,Venezuela,862,0,1,1,"(8.635765,-77.346578)"
2014,Febrero,Japón,392,0,1,1,"(7.128456,-73.183637)"
2017,Enero,Japón,392,0,1,1,"(12.586067,-81.702563)"
2015,Julio,Japón,392,0,1,1,"(12.586067,-81.702563)"
2018,Septiembre,Nueva Zelanda,554,7,14,21,"(6.171601,-75.427454)"
2017,Junio,Grecia,300,0,2,2,"(9.402978,-75.681599)"
2015,Julio,Trinidad y Tobago,780,11,17,28,"(10.445761,-75.516429)"
2014,Enero,Países Bajos,528,30,65,95,"(3.541112,-76.384584)"
2017,Diciembre,Portugal,620,22,48,70,"(6.171601,-75.427454)"
2018,Agosto,Nicaragua,558,23,35,58,"(6.171601,-75.427454)"
2018,Octubre,Jamaica,388,23,59,82,"(4.697144,-74.140516)"
2023,Mayo,Kenia,404,0,1,1,"(6.171601,-75.427454)"
2019,Febrero,Cuba,192,14,16,30,"(6.171601,-75.427454)"
2020,Junio,Paraguay,600,0,8,8,"(4.697144,-74.140516)"
2018,Marzo,Federación de Rusia,643,5,2,7,"(0.814836,-77.662532)"
2019,Febrero,Australia,36,1,9,10,"(0.25129,-76.875963)"
2021,Junio,Bulgaria,100,0,3,3,"(10.445761,-75.516429)"
2016,Enero,Guyana,328,2,3,5,"(6.171601,-75.427454)"
2017,Marzo,Australia,36,2,15,17,"(10.886611,-74.776708)"
2012,Febrero,Trinidad y Tobago,780,0,1,1,"(10.408582,-75.538003)"
2019,Enero,Irán,364,0,1,1,"(3.541112,-76.384584)"
2016,Diciembre,Costa Rica,188,8,3,11,"(7.128456,-73.183637)"
2018,Abril,China,156,0,2,2,"(10.971302,-74.765397)"
2023,Enero,San Cristóbal y Nevis,659,1,4,5,"(4.697144,-74.140516)"
2013,Marzo,Guyana,328,0,2,2,"(10.445761,-75.516429)"
2023,Enero,Perú,604,2,1,3,"(-0.193180,-74.784874)"
2019,Diciembre,Egipto,818,0,1,1,"(4.815061,-75.736532)"
2021,Marzo,Costa Rica,188,419,466,885,"(4.697144,-74.140516)"
2017,Agosto,El Salvador,222,0,1,1,"(7.088729,-70.740253)"
2013,Marzo,Polonia,616,1,3,4,"(3.541112,-76.384584)"
2016,Octubre,Italia,380,0,2,2,"(12.5744111,-81.703935)"
2018,Septiembre,Portugal,620,12,30,42,"(10.445761,-75.516429)"
2014,Agosto,Palestina,99999,0,1,1,"(6.171601,-75.427454)"
2016,Diciembre,Sri Lanka,144,0,1,1,"(7.128456,-73.183637)"
2014,Abril,Costa Rica,188,1,5,6,"(4.815061,-75.736532)"
2013,Diciembre,Reino Unido de Gran Bretaña e Irlanda del Norte,826,29,32,61,"(10.408582,-75.538003)"
2019,Octubre,República de Irlanda,372,1,1,2,"(-4.223468,-69.945098)"
2022,Junio,Hong Kong,344,5,4,9,"(6.171601,-75.427454)"
2023,Febrero,Polonia,616,11,11,22,"(0.814836,-77.662532)"
2019,Abril,India,356,7,61,68,"(6.171601,-75.427454)"
2017,Septiembre,Países Bajos,528,31,20,51,"(7.128456,-73.183637)"
2017,Junio,Noruega,578,175,256,431,"(4.697144,-74.140516)"
2017,Marzo,Cuba,192,6,7,13,"(10.886611,-74.776708)"
2012,Mayo,China,156,0,1,1,"(7.927209,-72.507910)"
2020,Octubre,Brasil,76,0,1,1,"(4.452882,-75.766298)"
2014,Agosto,Argelia,12,2,4,6,"(4.697144,-74.140516)"
2018,Mayo,Australia,36,3,2,5,"(-4.223468,-69.945098)"
2023,Febrero,Albania,8,0,4,4,"(6.171601,-75.427454)"
2015,Febrero,México,484,2,7,9,"(12.586067,-81.702563)"
2019,Mayo,Malasia,458,1,7,8,"(6.171601,-75.427454)"
2013,Abril,España,724,0,8,8,"(4.815061,-75.736532)"
2012,Junio,Puerto Rico/Territorio de Estados Unidos,630,0,2,2,"(10.886611,-74.776708)"
2012,Diciembre,Panamá,591,34,31,65,"(12.586067,-81.702563)"
2018,Mayo,España,724,25,56,81,"(10.886611,-74.776708)"
2018,Febrero,Jamaica,388,1,0,1,"(7.818934,-72.453226)"
2013,Marzo,Bermudas/Territorio Británico de Ultramar,60,2,0,2,"(10.445761,-75.516429)"
2019,Agosto,Estados Unidos de América,840,2,1,3,"(7.088729,-70.740253)"
2017,Agosto,Taiwán,158,5,5,10,"(10.445761,-75.516429)"
2022,Abril,Perú,604,9,3,12,"(7.927209,-72.507910)"
2012,Octubre,Paraguay,600,89,119,208,"(4.697144,-74.140516)"
2019,Junio,Eslovaquia,703,1,0,1,"(3.541112,-76.384584)"
2016,Noviembre,Venezuela,862,75,73,148,"(8.36068,-72.409396)"
2015,Diciembre,Chile,152,0,3,3,"(7.128456,-73.183637)"
2012,Febrero,España,724,1,2,3,"(8.635765,-77.346578)"
2021,Junio,Noruega,578,0,1,1,"(3.541112,-76.384584)"
2018,Julio,Reino Unido de Gran Bretaña e Irlanda del Norte,826,0,2,2,"(12.5744111,-81.703935)"
2014,Mayo,Japón,392,8,12,20,"(3.541112,-76.384584)"
2023,Junio,Perú,604,4373,5064,9437,"(4.697144,-74.140516)"
2013,Enero,República Dominicana,214,200,260,460,"(4.697144,-74.140516)"
2012,Julio,China,156,146,367,513,"(4.697144,-74.140516)"
2017,Enero,Bolivia,68,43,46,89,"(6.171601,-75.427454)"
2019,Junio,Canadá,124,1,1,2,"(-4.197703,-69.941278)"
2016,Noviembre,Argelia,12,4,4,8,"(4.697144,-74.140516)"
2016,Octubre,Dinamarca,208,1,1,2,"(-4.197703,-69.941278)"
2016,Abril,República de Irlanda,372,96,161,257,"(4.697144,-74.140516)"
2016,Enero,Serbia,688,0,1,1,"(0.814836,-77.662532)"
2015,Mayo,Alemania,276,14,12,26,"(8.635765,-77.346578)"
2012,Febrero,Canadá,124,446,456,902,"(12.586067,-81.702563)"
2020,Junio,Honduras,340,3,0,3,"(4.697144,-74.140516)"
2014,Marzo,Portugal,620,120,347,467,"(4.697144,-74.140516)"
2023,Junio,Finlandia,246,7,10,17,"(6.171601,-75.427454)"
2013,Septiembre,Italia,380,0,2,2,"(8.635765,-77.346578)"
2016,Noviembre,Bahamas,44,0,2,2,"(4.815061,-75.736532)"
2019,Enero,Bélgica,56,12,14,26,"(0.814836,-77.662532)"
2021,Mayo,Alemania,276,0,1,1,"(-4.197703,-69.941278)"
2022,Junio,Austria,40,0,1,1,"(8.635765,-77.346578)"
2015,Julio,Chile,152,37,70,107,"(3.541112,-76.384584)"
2017,Enero,Reino Unido de Gran Bretaña e Irlanda del Norte,826,3,13,16,"(10.886611,-74.776708)"
2012,Agosto,Reino Unido de Gran Bretaña e Irlanda del Norte,826,16,26,42,"(6.171601,-75.427454)"
2019,Agosto,Venezuela,862,1078,957,2035,"(7.088729,-70.740253)"
2021,Mayo,Kenia,404,1,0,1,"(10.445761,-75.516429)"
2016,Enero,Taiwán,158,1,0,1,"(10.445761,-75.516429)"
2013,Diciembre,China,156,9,5,14,"(6.171601,-75.427454)"
2020,Febrero,Granada,308,2,4,6,"(4.697144,-74.140516)"
2019,Junio,Malawi,454,0,1,1,"(4.697144,-74.140516)"
2021,Marzo,Guatemala,320,5,6,11,"(4.815061,-75.736532)"
2013,Noviembre,México,484,1,2,3,"(6.185799,-67.483929)"
2014,Diciembre,México,484,18,20,38,"(7.128456,-73.183637)"
2013,Junio,Turquía,792,0,1,1,"(10.971302,-74.765397)"
2021,Mayo,China,156,5,19,24,"(6.171601,-75.427454)"
2022,Noviembre,Dinamarca,208,0,1,1,"(0.814836,-77.662532)"
2018,Enero,México,484,25,35,60,"(0.814836,-77.662532)"
2022,Abril,Grecia,300,0,1,1,"(8.36068,-72.409396)"
2022,Noviembre,Jamaica,388,0,1,1,"(12.5744111,-81.703935)"
2019,Octubre,Desconocido,99999,0,1,1,"(12.586067,-81.702563)"
2017,Diciembre,Dinamarca,208,0,5,5,"(8.635765,-77.346578)"
2012,Enero,Bélgica,56,2,3,5,"(-4.197703,-69.941278)"
2018,Diciembre,Malasia,458,5,10,16,"(10.445761,-75.516429)"
2022,Abril,Polonia,616,1,9,10,"(10.408582,-75.538003)"
2020,Enero,Italia,380,7,13,20,"(10.408582,-75.538003)"
2013,Febrero,Reino Unido de Gran Bretaña e Irlanda del Norte,826,0,1,1,"(10.408582,-75.538003)"
2014,Mayo,Francia,250,39,50,89,"(10.445761,-75.516429)"
2015,Junio,Santa Lucia,662,0,1,1,"(12.586067,-81.702563)"
2017,Mayo,Bahamas,44,0,5,5,"(6.171601,-75.427454)"
2014,Junio,España,724,4,18,22,"(10.886611,-74.776708)"
2016,Abril,Reino Unido de Gran Bretaña e Irlanda del Norte,826,0,1,1,"(7.927209,-72.507910)"
2016,Septiembre,Israel,376,1,1,2,"(10.408582,-75.538003)"
2017,Enero,Rumania,642,57,86,143,"(4.697144,-74.140516)"
2016,Mayo,Guatemala,320,1,8,9,"(7.927209,-72.507910)"
2016,Mayo,Japón,392,0,1,1,"(4.815061,-75.736532)"
2015,Abril,Chile,152,49,53,102,"(10.445761,-75.516429)"
2022,Junio,Guatemala,320,0,4,4,"(4.815061,-75.736532)"
2021,Marzo,Dinamarca,208,16,28,44,"(4.697144,-74.140516)"
2016,Abril,Israel,376,0,4,4,"(8.635765,-77.346578)"
2018,Enero,Brasil,76,0,3,3,"(8.635765,-77.346578)"
2012,Julio,Ecuador,218,21,32,53,"(11.360009,-72.129330)"
2022,Noviembre,Nigeria,566,3,3,6,"(6.171601,-75.427454)"
2013,Septiembre,Nueva Zelanda,554,24,58,82,"(4.697144,-74.140516)"
2013,Septiembre,Reino Unido de Gran Bretaña e Irlanda del Norte,826,1,0,1,"(10.886611,-74.776708)"
2018,Septiembre,Federación de Rusia,643,0,2,2,"(12.586067,-81.702563)"
2015,Diciembre,Mozambique,508,2,2,4,"(4.697144,-74.140516)"
2016,Octubre,Trinidad y Tobago,780,0,2,2,"(7.818934,-72.453226)"
2012,Octubre,Perú,604,18,42,60,"(7.818934,-72.453226)"
2012,Abril,Canadá,124,198,276,474,"(10.445761,-75.516429)"
2016,Junio,Pakistán,586,4,17,21,"(4.697144,-74.140516)"
2012,Julio,Austria,40,1,2,3,"(-4.197703,-69.941278)"
2021,Junio,Panamá,591,1,0,1,"(7.088729,-70.740253)"
2023,Marzo,Kenia,404,0,1,1,"(6.171601,-75.427454)"
2022,Diciembre,República Dominicana,214,2179,2251,4430,"(4.697144,-74.140516)"
2015,Noviembre,Bolivia,68,513,693,1206,"(4.697144,-74.140516)"
2023,Febrero,Chile,152,2,1,3,"(-4.197703,-69.941278)"
2022,Enero,Liechtenstein,438,1,3,4,"(4.697144,-74.140516)"
2023,Febrero,Reino Unido de Gran Bretaña e Irlanda del Norte,826,15,19,34,"(11.247723,-74.213989)"
2016,Mayo,Dinamarca,208,0,2,2,"(7.128456,-73.183637)"
2022,Junio,República Dominicana,214,4,2,6,"(4.815061,-75.736532)"
2017,Septiembre,Argentina,32,132,94,226,"(12.586067,-81.702563)"
2012,Mayo,Estados Unidos de América,840,5784,11385,17169,"(4.697144,-74.140516)"
2021,Noviembre,Chipre,196,2,6,8,"(4.697144,-74.140516)"
2021,Diciembre,Chipre,196,4,9,13,"(4.697144,-74.140516)"
2018,Enero,Libia,434,0,1,1,"(6.171601,-75.427454)"
2014,Marzo,Rumania,642,1,1,2,"(10.886611,-74.776708)"
2019,Junio,Federación de Rusia,643,1,0,1,"(0.25129,-76.875963)"
2014,Agosto,Angola,24,1,0,1,"(6.171601,-75.427454)"
2022,Agosto,Turquía,792,3,21,24,"(6.171601,-75.427454)"
2016,Junio,Georgia,268,0,1,1,"(10.408582,-75.538003)"
2021,Diciembre,Costa Rica,188,0,1,1,"(11.360009,-72.129330)"
2018,Agosto,Estados Unidos de América,840,5653,6952,12606,"(10.445761,-75.516429)"
2022,Octubre,República Dominicana,214,2,5,7,"(7.128456,-73.183637)"
2019,Noviembre,Francia,250,9,6,15,"(-4.197703,-69.941278)"
2020,Enero,India,356,1,0,1,"(-4.223468,-69.945098)"
2018,Noviembre,India,356,0,2,2,"(-4.197703,-69.941278)"
2015,Marzo,Panamá,591,0,6,6,"(11.360009,-72.129330)"
2019,Mayo,Dinamarca,208,0,1,1,"(-4.197703,-69.941278)"
2018,Septiembre,Bolivia,68,233,187,423,"(10.445761,-75.516429)"
2016,Enero,Ghana,288,0,1,1,"(11.360009,-72.129330)"
2016,Marzo,Brasil,76,489,396,885,"(12.586067,-81.702563)"
2017,Marzo,Nicaragua,558,70,101,171,"(4.697144,-74.140516)"
2017,Julio,Georgia,268,0,1,1,"(6.171601,-75.427454)"
2014,Mayo,Canadá,124,31,44,75,"(3.541112,-76.384584)"
2017,Julio,Australia,36,0,2,2,"(11.360009,-72.129330)"
2020,Diciembre,Chipre,196,1,2,3,"(4.697144,-74.140516)"
2013,Marzo,Guatemala,320,42,57,99,"(10.445761,-75.516429)"
2016,Noviembre,Australia,36,13,23,36,"(10.408582,-75.538003)"
2014,Septiembre,Australia,36,42,80,122,"(6.171601,-75.427454)"
2022,Enero,Turquía,792,0,3,3,"(0.814836,-77.662532)"
2019,Febrero,Hungría,348,72,123,195,"(4.697144,-74.140516)"
2012,Junio,Lituania,440,0,1,1,"(6.171601,-75.427454)"
2019,Enero,Sudáfrica,710,0,1,1,"(10.886611,-74.776708)"
2012,Marzo,Guinea Bissau,624,0,1,1,"(4.697144,-74.140516)"
2018,Agosto,Nueva Zelanda,554,4,5,9,"(10.886611,-74.776708)"
2018,Abril,Vietnam,704,2,5,7,"(4.697144,-74.140516)"
2018,Septiembre,Honduras,340,0,1,1,"(9.402978,-75.681599)"
2017,Octubre,Perú,604,8,12,20,"(-0.193180,-74.784874)"
2021,Julio,Venezuela,862,102,91,193,"(10.445761,-75.516429)"
2016,Junio,Belice,84,4,10,14,"(4.697144,-74.140516)"
2017,Noviembre,Grecia,300,0,1,1,"(10.886611,-74.776708)"
2022,Marzo,Francia,250,0,1,1,"(7.927209,-72.507910)"
2021,Febrero,Filipinas,608,1,39,40,"(10.445761,-75.516429)"
2018,Febrero,Reino Unido de Gran Bretaña e Irlanda del Norte,826,1,2,3,"(4.815061,-75.736532)"
2013,Febrero,Nueva Zelanda,554,2,4,6,"(0.814836,-77.662532)"
2014,Noviembre,Guatemala,320,319,587,906,"(4.697144,-74.140516)"
2017,Marzo,Bélgica,56,0,1,1,"(13.3387613,-81.372937)"
2023,Febrero,Serbia,688,0,1,1,"(12.586067,-81.702563)"
2018,Febrero,Ghana,288,3,7,10,"(4.697144,-74.140516)"
2014,Octubre,Argentina,32,335,264,599,"(12.586067,-81.702563)"
2015,Octubre,España,724,10,12,22,"(10.408582,-75.538003)"
2022,Enero,República de Irlanda,372,1,5,6,"(3.541112,-76.384584)"
2013,Marzo,República de Irlanda,372,46,110,156,"(4.697144,-74.140516)"
2018,Mayo,Sri Lanka,144,0,1,1,"(6.171601,-75.427454)"
2013,Marzo,Dominica,212,0,1,1,"(10.445761,-75.516429)"
2021,Mayo,Austria,40,0,2,2,"(10.886611,-74.776708)"
2017,Mayo,República de Belarús,112,3,4,7,"(4.697144,-74.140516)"
2017,Febrero,República Checa,203,1,0,1,"(-4.197703,-69.941278)"
2021,Octubre,Letonia,428,1,1,2,"(10.445761,-75.516429)"
2016,Diciembre,Desconocido,99999,2,2,4,"(6.171601,-75.427454)"
2017,Octubre,Tonga,776,1,0,1,"(4.697144,-74.140516)"
2012,Febrero,Perú,604,1,1,2,"(7.927209,-72.507910)"
2023,Marzo,Haití,332,11,22,33,"(4.697144,-74.140516)"
2022,Enero,Francia,250,2,1,3,"(7.818934,-72.453226)"
2014,Febrero,Costa Rica,188,2,0,2,"(0.814836,-77.662532)"
2015,Septiembre,Australia,36,51,80,131,"(6.171601,-75.427454)"
2019,Agosto,Turquía,792,223,358,581,"(4.697144,-74.140516)"
2014,Julio,República Democrática del Congo,180,4,0,4,"(7.818934,-72.453226)"
2014,Diciembre,Francia,250,54,87,141,"(10.445761,-75.516429)"
2013,Junio,Trinidad y Tobago,780,0,2,2,"(10.886611,-74.776708)"
2015,Diciembre,Canadá,124,67,94,161,"(10.886611,-74.776708)"
2012,Febrero,Nicaragua,558,1,3,4,"(10.886611,-74.776708)"
2017,Mayo,Estados Unidos de América,840,11,12,23,"(-4.223468,-69.945098)"
2019,Agosto,Argentina,32,3,11,14,"(-4.197703,-69.941278)"
2023,Mayo,Dinamarca,208,3,0,3,"(-4.223468,-69.945098)"
2018,Septiembre,Panamá,591,0,2,2,"(7.927209,-72.507910)"
2015,Noviembre,Bolivia,68,16,17,33,"(10.408582,-75.538003)"
2016,Diciembre,República Checa,203,0,2,2,"(-4.197703,-69.941278)"
2015,Diciembre,España,724,495,878,1373,"(3.541112,-76.384584)"
2021,Octubre,Eslovenia,705,2,3,5,"(6.171601,-75.427454)"
2018,Septiembre,Australia,36,13,9,22,"(8.635765,-77.346578)"
2017,Septiembre,Grecia,300,0,1,1,"(0.25129,-76.875963)"
2022,Octubre,Bangladesh,50,0,20,20,"(3.893038,-77.067921)"
2022,Abril,Guyana,328,0,1,1,"(10.408582,-75.538003)"
2022,Agosto,Ecuador,218,32,61,93,"(7.818934,-72.453226)"
2012,Julio,Venezuela,862,5,17,22,"(4.815061,-75.736532)"
2014,Agosto,Surinam,740,7,18,25,"(4.697144,-74.140516)"
2022,Marzo,Venezuela,862,14,7,21,"(4.452882,-75.766298)"
2016,Junio,Kazajistán,398,1,1,2,"(10.445761,-75.516429)"
2023,Junio,San Cristóbal y Nevis,659,4,0,4,"(10.445761,-75.516429)"
2012,Octubre,Países Bajos,528,0,1,1,"(12.5744111,-81.703935)"
2014,Agosto,Francia,250,0,1,1,"(11.247723,-74.213989)"
2018,Diciembre,Bélgica,56,4,12,16,"(10.886611,-74.776708)"
2013,Mayo,República Árabe Siria,760,0,1,1,"(4.697144,-74.140516)"
2022,Marzo,Países Bajos,528,2,4,6,"(7.128456,-73.183637)"
2021,Junio,Perú,604,42,34,76,"(10.445761,-75.516429)"
2014,Marzo,Eslovenia,705,0,1,1,"(4.815061,-75.736532)"
2013,Enero,Estados Unidos de América,840,1042,1812,2854,"(10.445761,-75.516429)"
2017,Agosto,República Checa,203,2,0,2,"(8.635765,-77.346578)"
2022,Noviembre,Suiza,756,6,4,10,"(8.635765,-77.346578)"
2016,Febrero,Perú,604,251,299,550,"(3.541112,-76.384584)"
2019,Febrero,República de Belarús,112,0,1,1,"(3.541112,-76.384584)"
2013,Diciembre,Japón,392,1,3,4,"(10.408582,-75.538003)"
2014,Febrero,Dinamarca,208,1,1,2,"(6.185799,-67.483929)"
2012,Junio,Rumania,642,0,2,2,"(0.814836,-77.662532)"
2012,Febrero,Estados Unidos de América,840,10,15,25,"(7.128456,-73.183637)"
2020,Noviembre,Chile,152,27,63,90,"(6.171601,-75.427454)"
2017,Septiembre,Noruega,578,2,3,5,"(3.541112,-76.384584)"
2016,Abril,Islas Fiji,242,0,1,1,"(4.697144,-74.140516)"
2019,Junio,Dominica,212,2,0,2,"(6.171601,-75.427454)"
2013,Febrero,San Cristóbal y Nevis,659,0,1,1,"(6.171601,-75.427454)"
2022,Noviembre,Pakistán,586,4,3,7,"(6.171601,-75.427454)"
2014,Octubre,Cuba,192,0,5,5,"(7.927209,-72.507910)"
2023,Mayo,Suiza,756,1,0,1,"(7.927209,-72.507910)"
2023,Abril,Nigeria,566,3,3,6,"(6.171601,-75.427454)"
2019,Marzo,Panamá,591,430,440,870,"(3.541112,-76.384584)"
2016,Febrero,Cabo Verde,132,0,1,1,"(10.408582,-75.538003)"
2023,Marzo,Islas Caimán/Territorio Británico de Ultramar,136,0,2,2,"(4.697144,-74.140516)"
2015,Julio,Nigeria,566,0,1,1,"(3.541112,-76.384584)"
2019,Febrero,Bermudas/Territorio Británico de Ultramar,60,0,2,2,"(6.171601,-75.427454)"
2021,Diciembre,Chile,152,1,2,3,"(-4.197703,-69.941278)"
2016,Febrero,Suecia,752,0,1,1,"(12.586067,-81.702563)"
2016,Abril,Rumania,642,3,2,5,"(3.541112,-76.384584)"
2017,Noviembre,Aruba,533,0,1,1,"(6.171601,-75.427454)"
2013,Septiembre,Kazajistán,398,0,2,2,"(0.814836,-77.662532)"
2018,Mayo,Andorra,20,1,7,8,"(4.697144,-74.140516)"
2014,Noviembre,Serbia,688,0,2,2,"(10.445761,-75.516429)"
2018,Julio,Palestina,99999,2,2,4,"(4.697144,-74.140516)"
2017,Diciembre,Países Bajos,528,0,3,3,"(-4.223468,-69.945098)"
2019,Junio,Cuba,192,198,319,517,"(4.697144,-74.140516)"
2014,Marzo,Malasia,458,0,1,1,"(9.402978,-75.681599)"
2018,Diciembre,Nicaragua,558,2,4,6,"(10.886611,-74.776708)"
2021,Noviembre,México,484,2,14,16,"(10.408582,-75.538003)"
2019,Junio,Paraguay,600,177,186,363,"(4.697144,-74.140516)"
2012,Febrero,Finlandia,246,0,1,1,"(11.360009,-72.129330)"
2020,Febrero,Israel,376,0,1,1,"(12.586067,-81.702563)"
2018,Septiembre,Perú,604,0,2,2,"(7.128456,-73.183637)"
2017,Marzo,Croacia,191,16,42,58,"(4.697144,-74.140516)"
2023,Enero,Ucrania,804,0,3,3,"(6.18189,-67.47535)"
2018,Enero,Suecia,752,5,3,8,"(8.635765,-77.346578)"
2022,Junio,Ghana,288,0,7,7,"(4.697144,-74.140516)"
2012,Noviembre,México,484,6,6,12,"(12.586067,-81.702563)"
2018,Noviembre,Bahamas,44,2,6,8,"(10.445761,-75.516429)"
2020,Febrero,Japón,392,0,1,1,"(12.586067,-81.702563)"
2022,Julio,Noruega,578,2,1,3,"(0.814836,-77.662532)"
2017,Enero,Países Bajos,528,6,12,18,"(-4.197703,-69.941278)"
2015,Junio,México,484,1,0,1,"(6.185799,-67.483929)"
2016,Septiembre,Dominica,212,1,2,3,"(3.541112,-76.384584)"
2015,Junio,Bélgica,56,1,1,2,"(12.586067,-81.702563)"
2015,Marzo,Israel,376,0,2,2,"(7.927209,-72.507910)"
2014,Febrero,Italia,380,0,7,7,"(-4.197703,-69.941278)"
2014,Febrero,Alemania,276,25,38,63,"(10.408582,-75.538003)"
2012,Septiembre,Antigua y Barbuda,28,0,1,1,"(10.445761,-75.516429)"
2014,Diciembre,Brasil,76,73,103,176,"(3.541112,-76.384584)"
2014,Diciembre,Indonesia,360,0,1,1,"(0.814836,-77.662532)"
2023,Marzo,Países Bajos,528,1433,1993,3426,"(4.697144,-74.140516)"
2018,Marzo,Refugiado,99999,0,1,1,"(0.814836,-77.662532)"
2017,Enero,Países Bajos,528,54,82,136,"(10.886611,-74.776708)"
2012,Septiembre,Reino Unido de Gran Bretaña e Irlanda del Norte,826,196,509,705,"(4.697144,-74.140516)"
2022,Enero,República Árabe Siria,760,1,1,2,"(6.171601,-75.427454)"
2014,Junio,El Salvador,222,46,11,57,"(10.445761,-75.516429)"
2012,Septiembre,Estados Unidos de América,840,697,2191,2888,"(6.171601,-75.427454)"
2012,Febrero,Perú,604,0,3,3,"(4.815061,-75.736532)"
2015,Marzo,Alemania,276,16,20,36,"(8.635765,-77.346578)"
2012,Julio,Guatemala,320,1,2,3,"(11.360009,-72.129330)"
2013,Octubre,Estados Unidos de América,840,216,394,610,"(10.886611,-74.776708)"
2013,Octubre,Islas Turcas y Caicos/Territorio Británico de Ultramar,796,1,1,2,"(4.697144,-74.140516)"
2021,Enero,Bélgica,56,7,23,30,"(6.171601,-75.427454)"
2014,Junio,Filipinas,608,0,8,8,"(10.886611,-74.776708)"
2023,Abril,China,156,325,822,1147,"(4.697144,-74.140516)"
2020,Noviembre,Ecuador,218,1,0,1,"(7.818934,-72.453226)"
2018,Septiembre,Hungría,348,1,2,3,"(10.408582,-75.538003)"
2022,Abril,China,156,0,3,3,"(0.814836,-77.662532)"
2014,Septiembre,Italia,380,0,1,1,"(7.088729,-70.740253)"
2015,Julio,Palestina,99999,2,1,3,"(4.697144,-74.140516)"
2018,Enero,Cuba,192,22,44,66,"(3.541112,-76.384584)"
2019,Julio,Filipinas,608,0,14,14,"(11.247723,-74.213989)"
2014,Septiembre,Turquía,792,1,0,1,"(-4.197703,-69.941278)"
2022,Mayo,Kazajistán,398,3,12,15,"(4.697144,-74.140516)"
2015,Enero,Haití,332,7,18,25,"(4.697144,-74.140516)"
2022,Agosto,Filipinas,608,0,147,147,"(3.893038,-77.067921)"
2015,Febrero,San  Vicente y las Granadinas,670,1,0,1,"(4.697144,-74.140516)"
2014,Enero,Suecia,752,8,20,28,"(10.445761,-75.516429)"
2019,Junio,Sri Lanka,144,0,1,1,"(0.814836,-77.662532)"
2017,Diciembre,Singapur,702,1,1,2,"(0.814836,-77.662532)"
2013,Mayo,Singapur,702,0,1,1,"(7.818934,-72.453226)"
2012,Mayo,Perú,604,129,285,414,"(0.814836,-77.662532)"
2013,Julio,Reino Unido de Gran Bretaña e Irlanda del Norte,826,26,52,78,"(10.445761,-75.516429)"
2017,Abril,Nicaragua,558,1,0,1,"(-4.197703,-69.941278)"
2019,Agosto,Honduras,340,59,55,114,"(10.445761,-75.516429)"
2014,Octubre,Honduras,340,0,3,3,"(13.3387613,-81.372937)"
2017,Enero,Israel,376,0,1,1,"(12.586067,-81.702563)"
2017,Julio,San  Vicente y las Granadinas,670,2,1,3,"(6.171601,-75.427454)"
2019,Junio,Bélgica,56,0,1,1,"(12.586067,-81.702563)"
2021,Diciembre,Guatemala,320,5,4,9,"(7.128456,-73.183637)"
2013,Noviembre,Lituania,440,0,1,1,"(10.445761,-75.516429)"
2021,Diciembre,Suecia,752,23,43,66,"(3.541112,-76.384584)"
2018,Noviembre,Canadá,124,2,0,2,"(-4.197703,-69.941278)"
2013,Diciembre,Perú,604,9,30,39,"(10.886611,-74.776708)"
2022,Octubre,Guatemala,320,0,1,1,"(10.971302,-74.765397)"
2014,Septiembre,Grecia,300,2,4,6,"(6.171601,-75.427454)"
2020,Febrero,Francia,250,59,117,177,"(3.541112,-76.384584)"
2015,Julio,Brasil,76,303,237,540,"(10.445761,-75.516429)"
2018,Septiembre,Uganda,800,1,0,1,"(6.171601,-75.427454)"
2017,Abril,Federación de Rusia,643,1,1,2,"(12.586067,-81.702563)"
2015,Diciembre,Ucrania,804,1,3,4,"(3.541112,-76.384584)"
2022,Enero,Egipto,818,1,3,4,"(6.171601,-75.427454)"
2017,Julio,Guyana,328,0,2,2,"(10.408582,-75.538003)"
2016,Marzo,Alemania,276,19,20,39,"(-4.197703,-69.941278)"
2014,Abril,Japón,392,19,20,39,"(0.814836,-77.662532)"
2015,Febrero,Desconocido,99999,0,1,1,"(7.128456,-73.183637)"
2022,Marzo,Cuba,192,0,2,2,"(7.128456,-73.183637)"
2015,Febrero,Haití,332,0,3,3,"(3.541112,-76.384584)"
2017,Octubre,Brasil,76,0,7,7,"(11.360009,-72.129330)"
2012,Julio,Guyana,328,0,1,1,"(10.445761,-75.516429)"
2013,Diciembre,República CentroÁfricana,140,0,1,1,"(3.541112,-76.384584)"
2021,Noviembre,Portugal,620,1,0,1,"(11.247723,-74.213989)"
2015,Junio,Polonia,616,0,8,8,"(10.971302,-74.765397)"
2019,Marzo,Tailandia,764,1,0,1,"(3.541112,-76.384584)"
2023,Enero,Brasil,76,20,26,46,"(0.814836,-77.662532)"
2013,Febrero,El Salvador,222,537,704,1241,"(4.697144,-74.140516)"
2018,Octubre,Francia,250,102,152,254,"(10.445761,-75.516429)"
2017,Mayo,Italia,380,14,15,29,"(10.408582,-75.538003)"
2013,Marzo,Territorio Antártico Británico/Territorio Británico de Ultramar,260,1,0,1,"(8.635765,-77.346578)"
2018,Marzo,Túnez,788,1,0,1,"(3.541112,-76.384584)"
2021,Julio,Sierra Leona,694,0,1,1,"(4.697144,-74.140516)"
2013,Octubre,Francia,250,4,9,13,"(10.886611,-74.776708)"
2020,Julio,Pakistán,586,0,1,1,"(4.697144,-74.140516)"
2014,Agosto,Ecuador,218,1,2,3,"(7.128456,-73.183637)"
2013,Junio,Nicaragua,558,48,60,108,"(4.697144,-74.140516)"
2013,Noviembre,España,724,6,5,11,"(12.586067,-81.702563)"
2019,Marzo,Antigua y Barbuda,28,0,1,1,"(4.697144,-74.140516)"
2016,Octubre,España,724,11,8,19,"(-4.197703,-69.941278)"
2016,Noviembre,Egipto,818,0,1,1,"(10.408582,-75.538003)"
2021,Abril,Filipinas,608,2,1,3,"(6.171601,-75.427454)"
2014,Abril,Nueva Zelanda,554,0,5,5,"(3.541112,-76.384584)"
2021,Octubre,Bahamas,44,22,10,32,"(3.541112,-76.384584)"
2015,Mayo,Guatemala,320,0,3,3,"(7.818934,-72.453226)"
2021,Septiembre,Ucrania,804,0,2,2,"(-4.197703,-69.941278)"
2016,Noviembre,Argentina,32,1,0,1,"(8.635765,-77.346578)"
2022,Abril,Liberia,430,0,2,2,"(4.697144,-74.140516)"
2012,Noviembre,Rumania,642,9,8,17,"(10.445761,-75.516429)"
2013,Julio,Guatemala,320,2,2,4,"(12.586067,-81.702563)"
2020,Enero,Chile,152,8,10,18,"(-4.223468,-69.945098)"
2022,Febrero,Benín,204,3,0,3,"(10.886611,-74.776708)"
2017,Mayo,Estonia,233,0,2,2,"(6.171601,-75.427454)"
2019,Junio,Guatemala,320,0,1,1,"(4.452882,-75.766298)"
2019,Febrero,Austria,40,15,17,32,"(10.445761,-75.516429)"
2018,Mayo,México,484,3,5,8,"(12.586067,-81.702563)"
2015,Julio,Indonesia,360,0,1,1,"(0.814836,-77.662532)"
2015,Octubre,Nepal,524,0,1,1,"(0.814836,-77.662532)"
2021,Junio,Arabia Saudita,682,1,6,7,"(4.697144,-74.140516)"
2017,Junio,Polonia,616,0,1,1,"(7.128456,-73.183637)"
2020,Febrero,Eslovenia,705,1,11,12,"(6.171601,-75.427454)"
2022,Mayo,República Dominicana,214,62,68,130,"(3.541112,-76.384584)"
2013,Septiembre,Argentina,32,194,139,333,"(12.586067,-81.702563)"
2012,Febrero,Venezuela,862,49,60,109,"(3.541112,-76.384584)"
2017,Noviembre,Ecuador,218,119,353,472,"(0.25129,-76.875963)"
2017,Abril,Finlandia,246,0,1,1,"(7.818934,-72.453226)"
2012,Abril,Reino Unido de Gran Bretaña e Irlanda del Norte,826,4,3,7,"(10.408582,-75.538003)"
2022,Mayo,Reino Unido de Gran Bretaña e Irlanda del Norte,826,0,1,1,"(3.893038,-77.067921)"
2018,Octubre,Reino Unido de Gran Bretaña e Irlanda del Norte,826,0,4,4,"(4.815061,-75.736532)"
2023,Febrero,Canadá,124,1,5,6,"(0.25129,-76.875963)"
2013,Septiembre,Albania,8,0,1,1,"(6.171601,-75.427454)"
2019,Diciembre,Bolivia,68,4,3,7,"(4.815061,-75.736532)"
2021,Julio,Bélgica,56,2,5,7,"(10.886611,-74.776708)"
2022,Agosto,Jamaica,388,0,1,1,"(7.128456,-73.183637)"
2020,Diciembre,Turquía,792,1,0,1,"(10.445761,-75.516429)"
2015,Febrero,China,156,6,10,16,"(6.171601,-75.427454)"
2012,Octubre,Sudáfrica,710,0,2,2,"(0.814836,-77.662532)"
2015,Noviembre,India,356,4,5,9,"(0.814836,-77.662532)"
2015,Diciembre,Eslovenia,705,20,29,49,"(4.697144,-74.140516)"
2012,Septiembre,Finlandia,246,0,1,1,"(1.813928,-78.763924)"
2019,Noviembre,Mauricio,480,1,3,4,"(4.697144,-74.140516)"
2017,Diciembre,Australia,36,0,2,2,"(7.818934,-72.453226)"
2014,Mayo,Hungría,348,1,1,2,"(10.408582,-75.538003)"
2012,Abril,Hungría,348,7,19,26,"(4.697144,-74.140516)"
2022,Julio,Arabia Saudita,682,1,1,2,"(10.445761,-75.516429)"
2017,Abril,Suiza,756,0,3,3,"(7.818934,-72.453226)"
2015,Mayo,Israel,376,15,77,92,"(6.171601,-75.427454)"
2014,Julio,Polonia,616,5,4,9,"(10.445761,-75.516429)"
2015,Junio,Guyana,328,6,6,12,"(4.697144,-74.140516)"
2022,Febrero,Marruecos,504,3,1,4,"(10.445761,-75.516429)"
2022,Mayo,Costa Rica,188,8,5,13,"(4.452882,-75.766298)"
2015,Noviembre,República de Irlanda,372,0,1,1,"(0.25129,-76.875963)"
2013,Junio,Reino Unido de Gran Bretaña e Irlanda del Norte,826,10,23,33,"(6.171601,-75.427454)"
2017,Noviembre,El Salvador,222,0,1,1,"(10.408582,-75.538003)"
2012,Septiembre,Suecia,752,2,3,5,"(3.541112,-76.384584)"
2015,Junio,Nicaragua,558,1,2,3,"(10.886611,-74.776708)"
2020,Enero,Taiwán,158,67,70,137,"(4.697144,-74.140516)"
2014,Mayo,Letonia,428,9,8,17,"(4.697144,-74.140516)"
2016,Enero,Dominica,212,1,2,3,"(4.697144,-74.140516)"
2018,Julio,Desconocido,99999,1,3,4,"(10.445761,-75.516429)"
2017,Abril,Alemania,276,5,9,14,"(-4.197703,-69.941278)"
2017,Marzo,República Dominicana,214,19,25,44,"(4.815061,-75.736532)"
2017,Enero,Brasil,76,206,256,462,"(6.171601,-75.427454)"
2014,Mayo,Hungría,348,0,1,1,"(10.445761,-75.516429)"
2015,Noviembre,Kirguistán,417,2,6,8,"(4.697144,-74.140516)"
2020,Febrero,Polonia,616,5,1,6,"(8.635765,-77.346578)"
2019,Abril,Macedonia,807,0,1,1,"(6.171601,-75.427454)"
2019,Septiembre,Grecia,300,2,8,10,"(10.445761,-75.516429)"
2012,Diciembre,Panamá,591,1,0,1,"(0.25129,-76.875963)"
2012,Febrero,Pakistán,586,0,1,1,"(0.814836,-77.662532)"
2017,Abril,Reino Unido de Gran Bretaña e Irlanda del Norte,826,1,0,1,"(12.5744111,-81.703935)"
2012,Junio,República Árabe Siria,760,0,1,1,"(11.360009,-72.129330)"
2013,Septiembre,República de Belarús,112,0,3,3,"(4.697144,-74.140516)"
2016,Marzo,Dominica,212,1,2,3,"(4.697144,-74.140516)"
2014,Mayo,Japón,392,0,2,2,"(11.360009,-72.129330)"
2015,Junio,México,484,36,60,96,"(10.886611,-74.776708)"
2023,Enero,Francia,250,16,25,41,"(4.815061,-75.736532)"
2016,Enero,México,484,38,47,85,"(0.814836,-77.662532)"
2014,Noviembre,Francia,250,1,1,2,"(7.128456,-73.183637)"
2018,Junio,Francia,250,1,1,2,"(13.3387613,-81.372937)"
2022,Agosto,Filipinas,608,1,19,20,"(10.971302,-74.765397)"
2012,Julio,España,724,3,14,17,"(10.445761,-75.516429)"
2013,Febrero,Suiza,756,3,7,10,"(11.360009,-72.129330)"
2014,Diciembre,Países Bajos,528,1,2,3,"(12.586067,-81.702563)"
2019,Agosto,Filipinas,608,3,4,7,"(6.171601,-75.427454)"
2013,Diciembre,Eslovenia,705,1,1,2,"(0.814836,-77.662532)"
2018,Mayo,Bahamas,44,0,3,3,"(10.886611,-74.776708)"
2017,Julio,Federación de Rusia,643,0,1,1,"(-4.223468,-69.945098)"
2023,Febrero,Grecia,300,1,8,9,"(10.408582,-75.538003)"
2016,Noviembre,Mónaco,492,0,2,2,"(4.697144,-74.140516)"
2016,Marzo,Argentina,32,0,4,4,"(7.128456,-73.183637)"
2018,Junio,Desconocido,99999,97,165,262,"(4.697144,-74.140516)"
2013,Septiembre,Isla de Man,833,4,14,18,"(3.541112,-76.384584)"
2020,Febrero,Jamaica,388,0,1,1,"(10.408582,-75.538003)"
2017,Mayo,República Dominicana,214,13,30,43,"(10.886611,-74.776708)"
2018,Febrero,Georgia,268,0,1,1,"(10.408582,-75.538003)"
2018,Julio,Ecuador,218,59,104,163,"(6.171601,-75.427454)"
2018,Noviembre,Perú,604,254,182,436,"(12.586067,-81.702563)"
2021,Septiembre,Chile,152,1334,1868,3202,"(4.697144,-74.140516)"
2014,Enero,Países Bajos,528,1,3,4,"(10.445761,-75.516429)"
2022,Abril,El Salvador,222,128,119,247,"(10.445761,-75.516429)"
2021,Junio,República Dominicana,214,3,7,10,"(7.128456,-73.183637)"
2021,Diciembre,Montenegro,499,0,3,3,"(10.445761,-75.516429)"
2012,Enero,Ucrania,804,0,1,1,"(3.541112,-76.384584)"
2012,Julio,Costa Rica,188,2,0,2,"(7.927209,-72.507910)"
2022,Septiembre,Alemania,276,0,2,2,"(11.360009,-72.129330)"
2021,Octubre,Kazajistán,398,1,0,1,"(3.541112,-76.384584)"
2012,Marzo,Eslovaquia,703,1,0,1,"(0.814836,-77.662532)"
2022,Abril,Guatemala,320,0,1,1,"(10.408582,-75.538003)"
2018,Mayo,Bahamas,44,2,1,3,"(3.541112,-76.384584)"
2020,Enero,Bélgica,56,38,72,110,"(6.171601,-75.427454)"
2012,Julio,Francia,250,5,4,9,"(11.247723,-74.213989)"
2021,Octubre,Surinam,740,14,8,22,"(4.697144,-74.140516)"
2017,Febrero,Canadá,124,1,8,9,"(8.635765,-77.346578)"
2013,Abril,Irán,364,1,10,11,"(4.697144,-74.140516)"
2016,Junio,Bolivia,68,31,41,72,"(3.541112,-76.384584)"
2023,Febrero,Perú,604,4,11,15,"(7.088729,-70.740253)"
2012,Marzo,Brasil,76,34,106,140,"(6.171601,-75.427454)"
2022,Abril,Suecia,752,0,2,2,"(11.247723,-74.213989)"
2013,Julio,Guatemala,320,77,183,260,"(6.171601,-75.427454)"
2017,Diciembre,Suecia,752,10,15,25,"(10.886611,-74.776708)"
2022,Febrero,Francia,250,148,221,369,"(10.445761,-75.516429)"
2022,Julio,Federación de Rusia,643,2,1,3,"(11.117806,-74.232622)"
2015,Diciembre,Polonia,616,114,140,254,"(4.697144,-74.140516)"
2022,Julio,Países Bajos,528,0,2,2,"(12.586067,-81.702563)"
2022,Junio,El Salvador,222,32,43,75,"(3.541112,-76.384584)"
2016,Febrero,Uruguay,858,4,10,14,"(0.814836,-77.662532)"
2014,Abril,Lituania,440,1,0,1,"(6.171601,-75.427454)"
2022,Octubre,Dominica,212,0,2,2,"(0.814836,-77.662532)"
2020,Diciembre,Canadá,124,31,77,108,"(10.445761,-75.516429)"
2021,Julio,Indonesia,360,1,0,1,"(6.171601,-75.427454)"
2015,Abril,República Dominicana,214,288,391,679,"(4.697144,-74.140516)"
2014,Noviembre,Pakistán,586,1,1,2,"(10.445761,-75.516429)"
2016,Diciembre,Austria,40,2,2,4,"(-4.197703,-69.941278)"
2013,Enero,Singapur,702,1,0,1,"(7.128456,-73.183637)"
2022,Octubre,España,724,40,69,109,"(7.818934,-72.453226)"
2017,Agosto,Costa Rica,188,54,34,88,"(12.586067,-81.702563)"
2012,Septiembre,Ecuador,218,0,3,3,"(3.893038,-77.067921)"
2015,Enero,Dinamarca,208,0,1,1,"(10.886611,-74.776708)"
2022,Septiembre,Trinidad y Tobago,780,0,2,2,"(10.886611,-74.776708)"
2015,Octubre,Paraguay,600,42,24,66,"(10.445761,-75.516429)"
2019,Enero,México,484,26,38,64,"(0.814836,-77.662532)"
2015,Diciembre,Uruguay,858,0,1,1,"(8.635765,-77.346578)"
2013,Diciembre,Lituania,440,0,3,3,"(10.971302,-74.765397)"
2016,Enero,Italia,380,1,3,4,"(0.25129,-76.875963)"
2016,Septiembre,Venezuela,862,5520,5448,10968,"(7.088729,-70.740253)"
2022,Septiembre,Estados Unidos de América,840,0,5,5,"(6.17134,-75.427194)"
2013,Marzo,Países Bajos,528,14,19,33,"(0.814836,-77.662532)"
2023,Marzo,Costa Rica,188,938,773,1711,"(10.445761,-75.516429)"
2012,Enero,Panamá,591,6,7,13,"(8.635765,-77.346578)"
2016,Febrero,Grecia,300,2,3,5,"(3.541112,-76.384584)"
2012,Agosto,Ecuador,218,196,217,413,"(7.818934,-72.453226)"
2017,Febrero,Estados Unidos de América,840,2,0,2,"(11.360009,-72.129330)"
2018,Junio,Sudáfrica,710,1,2,3,"(6.171601,-75.427454)"
2019,Diciembre,Ucrania,804,1,11,12,"(10.886611,-74.776708)"
2017,Diciembre,Reino Unido de Gran Bretaña e Irlanda del Norte,826,1,10,11,"(12.586067,-81.702563)"
2012,Septiembre,Taiwán,158,3,2,5,"(10.445761,-75.516429)"
2016,Mayo,Chipre,196,0,1,1,"(10.886611,-74.776708)"
2015,Diciembre,Países Bajos,528,1,1,2,"(12.5744111,-81.703935)"
2020,Marzo,Australia,36,0,1,1,"(4.452882,-75.766298)"
2021,Mayo,Bolivia,68,7,11,18,"(6.171601,-75.427454)"
2012,Febrero,Federación de Rusia,643,0,1,1,"(-4.197703,-69.941278)"
2016,Agosto,Chile,152,46,57,103,"(0.814836,-77.662532)"
2017,Mayo,Trinidad y Tobago,780,3,11,14,"(6.171601,-75.427454)"
2022,Diciembre,Sudáfrica,710,0,1,1,"(10.886611,-74.776708)"
2014,Octubre,Japón,392,4,7,11,"(10.445761,-75.516429)"
2018,Julio,Chile,152,0,1,1,"(8.635765,-77.346578)"
2016,Febrero,Serbia,688,8,13,21,"(4.697144,-74.140516)"
2022,Septiembre,China,156,0,5,5,"(0.814836,-77.662532)"
2015,Febrero,Noruega,578,0,3,3,"(0.814836,-77.662532)"
2012,Febrero,Líbano,422,0,1,1,"(3.541112,-76.384584)"
2014,Febrero,Rumania,642,31,40,71,"(4.697144,-74.140516)"
2018,Noviembre,Francia,250,0,1,1,"(9.402978,-75.681599)"
2013,Julio,Granada,308,1,3,4,"(4.697144,-74.140516)"
2016,Febrero,Rumania,642,0,2,2,"(3.893038,-77.067921)"
2019,Mayo,Filipinas,608,1,20,21,"(3.541112,-76.384584)"
2015,Abril,Canadá,124,9,6,15,"(8.635765,-77.346578)"
2016,Julio,Nepal,524,1,2,3,"(4.697144,-74.140516)"
2017,Junio,Venezuela,862,140,177,317,"(7.088729,-70.740253)"
2016,Enero,Honduras,340,6,2,8,"(0.814836,-77.662532)"
2013,Febrero,Ecuador,218,79,130,209,"(7.818934,-72.453226)"
2023,Marzo,Trinidad y Tobago,780,0,1,1,"(12.586067,-81.702563)"
2021,Agosto,Arabia Saudita,682,0,6,6,"(4.697144,-74.140516)"
2017,Diciembre,Japón,392,0,3,3,"(10.886611,-74.776708)"
2014,Julio,Canadá,124,69,104,173,"(10.445761,-75.516429)"
2016,Junio,Perú,604,0,3,3,"(7.128456,-73.183637)"
2013,Marzo,Indonesia,360,0,2,2,"(7.818934,-72.453226)"
2014,Enero,Ecuador,218,114,187,301,"(7.818934,-72.453226)"
2019,Marzo,Noruega,578,7,20,27,"(6.171601,-75.427454)"
2021,Octubre,Israel,376,21,44,65,"(10.445761,-75.516429)"
2021,Junio,Eslovaquia,703,2,0,2,"(10.445761,-75.516429)"
2022,Abril,Chile,152,0,5,5,"(10.408582,-75.538003)"
2015,Julio,Barbados,52,12,20,32,"(4.697144,-74.140516)"
2013,Abril,Portugal,620,2,8,10,"(10.445761,-75.516429)"
2016,Febrero,Japón,392,7,6,13,"(10.445761,-75.516429)"
2017,Abril,Rumania,642,0,1,1,"(12.586067,-81.702563)"
2015,Marzo,Italia,380,9,28,37,"(10.408582,-75.538003)"
2019,Agosto,Angola,24,0,1,1,"(6.171601,-75.427454)"
2017,Noviembre,Vietnam,704,7,3,10,"(4.697144,-74.140516)"
2022,Octubre,Italia,380,93,233,326,"(6.171601,-75.427454)"
2017,Enero,Kirguistán,417,0,1,1,"(4.697144,-74.140516)"
2015,Diciembre,República Checa,203,1,0,1,"(10.886611,-74.776708)"
2017,Mayo,Singapur,702,2,1,3,"(6.171601,-75.427454)"
2018,Abril,Ecuador,218,25,26,51,"(1.813928,-78.763924)"
2022,Mayo,Bahamas,44,2,10,12,"(6.171601,-75.427454)"
2023,Febrero,Antigua y Barbuda,28,1,0,1,"(10.445761,-75.516429)"
2012,Noviembre,Taiwán,158,2,1,3,"(4.697144,-74.140516)"
2019,Abril,Ecuador,218,48,59,107,"(7.818934,-72.453226)"
2014,Julio,República de Irlanda,372,126,185,311,"(4.697144,-74.140516)"
2015,Agosto,Bulgaria,100,2,2,4,"(6.171601,-75.427454)"
2020,Septiembre,Venezuela,862,2,2,4,"(3.866713,-67.927521)"
2018,Marzo,Líbano,422,2,0,2,"(11.360009,-72.129330)"
2021,Septiembre,Marruecos,504,0,1,1,"(6.171601,-75.427454)"
2018,Julio,Francia,250,44,61,105,"(10.886611,-74.776708)"
2019,Marzo,Canadá,124,115,134,249,"(3.541112,-76.384584)"
2019,Diciembre,Camboya,116,1,2,4,"(4.697144,-74.140516)"
2021,Junio,Estados Unidos de América,840,3193,5401,8594,"(10.445761,-75.516429)"
2014,Agosto,Rumania,642,1,1,2,"(10.445761,-75.516429)"
2012,Noviembre,Haití,332,0,1,1,"(7.818934,-72.453226)"
2016,Julio,Etiopia,231,3,3,6,"(4.697144,-74.140516)"
2019,Diciembre,Croacia,191,4,3,7,"(3.541112,-76.384584)"
2013,Agosto,Paraguay,600,7,8,15,"(3.541112,-76.384584)"
2017,Abril,Italia,380,2,6,8,"(-4.223468,-69.945098)"
2018,Noviembre,Ucrania,804,0,2,2,"(3.893038,-77.067921)"
2018,Mayo,Vietnam,704,0,1,1,"(3.541112,-76.384584)"
2022,Febrero,Reino Unido de Gran Bretaña e Irlanda del Norte,826,2,1,3,"(4.452882,-75.766298)"
2021,Agosto,Cuba,192,11,13,24,"(10.445761,-75.516429)"
2013,Agosto,Malasia,458,10,17,27,"(4.697144,-74.140516)"
2015,Septiembre,Arabia Saudita,682,1,6,7,"(6.171601,-75.427454)"
2023,Marzo,República Árabe Siria,760,0,4,4,"(4.697144,-74.140516)"
2015,Noviembre,Canadá,124,16,38,54,"(10.886611,-74.776708)"
2019,Enero,Costa Rica,188,81,82,163,"(12.586067,-81.702563)"
2014,Julio,Israel,376,2,46,48,"(6.171601,-75.427454)"
2019,Febrero,Dinamarca,208,0,2,2,"(-4.223468,-69.945098)"
2014,Marzo,Reino Unido de Gran Bretaña e Irlanda del Norte,826,13,18,31,"(-4.197703,-69.941278)"
2013,Mayo,Japón,392,0,8,8,"(10.886611,-74.776708)"
2018,Julio,Suiza,756,9,8,17,"(10.886611,-74.776708)"
2022,Agosto,Países Bajos,528,0,3,3,"(11.360009,-72.129330)"
2016,Mayo,República Dominicana,214,7,3,10,"(12.586067,-81.702563)"
2017,Noviembre,Suecia,752,3,1,4,"(8.635765,-77.346578)"
2017,Abril,Myanmar,104,0,6,6,"(10.445761,-75.516429)"
2013,Diciembre,Francia,250,3,4,7,"(4.815061,-75.736532)"
2022,Junio,Rumania,642,0,10,10,"(10.408582,-75.538003)"
2021,Marzo,Italia,380,137,378,515,"(4.697144,-74.140516)"
2023,Enero,Grecia,300,0,5,5,"(10.408582,-75.538003)"
2018,Enero,India,356,12,43,55,"(10.445761,-75.516429)"
2013,Junio,Lituania,440,2,0,2,"(6.171601,-75.427454)"
2021,Febrero,Bahamas,44,1,4,5,"(3.541112,-76.384584)"
2019,Noviembre,Costa Rica,188,228,262,490,"(6.171601,-75.427454)"
2015,Febrero,Costa Rica,188,2,7,9,"(7.818934,-72.453226)"
2018,Diciembre,Canadá,124,2,2,4,"(13.3387613,-81.372937)"
2021,Septiembre,Filipinas,608,0,28,28,"(11.247723,-74.213989)"
2014,Febrero,Vietnam,704,6,14,20,"(4.697144,-74.140516)"
2017,Febrero,Bélgica,56,29,46,75,"(6.171601,-75.427454)"
2020,Enero,Austria,40,1,4,5,"(-4.223468,-69.945098)"
2018,Noviembre,Liberia,430,0,1,1,"(10.445761,-75.516429)"
2017,Mayo,Reino Unido de Gran Bretaña e Irlanda del Norte,826,19,38,57,"(10.408582,-75.538003)"
2012,Noviembre,República de Armenia,51,1,1,2,"(4.697144,-74.140516)"
2016,Septiembre,República Dominicana,214,23,54,77,"(10.886611,-74.776708)"
2017,Enero,Paraguay,600,2,1,3,"(4.815061,-75.736532)"
2018,Octubre,Bolivia,68,0,1,1,"(11.360009,-72.129330)"
2023,Marzo,Brasil,76,5,14,19,"(4.815061,-75.736532)"
2022,Septiembre,Dominica,212,1,0,1,"(7.818934,-72.453226)"
2023,Abril,Brasil,76,2,6,8,"(8.364293,-72.405710)"
2017,Septiembre,Hong Kong,344,1,0,1,"(10.445761,-75.516429)"
2015,Diciembre,Bosnia y Herzegovina,70,1,0,1,"(6.171601,-75.427454)"
2014,Agosto,Bolivia,68,2,0,2,"(7.927209,-72.507910)"
2013,Mayo,Estados Unidos de América,840,1,1,2,"(6.185799,-67.483929)"
2015,Marzo,Brasil,76,0,1,1,"(7.088729,-70.740253)"
2014,Octubre,Polonia,616,1,3,4,"(11.360009,-72.129330)"
2015,Abril,Rumania,642,4,7,11,"(6.171601,-75.427454)"
2023,Mayo,San Cristóbal y Nevis,659,1,7,8,"(4.697144,-74.140516)"
2023,Junio,Bolivia,68,10,9,19,"(12.586067,-81.702563)"
2020,Junio,Nicaragua,558,1,0,1,"(12.586067,-81.702563)"
2018,Septiembre,China,156,0,4,4,"(11.360009,-72.129330)"
2017,Febrero,Jordania,400,2,5,7,"(4.697144,-74.140516)"
2019,Enero,Israel,376,12,81,93,"(6.171601,-75.427454)"
2013,Diciembre,Federación de Rusia,643,0,1,1,"(10.971302,-74.765397)"
2018,Marzo,Chile,152,2,6,8,"(8.36068,-72.409396)"
2018,Julio,Francia,250,4,6,10,"(8.635765,-77.346578)"
2014,Marzo,Dinamarca,208,0,4,4,"(11.247723,-74.213989)"
2012,Septiembre,Trinidad y Tobago,780,2,3,5,"(10.886611,-74.776708)"
2013,Febrero,República Dominicana,214,3,5,8,"(4.815061,-75.736532)"
2021,Febrero,Eslovenia,705,2,11,13,"(4.697144,-74.140516)"
2013,Diciembre,Canadá,124,211,327,538,"(6.171601,-75.427454)"
2017,Febrero,China,156,1,0,1,"(11.360009,-72.129330)"
2021,Febrero,Croacia,191,4,21,25,"(4.697144,-74.140516)"
2018,Abril,Bélgica,56,1,3,4,"(13.3387613,-81.372937)"
2014,Octubre,Guinea,324,1,1,2,"(4.697144,-74.140516)"
2016,Septiembre,Italia,380,0,1,1,"(10.971302,-74.765397)"
2012,Octubre,Nigeria,566,1,1,2,"(10.445761,-75.516429)"
2017,Junio,Bahamas,44,1,0,1,"(3.541112,-76.384584)"
2020,Enero,Portugal,620,0,2,2,"(4.815061,-75.736532)"
2017,Diciembre,Japón,392,2,2,4,"(7.818934,-72.453226)"
2015,Agosto,Polonia,616,0,1,1,"(7.128456,-73.183637)"
2015,Marzo,Estados Unidos de América,840,7,6,13,"(11.360009,-72.129330)"
2017,Abril,República Dominicana,214,16,16,32,"(4.815061,-75.736532)"
2014,Noviembre,Myanmar,104,1,2,3,"(4.697144,-74.140516)"
2017,Abril,China,156,0,1,1,"(-4.197703,-69.941278)"
2014,Agosto,República Dominicana,214,4,7,11,"(0.814836,-77.662532)"
2014,Abril,México,484,66,130,196,"(3.541112,-76.384584)"
2021,Febrero,Polonia,616,36,81,117,"(4.697144,-74.140516)"
2016,Junio,Brasil,76,105,200,305,"(6.171601,-75.427454)"
2019,Junio,Jordania,400,0,1,1,"(10.445761,-75.516429)"
2013,Marzo,Australia,36,7,13,20,"(10.408582,-75.538003)"
2016,Noviembre,República Dominicana,214,0,1,1,"(-4.197703,-69.941278)"
2021,Agosto,Croacia,191,0,7,7,"(10.445761,-75.516429)"
2019,Diciembre,Suiza,756,715,1160,1875,"(4.697144,-74.140516)"
2015,Febrero,Francia,250,4,9,13,"(-4.197703,-69.941278)"
2021,Mayo,Países Bajos,528,2,3,5,"(7.128456,-73.183637)"
2017,Abril,Israel,376,640,1236,1876,"(4.697144,-74.140516)"
2015,Enero,Suecia,752,7,14,21,"(3.541112,-76.384584)"
2015,Diciembre,Panamá,591,0,1,1,"(1.813928,-78.763924)"
2014,Noviembre,Hungría,348,1,3,4,"(10.445761,-75.516429)"
2015,Abril,República Dominicana,214,1,0,1,"(7.102626,-77.762647)"
2020,Marzo,Bolivia,68,3,6,9,"(0.814836,-77.662532)"
2015,Noviembre,Egipto,818,1,1,2,"(10.445761,-75.516429)"
2014,Mayo,Guyana,328,0,1,1,"(8.635765,-77.346578)"
2023,Marzo,Turquía,792,0,8,8,"(10.886611,-74.776708)"
2015,Marzo,Japón,392,4,6,10,"(7.818934,-72.453226)"
2012,Diciembre,Albania,8,1,1,2,"(10.445761,-75.516429)"
2019,Febrero,Haití,332,1,1,2,"(3.541112,-76.384584)"
2015,Mayo,República de Corea,410,1,1,2,"(12.586067,-81.702563)"
2012,Enero,India,356,0,1,1,"(12.586067,-81.702563)"
2022,Octubre,India,356,0,4,4,"(10.971302,-74.765397)"
2013,Marzo,Ecuador,218,318,350,668,"(3.541112,-76.384584)"
2015,Abril,Ecuador,218,2,3,5,"(7.927209,-72.507910)"
2018,Mayo,Dominica,212,2,0,2,"(4.697144,-74.140516)"
2022,Agosto,Paraguay,600,240,211,451,"(4.697144,-74.140516)"
2023,Enero,República Dominicana,214,4,4,8,"(7.818934,-72.453226)"
2017,Junio,Ecuador,218,0,5,5,"(-4.197703,-69.941278)"
2014,Enero,Qatar,634,0,1,1,"(6.171601,-75.427454)"
2013,Septiembre,Brasil,76,0,1,1,"(7.927209,-72.507910)"
2014,Enero,Portugal,620,4,24,28,"(6.171601,-75.427454)"
2018,Marzo,Lituania,440,1,1,2,"(0.25129,-76.875963)"
2016,Agosto,República de Corea,410,0,2,2,"(10.971302,-74.765397)"
2023,Febrero,Chile,152,35,35,70,"(7.818934,-72.453226)"
2017,Mayo,Hungría,348,1,1,2,"(6.171601,-75.427454)"
2013,Mayo,Estados Unidos de América,840,0,2,2,"(11.528919,-72.919681)"
2021,Junio,Venezuela,862,0,1,1,"(12.586067,-81.702563)"
2018,Diciembre,Ucrania,804,0,2,2,"(9.402978,-75.681599)"
2022,Marzo,Nigeria,566,1,8,9,"(6.171601,-75.427454)"
2012,Mayo,Suecia,752,1,1,2,"(10.445761,-75.516429)"
2014,Junio,Desconocido,99999,0,2,2,"(6.171601,-75.427454)"
2022,Marzo,Panamá,591,6,8,14,"(12.586067,-81.702563)"
2021,Noviembre,Perú,604,103,172,275,"(3.541112,-76.384584)"
2012,Marzo,Dinamarca,208,0,5,5,"(10.886611,-74.776708)"
2019,Enero,Ucrania,804,1,4,5,"(3.541112,-76.384584)"
2016,Junio,Brasil,76,1,0,1,"(-0.193180,-74.784874)"
2021,Marzo,España,724,88,181,269,"(6.171601,-75.427454)"
2018,Marzo,Brasil,76,59,69,128,"(-4.197703,-69.941278)"
2019,Julio,Nicaragua,558,2,3,5,"(4.815061,-75.736532)"
2015,Septiembre,Hungría,348,20,43,63,"(4.697144,-74.140516)"
2020,Enero,Chile,152,20,26,46,"(7.818934,-72.453226)"
2018,Abril,Países Bajos,528,0,3,3,"(8.36068,-72.409396)"
2017,Diciembre,Turquía,792,0,4,4,"(3.541112,-76.384584)"
2016,Septiembre,Togo,768,0,1,1,"(4.697144,-74.140516)"
2020,Diciembre,Grecia,300,0,1,1,"(7.128456,-73.183637)"
2013,Octubre,Nueva Zelanda,554,27,49,76,"(4.697144,-74.140516)"
2015,Diciembre,Francia,250,130,243,373,"(6.171601,-75.427454)"
2014,Julio,Filipinas,608,0,34,34,"(3.893038,-77.067921)"
2012,Mayo,España,724,1,1,2,"(7.128456,-73.183637)"
2021,Agosto,Ucrania,804,1,6,7,"(3.541112,-76.384584)"
2016,Septiembre,Honduras,340,0,3,3,"(12.5744111,-81.703935)"
2022,Octubre,Islandia,352,1,0,1,"(0.814836,-77.662532)"
2019,Febrero,Polonia,616,0,1,1,"(9.402978,-75.681599)"
2016,Abril,Santa Lucia,662,1,1,2,"(10.445761,-75.516429)"
2012,Enero,Italia,380,1,3,4,"(11.247723,-74.213989)"
2017,Julio,Guatemala,320,20,62,82,"(3.541112,-76.384584)"
2016,Septiembre,España,724,7,8,15,"(12.586067,-81.702563)"
2018,Julio,Nueva Zelanda,554,3,2,5,"(3.541112,-76.384584)"
2015,Noviembre,China,156,1,4,5,"(0.814836,-77.662532)"
2017,Diciembre,República de Corea,410,20,29,49,"(6.171601,-75.427454)"
2022,Noviembre,Jordania,400,2,6,8,"(4.697144,-74.140516)"
2019,Marzo,Rumania,642,4,3,7,"(3.541112,-76.384584)"
2016,Febrero,Indonesia,360,2,1,3,"(3.541112,-76.384584)"
2022,Julio,Luxemburgo,442,7,16,23,"(4.697144,-74.140516)"
2013,Octubre,Malasia,458,0,1,1,"(3.541112,-76.384584)"
2018,Agosto,Brasil,76,16,35,51,"(10.886611,-74.776708)"
2021,Mayo,Croacia,191,0,2,2,"(10.445761,-75.516429)"
2023,Junio,Canadá,124,2,4,6,"(7.916725,-72.462544)"
2022,Marzo,Ecuador,218,20,24,44,"(10.886611,-74.776708)"
2019,Enero,Desconocido,99999,1,0,1,"(0.25129,-76.875963)"
2013,Marzo,España,724,17,61,78,"(3.541112,-76.384584)"
2014,Abril,Chile,152,0,1,1,"(7.088729,-70.740253)"
2022,Junio,Bolivia,68,1,0,1,"(12.586067,-81.702563)"
2012,Abril,Australia,36,12,7,19,"(-4.197703,-69.941278)"
2012,Noviembre,Filipinas,608,3,6,9,"(10.445761,-75.516429)"
2017,Noviembre,Croacia,191,21,60,81,"(4.697144,-74.140516)"
2018,Noviembre,Aruba,533,0,1,1,"(4.697144,-74.140516)"
2013,Octubre,Argentina,32,895,587,1482,"(10.445761,-75.516429)"
2023,Febrero,Francia,250,0,1,1,"(8.36068,-72.409396)"
2013,Abril,Austria,40,1,1,2,"(8.635765,-77.346578)"
2013,Junio,Brasil,76,11,11,22,"(11.360009,-72.129330)"
2017,Junio,República de Irlanda,372,8,5,13,"(8.635765,-77.346578)"
2013,Septiembre,Países Bajos,528,0,4,4,"(11.247723,-74.213989)"
2013,Octubre,Myanmar,104,0,3,3,"(4.697144,-74.140516)"
2013,Marzo,España,724,0,3,3,"(7.927209,-72.507910)"
2022,Diciembre,China,156,0,28,28,"(3.893038,-77.067921)"
2018,Mayo,Suiza,756,27,18,45,"(10.408582,-75.538003)"
2013,Noviembre,Ecuador,218,15,11,26,"(11.360009,-72.129330)"
2019,Junio,Costa Rica,188,161,122,283,"(10.445761,-75.516429)"
2012,Septiembre,Qatar,634,0,1,1,"(6.171601,-75.427454)"
2015,Abril,España,724,98,317,415,"(6.171601,-75.427454)"
2019,Septiembre,Nicaragua,558,4,2,6,"(12.586067,-81.702563)"
2018,Noviembre,Estados Unidos de América,840,8,15,23,"(7.818934,-72.453226)"
2022,Diciembre,Guatemala,320,7,3,10,"(4.815061,-75.736532)"
2022,Octubre,Letonia,428,0,3,3,"(10.408582,-75.538003)"
2023,Enero,Tailandia,764,4,0,4,"(10.445761,-75.516429)"
2012,Abril,Honduras,340,0,1,1,"(12.586067,-81.702563)"
2014,Marzo,Mongolia,496,1,0,1,"(4.697144,-74.140516)"
2018,Diciembre,Grecia,300,0,3,3,"(10.408582,-75.538003)"
2022,Noviembre,República Del Congo,178,1,2,3,"(4.697144,-74.140516)"
2015,Diciembre,Noruega,578,13,13,26,"(3.541112,-76.384584)"
2021,Mayo,Nicaragua,558,4,6,10,"(3.541112,-76.384584)"
2016,Octubre,El Salvador,222,0,2,2,"(7.088729,-70.740253)"
2021,Noviembre,Jordania,400,1,1,2,"(6.171601,-75.427454)"
2023,Enero,México,484,6,5,11,"(7.088729,-70.740253)"
2018,Octubre,Malasia,458,4,9,13,"(10.445761,-75.516429)"
2013,Enero,Reino Unido de Gran Bretaña e Irlanda del Norte,826,3,2,5,"(-4.197703,-69.941278)"
2013,Diciembre,Bélgica,56,1,9,10,"(11.247723,-74.213989)"
2020,Abril,Perú,604,0,4,4,"(10.886611,-74.776708)"
2017,Agosto,Ghana,288,0,4,4,"(4.697144,-74.140516)"
2017,Diciembre,Jamaica,388,3,2,5,"(6.171601,-75.427454)"
2022,Octubre,Finlandia,246,10,20,30,"(6.171601,-75.427454)"
2018,Diciembre,Federación de Rusia,643,0,1,1,"(10.971302,-74.765397)"
2014,Octubre,República Dominicana,214,3,3,6,"(4.815061,-75.736532)"
2018,Noviembre,Zimbabue,716,0,1,1,"(6.171601,-75.427454)"
2014,Mayo,Grecia,300,0,1,1,"(7.927209,-72.507910)"
2019,Diciembre,India,356,0,3,3,"(4.815061,-75.736532)"
2017,Octubre,Estados Unidos de América,840,9,20,29,"(-4.197703,-69.941278)"
2014,Noviembre,Australia,36,0,2,2,"(12.586067,-81.702563)"
2023,Abril,Portugal,620,3,4,7,"(12.586067,-81.702563)"
2017,Marzo,Paraguay,600,3,2,5,"(4.815061,-75.736532)"
2019,Julio,Israel,376,0,1,1,"(8.635765,-77.346578)"
2019,Octubre,Argentina,32,3,1,4,"(7.128456,-73.183637)"
2021,Enero,Belice,84,0,3,3,"(4.697144,-74.140516)"
2012,Julio,Paraguay,600,7,3,10,"(6.171601,-75.427454)"
2016,Diciembre,Islandia,352,0,2,2,"(6.171601,-75.427454)"
2021,Enero,Polonia,616,34,96,130,"(4.697144,-74.140516)"
2019,Marzo,Ucrania,804,0,1,1,"(11.247723,-74.213989)"
2013,Septiembre,Japón,392,2,1,3,"(7.128456,-73.183637)"
2015,Septiembre,Albania,8,1,1,2,"(10.445761,-75.516429)"
2013,Abril,México,484,3,9,12,"(7.927209,-72.507910)"
2020,Octubre,Estados Unidos de América,840,1273,4117,5390,"(6.171601,-75.427454)"
2017,Agosto,Grecia,300,3,4,7,"(6.171601,-75.427454)"
2014,Julio,República Democrática Popular  Lao,418,2,0,2,"(4.697144,-74.140516)"
2016,Junio,Uruguay,858,3,3,6,"(4.815061,-75.736532)"
2015,Agosto,Desconocido,99999,2,1,3,"(10.886611,-74.776708)"
2023,Febrero,Serbia,688,1,2,3,"(10.886611,-74.776708)"
2019,Marzo,Alemania,276,3,1,4,"(11.360009,-72.129330)"
2012,Agosto,Malawi,454,0,1,1,"(3.541112,-76.384584)"
2023,Abril,Bosnia y Herzegovina,70,1,1,2,"(10.408582,-75.538003)"
2021,Noviembre,República Checa,203,1,1,2,"(7.818934,-72.453226)"
2015,Septiembre,Estados Unidos de América,840,38,71,109,"(0.814836,-77.662532)"
2013,Noviembre,Marruecos,504,4,13,17,"(4.697144,-74.140516)"
2013,Septiembre,Hungría,348,2,1,3,"(3.541112,-76.384584)"
2019,Abril,Nicaragua,558,15,22,37,"(6.171601,-75.427454)"
2018,Junio,Marruecos,504,0,1,1,"(6.171601,-75.427454)"
2014,Agosto,Panamá,591,1,4,5,"(7.927209,-72.507910)"
2021,Septiembre,Italia,380,0,5,5,"(10.408582,-75.538003)"
2016,Septiembre,Estados Unidos de América,840,52,106,158,"(4.815061,-75.736532)"
2017,Marzo,Kazajistán,398,1,0,1,"(-4.197703,-69.941278)"
2023,Febrero,Cuba,192,1,2,3,"(4.452882,-75.766298)"
2013,Noviembre,Costa Rica,188,0,1,1,"(8.635765,-77.346578)"
2018,Noviembre,Brasil,76,7,34,41,"(10.886611,-74.776708)"
2018,Junio,Kuwait,414,0,1,1,"(10.445761,-75.516429)"
2012,Marzo,Costa Rica,188,0,2,2,"(8.635765,-77.346578)"
2019,Septiembre,Paraguay,600,125,51,176,"(10.445761,-75.516429)"
2019,Mayo,Federación de Rusia,643,0,2,2,"(9.402978,-75.681599)"
2015,Julio,Italia,380,2,3,5,"(7.927209,-72.507910)"
2019,Marzo,Japón,392,10,12,22,"(3.541112,-76.384584)"
2021,Febrero,Venezuela,862,125,92,217,"(10.445761,-75.516429)"
2021,Abril,Sri Lanka,144,0,1,1,"(10.445761,-75.516429)"
2012,Julio,Argentina,32,1,1,2,"(11.247723,-74.213989)"
2015,Octubre,Países Bajos,528,0,1,1,"(8.066966,-76.735404)"
2017,Julio,Australia,36,2,1,3,"(0.25129,-76.875963)"
2014,Enero,Canadá,124,0,1,1,"(7.088729,-70.740253)"
2015,Enero,Rumania,642,1,2,3,"(0.814836,-77.662532)"
2017,Agosto,Tailandia,764,1,1,2,"(10.445761,-75.516429)"
2023,Mayo,Georgia,268,0,1,1,"(10.971302,-74.765397)"
2023,Enero,Italia,380,1,3,4,"(0.25129,-76.875963)"
2023,Enero,Singapur,702,1,7,8,"(6.171601,-75.427454)"
2015,Septiembre,Zimbabue,716,0,4,4,"(6.171601,-75.427454)"
2016,Abril,Bermudas/Territorio Británico de Ultramar,60,0,1,1,"(4.697144,-74.140516)"
2016,Abril,Países Bajos,528,10,16,26,"(7.128456,-73.183637)"
2013,Febrero,El Salvador,222,20,13,33,"(10.445761,-75.516429)"
2017,Abril,Ghana,288,1,0,1,"(6.171601,-75.427454)"
2019,Agosto,Países Bajos,528,0,1,1,"(13.3387613,-81.372937)"
2014,Noviembre,Filipinas,608,0,1,1,"(9.402978,-75.681599)"
2013,Noviembre,Estados Unidos de América,840,4,11,15,"(-4.197703,-69.941278)"
2023,Febrero,Pakistán,586,0,1,1,"(10.445761,-75.516429)"
2017,Abril,Nicaragua,558,13,12,25,"(3.541112,-76.384584)"
2014,Enero,Uruguay,858,0,2,2,"(-4.197703,-69.941278)"
2020,Enero,Polonia,616,3,8,11,"(10.886611,-74.776708)"
2018,Diciembre,Pakistán,586,3,16,19,"(4.697144,-74.140516)"
2016,Septiembre,Estados Unidos de América,840,7,16,23,"(-4.197703,-69.941278)"
2015,Mayo,Francia,250,9,10,19,"(11.360009,-72.129330)"
2015,Febrero,Bosnia y Herzegovina,70,1,2,3,"(4.697144,-74.140516)"
2018,Abril,Venezuela,862,25,31,56,"(7.128456,-73.183637)"
2015,Abril,Bélgica,56,10,18,28,"(3.541112,-76.384584)"
2012,Octubre,Argentina,32,43,68,111,"(0.814836,-77.662532)"
2014,Noviembre,Ecuador,218,0,4,4,"(12.5744111,-81.703935)"
2021,Noviembre,Nigeria,566,0,2,2,"(6.171601,-75.427454)"
2020,Enero,Singapur,702,2,1,3,"(6.171601,-75.427454)"
2014,Septiembre,Cuba,192,115,182,297,"(4.697144,-74.140516)"
2019,Enero,Austria,40,1,0,1,"(4.452882,-75.766298)"
2015,Agosto,Canadá,124,22,16,38,"(0.814836,-77.662532)"
2016,Diciembre,Australia,36,1,1,2,"(4.452882,-75.766298)"
2018,Febrero,Nueva Zelanda,554,12,15,27,"(10.445761,-75.516429)"
2014,Mayo,Países Bajos,528,3,1,4,"(7.818934,-72.453226)"
2012,Enero,Panamá,591,85,118,203,"(3.541112,-76.384584)"
2017,Mayo,Canadá,124,15,21,36,"(0.814836,-77.662532)"
2015,Octubre,Honduras,340,310,294,604,"(4.697144,-74.140516)"
2021,Julio,Panamá,591,0,4,4,"(11.360009,-72.129330)"
2017,Febrero,Finlandia,246,1,1,2,"(10.408582,-75.538003)"
2016,Julio,Haití,332,4,4,8,"(10.445761,-75.516429)"
2013,Mayo,México,484,6,12,18,"(0.814836,-77.662532)"
2015,Marzo,Honduras,340,0,1,1,"(10.971302,-74.765397)"
2021,Marzo,Liberia,430,0,1,1,"(4.697144,-74.140516)"
2014,Febrero,Bolivia,68,18,27,45,"(6.171601,-75.427454)"
2016,Enero,Francia,250,2,3,5,"(7.128456,-73.183637)"
2013,Agosto,Eslovenia,705,11,15,26,"(4.697144,-74.140516)"
2019,Septiembre,Alemania,276,0,4,4,"(7.818934,-72.453226)"
2013,Enero,México,484,1731,3448,5179,"(4.697144,-74.140516)"
2013,Febrero,Dinamarca,208,6,14,20,"(10.445761,-75.516429)"
2018,Julio,Alemania,276,1,1,2,"(10.971302,-74.765397)"
2018,Julio,Turquía,792,0,1,1,"(10.408582,-75.538003)"
2022,Julio,Costa Rica,188,0,1,1,"(-4.197703,-69.941278)"
2014,Julio,Honduras,340,3,6,9,"(12.586067,-81.702563)"
2019,Mayo,Argentina,32,91,156,247,"(3.541112,-76.384584)"
2013,Mayo,México,484,0,4,4,"(-4.197703,-69.941278)"
2023,Abril,Grecia,300,2,2,4,"(9.402978,-75.681599)"
2015,Junio,Guatemala,320,0,4,4,"(7.927209,-72.507910)"
2016,Octubre,Francia,250,8,23,31,"(-4.197703,-69.941278)"
2022,Abril,Hungría,348,55,62,117,"(4.697144,-74.140516)"
2015,Marzo,Honduras,340,0,7,7,"(10.408582,-75.538003)"
2013,Marzo,Bélgica,56,2,0,2,"(11.360009,-72.129330)"
2020,Diciembre,Taiwán,158,1,2,3,"(6.171601,-75.427454)"
2019,Abril,Suiza,756,2,3,5,"(4.452882,-75.766298)"
2018,Enero,Kirguistán,417,1,0,1,"(4.697144,-74.140516)"
2022,Junio,Pakistán,586,2,3,5,"(6.171601,-75.427454)"
2019,Noviembre,Islas Wallis y Futuna,876,1,0,1,"(7.818934,-72.453226)"
2016,Enero,Nigeria,566,0,1,1,"(6.171601,-75.427454)"
2012,Diciembre,Senegal,686,0,1,1,"(0.814836,-77.662532)"
2023,Abril,Bahamas,44,22,13,35,"(3.541112,-76.384584)"
2012,Julio,Perú,604,2015,2969,4984,"(4.697144,-74.140516)"
2013,Julio,Barbados,52,0,1,1,"(10.886611,-74.776708)"
2017,Abril,Portugal,620,1,3,4,"(-4.223468,-69.945098)"
2019,Octubre,Suiza,756,2,9,11,"(10.886611,-74.776708)"
2023,Abril,Uganda,800,1,1,2,"(10.445761,-75.516429)"
2017,Junio,Belice,84,0,3,3,"(6.171601,-75.427454)"
2013,Abril,Honduras,340,0,1,1,"(8.066966,-76.735404)"
2016,Febrero,Haití,332,0,2,2,"(3.541112,-76.384584)"
2015,Marzo,Bolivia,68,6,3,9,"(7.818934,-72.453226)"
2021,Abril,Sudáfrica,710,3,2,5,"(10.445761,-75.516429)"
2012,Noviembre,Irán,364,6,7,13,"(4.697144,-74.140516)"
2015,Octubre,Albania,8,0,1,1,"(10.445761,-75.516429)"
2014,Febrero,Bélgica,56,0,1,1,"(7.128456,-73.183637)"
2022,Enero,Serbia,688,0,1,1,"(10.886611,-74.776708)"
2016,Agosto,Estados Unidos de América,840,77,119,196,"(0.814836,-77.662532)"
2018,Julio,Reino Unido de Gran Bretaña e Irlanda del Norte,826,1,5,6,"(0.25129,-76.875963)"
2019,Noviembre,Bélgica,56,28,50,78,"(10.445761,-75.516429)"
2017,Septiembre,Serbia,688,2,0,2,"(6.171601,-75.427454)"
2022,Octubre,Cabo Verde,132,0,1,1,"(4.697144,-74.140516)"
2012,Marzo,Lituania,440,1,0,1,"(10.445761,-75.516429)"
2023,Junio,Alemania,276,1,3,4,"(11.247723,-74.213989)"
2020,Diciembre,Federación de Rusia,643,0,1,1,"(-4.197703,-69.941278)"
2012,Diciembre,Brasil,76,5,10,15,"(7.927209,-72.507910)"
2016,Septiembre,Camerún,120,0,1,1,"(3.541112,-76.384584)"
2016,Marzo,Guyana,328,4,9,13,"(4.697144,-74.140516)"
2018,Diciembre,Suecia,752,45,72,117,"(6.171601,-75.427454)"
2017,Noviembre,Estonia,233,2,3,5,"(6.171601,-75.427454)"
2016,Enero,Iraq,368,0,1,1,"(10.445761,-75.516429)"
2018,Marzo,Bangladesh,50,0,1,1,"(6.171601,-75.427454)"
2012,Diciembre,Panamá,591,11,14,25,"(8.635765,-77.346578)"
2023,Abril,Belice,84,19,14,33,"(4.697144,-74.140516)"
2015,Noviembre,Indonesia,360,2,5,7,"(10.445761,-75.516429)"
2018,Abril,Costa Rica,188,2,2,4,"(7.128456,-73.183637)"
2019,Septiembre,Finlandia,246,2,0,2,"(8.635765,-77.346578)"
2021,Junio,Eslovenia,705,0,2,2,"(6.171601,-75.427454)"
2017,Febrero,Portugal,620,4,3,7,"(0.814836,-77.662532)"
2012,Octubre,Surinam,740,12,15,27,"(4.697144,-74.140516)"
2014,Febrero,Canadá,124,0,5,5,"(4.815061,-75.736532)"
2018,Febrero,Finlandia,246,4,13,17,"(10.445761,-75.516429)"
2012,Marzo,Chile,152,171,133,304,"(10.445761,-75.516429)"
2019,Diciembre,Italia,380,0,1,1,"(11.117806,-74.232622)"
2015,Agosto,Costa Rica,188,0,1,1,"(0.25129,-76.875963)"
2017,Diciembre,Francia,250,2,0,2,"(4.452882,-75.766298)"
2015,Octubre,República de Corea,410,176,458,634,"(4.697144,-74.140516)"
2017,Octubre,Suiza,756,1,1,2,"(7.128456,-73.183637)"
2016,Septiembre,Bahréin,48,0,1,1,"(12.586067,-81.702563)"
2022,Febrero,Georgia,268,2,0,2,"(7.128456,-73.183637)"
2018,Octubre,Estonia,233,10,10,20,"(4.697144,-74.140516)"
2023,Enero,Burundi,108,1,1,2,"(4.697144,-74.140516)"
2017,Abril,Paraguay,600,57,30,87,"(10.445761,-75.516429)"
2016,Marzo,Ecuador,218,0,2,2,"(4.452882,-75.766298)"
2023,Marzo,Estados Unidos de América,840,148,154,302,"(12.586067,-81.702563)"
2012,Agosto,Chile,152,26,75,101,"(3.541112,-76.384584)"
2012,Octubre,Islas Aland/Provincia de Finlandia,248,0,2,2,"(4.697144,-74.140516)"
2022,Abril,Estados Unidos de América,840,6923,9635,16558,"(10.445761,-75.516429)"
2021,Septiembre,Países Bajos,528,522,876,1398,"(4.697144,-74.140516)"
2022,Septiembre,Noruega,578,2,1,3,"(3.541112,-76.384584)"
2019,Julio,India,356,0,1,1,"(9.402978,-75.681599)"
2019,Febrero,San Cristóbal y Nevis,659,0,2,2,"(10.445761,-75.516429)"
2015,Octubre,Estados Unidos de América,840,0,2,2,"(6.228046,-77.404104)"
2014,Octubre,Chile,152,0,3,3,"(7.128456,-73.183637)"
2017,Febrero,Turquía,792,1,13,14,"(6.171601,-75.427454)"
2021,Septiembre,Japón,392,34,71,105,"(4.697144,-74.140516)"
2013,Julio,Estados Unidos de América,840,1,2,3,"(0.25129,-76.875963)"
2020,Febrero,República Checa,203,5,4,9,"(8.635765,-77.346578)"
2015,Agosto,India,356,0,2,2,"(9.402978,-75.681599)"
2021,Diciembre,Albania,8,0,1,1,"(3.541112,-76.384584)"
2014,Diciembre,Azerbaiyán,31,0,1,1,"(0.814836,-77.662532)"
2022,Junio,Estados Unidos de América,840,21,35,56,"(7.818934,-72.453226)"
2015,Julio,Marruecos,504,1,9,10,"(3.541112,-76.384584)"
2021,Noviembre,Bosnia y Herzegovina,70,3,8,11,"(4.697144,-74.140516)"
2015,Diciembre,Haití,332,1,0,1,"(10.886611,-74.776708)"
2015,Agosto,Panamá,591,0,1,1,"(12.5744111,-81.703935)"
2014,Junio,Ecuador,218,2,5,7,"(7.927209,-72.507910)"
2016,Agosto,Malta,470,0,1,1,"(10.445761,-75.516429)"
2016,Septiembre,Chile,152,0,1,1,"(6.185799,-67.483929)"
2019,Noviembre,Honduras,340,3,2,5,"(0.814836,-77.662532)"
2014,Julio,Líbano,422,13,28,41,"(4.697144,-74.140516)"
2017,Junio,Uruguay,858,3,12,15,"(7.818934,-72.453226)"
2016,Diciembre,España,724,2,3,5,"(0.25129,-76.875963)"
2016,Agosto,Israel,376,12,44,56,"(10.445761,-75.516429)"
2012,Agosto,Nicaragua,558,49,26,75,"(4.697144,-74.140516)"
2013,Junio,China,156,6,12,18,"(6.171601,-75.427454)"
2019,Abril,Francia,250,3,6,9,"(11.247723,-74.213989)"
2013,Diciembre,China,156,4,5,9,"(10.445761,-75.516429)"
2016,Mayo,Filipinas,608,0,7,7,"(10.971302,-74.765397)"
2012,Octubre,Taiwán,158,1,0,1,"(6.171601,-75.427454)"
2012,Noviembre,Japón,392,0,1,1,"(7.927209,-72.507910)"
2023,Abril,Chile,152,452,625,1078,"(3.541112,-76.384584)"
2022,Noviembre,Lituania,440,0,1,1,"(3.893038,-77.067921)"
2020,Marzo,Italia,380,4,11,15,"(10.886611,-74.776708)"
2019,Abril,Guatemala,320,0,1,1,"(11.360009,-72.129330)"
2012,Enero,Ecuador,218,12,11,23,"(11.360009,-72.129330)"
2021,Noviembre,Costa Rica,188,6,6,12,"(4.815061,-75.736532)"
2018,Diciembre,Noruega,578,0,1,1,"(13.3387613,-81.372937)"
2012,Septiembre,Federación de Rusia,643,1,0,1,"(8.635765,-77.346578)"
2020,Julio,Etiopia,231,0,16,16,"(4.697144,-74.140516)"
2015,Septiembre,Grecia,300,0,6,6,"(10.408582,-75.538003)"
2014,Octubre,Suiza,756,4,6,10,"(-4.197703,-69.941278)"
2016,Julio,China,156,17,17,34,"(10.445761,-75.516429)"
2012,Diciembre,Haití,332,13,16,29,"(4.697144,-74.140516)"
2022,Agosto,Ghana,288,1,3,4,"(10.445761,-75.516429)"
2015,Diciembre,Austria,40,4,2,6,"(10.886611,-74.776708)"
2014,Enero,Estados Unidos de América,840,545,945,1490,"(3.541112,-76.384584)"
2016,Diciembre,Suiza,756,32,34,66,"(0.814836,-77.662532)"
2023,Marzo,El Salvador,222,0,1,1,"(0.25129,-76.875963)"
2020,Diciembre,Filipinas,608,0,9,9,"(10.886611,-74.776708)"
2017,Diciembre,Chipre,196,1,0,1,"(3.541112,-76.384584)"
2014,Diciembre,Trinidad y Tobago,780,0,2,2,"(11.360009,-72.129330)"
2023,Febrero,Italia,380,2,5,7,"(12.586067,-81.702563)"
2023,Abril,Eslovenia,705,35,46,81,"(4.697144,-74.140516)"
2019,Agosto,Cuba,192,41,49,90,"(6.171601,-75.427454)"
2022,Agosto,Polonia,616,0,1,1,"(4.815061,-75.736532)"
2021,Diciembre,Venezuela,862,25,24,49,"(6.185799,-67.483929)"
2023,Mayo,Ghana,288,4,15,19,"(4.697144,-74.140516)"
2013,Julio,Portugal,620,1,2,3,"(11.360009,-72.129330)"
2014,Diciembre,Países Bajos,528,3,1,4,"(-4.197703,-69.941278)"
2016,Mayo,Grecia,300,0,5,5,"(10.886611,-74.776708)"
2018,Octubre,República Dominicana,214,0,8,8,"(7.818934,-72.453226)"
2015,Diciembre,Bahamas,44,1,1,2,"(6.171601,-75.427454)"
2012,Octubre,Uganda,800,2,0,2,"(4.697144,-74.140516)"
2019,Mayo,Dinamarca,208,5,5,10,"(0.814836,-77.662532)"
2018,Febrero,Líbano,422,2,0,2,"(11.360009,-72.129330)"
2013,Junio,Suecia,752,160,223,383,"(4.697144,-74.140516)"
2012,Junio,El Salvador,222,6,10,16,"(3.541112,-76.384584)"
2019,Diciembre,República de Moldavia,498,2,1,3,"(10.445761,-75.516429)"
2022,Marzo,India,356,16,73,89,"(10.445761,-75.516429)"
2015,Agosto,Kuwait,414,0,3,3,"(4.697144,-74.140516)"
2019,Agosto,Croacia,191,0,5,5,"(10.445761,-75.516429)"
2020,Diciembre,Venezuela,862,218,247,465,"(10.445761,-75.516429)"
2019,Junio,Países Bajos,528,5,4,9,"(8.635765,-77.346578)"
2013,Abril,Mozambique,508,2,4,6,"(4.697144,-74.140516)"
2017,Octubre,Lituania,440,28,27,55,"(4.697144,-74.140516)"
2022,Noviembre,Suazilandia,748,1,1,2,"(4.697144,-74.140516)"
2013,Julio,Andorra,20,0,1,1,"(10.886611,-74.776708)"
2016,Enero,Bulgaria,100,0,1,1,"(-4.197703,-69.941278)"
2018,Mayo,Lituania,440,3,5,8,"(6.171601,-75.427454)"
2018,Octubre,Croacia,191,1,1,2,"(10.408582,-75.538003)"
2019,Junio,Perú,604,4,4,8,"(8.36068,-72.409396)"
2022,Junio,Bélgica,56,0,1,1,"(12.586067,-81.702563)"
2012,Abril,República de Irlanda,372,1,1,2,"(-4.197703,-69.941278)"
2019,Abril,Reino Unido de Gran Bretaña e Irlanda del Norte,826,3,1,4,"(7.128456,-73.183637)"
2017,Abril,Indonesia,360,0,4,4,"(3.541112,-76.384584)"
2012,Noviembre,Bélgica,56,6,14,20,"(3.541112,-76.384584)"
2018,Abril,Barbados,52,0,2,2,"(3.541112,-76.384584)"
2014,Julio,Brasil,76,241,213,454,"(12.586067,-81.702563)"
2022,Abril,Chile,152,1,0,1,"(7.088729,-70.740253)"
2015,Mayo,Reino Unido de Gran Bretaña e Irlanda del Norte,826,16,133,149,"(3.541112,-76.384584)"
2014,Octubre,Alemania,276,2,0,2,"(7.128456,-73.183637)"
2014,Agosto,Malasia,458,0,1,1,"(3.541112,-76.384584)"
2015,Febrero,Finlandia,246,0,3,3,"(10.408582,-75.538003)"
2017,Junio,Japón,392,0,1,1,"(8.635765,-77.346578)"
2012,Mayo,República de Corea,410,1,1,2,"(10.445761,-75.516429)"
2022,Diciembre,Alemania,276,92,104,196,"(3.541112,-76.384584)"
2013,Mayo,Hungría,348,0,1,1,"(6.171601,-75.427454)"
2013,Julio,Honduras,340,1,3,4,"(8.635765,-77.346578)"
2018,Febrero,Perú,604,8,6,14,"(7.128456,-73.183637)"
2019,Febrero,Angola,24,0,1,1,"(6.171601,-75.427454)"
2018,Mayo,El Salvador,222,171,239,410,"(6.171601,-75.427454)"
2014,Abril,Estados Unidos de América,840,1,0,1,"(6.185799,-67.483929)"
2023,Marzo,Grecia,300,10,10,20,"(6.171601,-75.427454)"
2018,Noviembre,Italia,380,0,1,1,"(11.247723,-74.213989)"
2019,Octubre,Nueva Zelanda,554,1,5,6,"(10.408582,-75.538003)"
2017,Julio,Estados Unidos de América,840,2,1,3,"(11.360009,-72.129330)"
2021,Mayo,Nueva Zelanda,554,0,1,1,"(10.445761,-75.516429)"
2014,Junio,Venezuela,862,4,6,10,"(4.815061,-75.736532)"
2013,Marzo,Chile,152,2,3,5,"(8.635765,-77.346578)"
2013,Mayo,Noruega,578,4,6,10,"(3.541112,-76.384584)"
2014,Julio,Panamá,591,1,2,3,"(11.360009,-72.129330)"
2021,Noviembre,China,156,2,2,4,"(10.886611,-74.776708)"
2022,Septiembre,Trinidad y Tobago,780,5,9,14,"(3.541112,-76.384584)"
2013,Octubre,Qatar,634,0,1,1,"(6.171601,-75.427454)"
2014,Noviembre,Costa de Marfil,384,0,1,1,"(3.541112,-76.384584)"
2012,Agosto,Japón,392,4,0,4,"(10.408582,-75.538003)"
2017,Enero,Paraguay,600,0,1,1,"(11.360009,-72.129330)"
2018,Julio,Sudáfrica,710,1,5,6,"(6.171601,-75.427454)"
2012,Agosto,Uruguay,858,138,107,245,"(10.445761,-75.516429)"
2015,Febrero,Filipinas,608,0,1,1,"(1.813928,-78.763924)"
2017,Junio,Chad,148,0,1,1,"(4.697144,-74.140516)"
2022,Noviembre,Georgia,268,0,1,1,"(11.247723,-74.213989)"
2014,Noviembre,Estados Unidos de América,840,128,168,296,"(4.815061,-75.736532)"
2017,Julio,Lituania,440,2,0,2,"(10.445761,-75.516429)"
2017,Diciembre,Ecuador,218,218,297,515,"(7.818934,-72.453226)"
2012,Mayo,Uruguay,858,0,3,3,"(4.815061,-75.736532)"
2012,Octubre,Santa Lucia,662,1,0,1,"(6.171601,-75.427454)"
2014,Agosto,Dinamarca,208,43,109,152,"(4.697144,-74.140516)"
2014,Marzo,Desconocido,99999,4,5,9,"(10.445761,-75.516429)"
2022,Marzo,Suazilandia,748,1,0,1,"(6.171601,-75.427454)"
2013,Junio,Guayana Francesa/Departamento de Ultramar Francés,254,0,1,1,"(4.697144,-74.140516)"
2013,Enero,Japón,392,1,1,2,"(-4.197703,-69.941278)"
2012,Enero,República de Moldavia,498,2,0,2,"(4.697144,-74.140516)"
2022,Julio,Japón,392,105,182,287,"(4.697144,-74.140516)"
2021,Mayo,Italia,380,10,33,43,"(10.445761,-75.516429)"
2014,Noviembre,Costa Rica,188,8,15,23,"(10.886611,-74.776708)"
2019,Diciembre,Nigeria,566,5,11,16,"(4.697144,-74.140516)"
2013,Octubre,Chile,152,25,347,372,"(10.886611,-74.776708)"
2019,Junio,Letonia,428,0,1,1,"(3.893038,-77.067921)"
2015,Mayo,India,356,0,1,1,"(11.360009,-72.129330)"
2019,Agosto,Estados Unidos de América,840,279,362,641,"(4.815061,-75.736532)"
2023,Mayo,Egipto,818,1,3,4,"(10.445761,-75.516429)"
2023,Mayo,Hungría,348,0,3,3,"(7.128456,-73.183637)"
2013,Agosto,Dinamarca,208,9,13,22,"(6.171601,-75.427454)"
2022,Enero,Uruguay,858,0,2,2,"(7.818934,-72.453226)"
2012,Junio,Lituania,440,0,1,1,"(0.814836,-77.662532)"
2018,Agosto,Belice,84,0,1,1,"(0.814836,-77.662532)"
2013,Enero,Turquía,792,2,2,4,"(0.814836,-77.662532)"
2022,Junio,Estados Unidos de América,840,4,13,17,"(12.5744111,-81.703935)"
2013,Septiembre,Países Bajos,528,9,50,59,"(10.445761,-75.516429)"
2020,Febrero,Perú,604,7,13,20,"(11.360009,-72.129330)"
2016,Octubre,Portugal,620,0,1,1,"(0.25129,-76.875963)"
2018,Octubre,Eslovenia,705,0,1,1,"(10.445761,-75.516429)"
2021,Diciembre,India,356,20,66,86,"(10.445761,-75.516429)"
2014,Junio,Islas Caimán/Territorio Británico de Ultramar,136,0,2,2,"(12.586067,-81.702563)"
2015,Febrero,San Cristóbal y Nevis,659,1,3,4,"(4.697144,-74.140516)"
2022,Diciembre,Omán,512,0,4,4,"(4.697144,-74.140516)"
2014,Marzo,Francia,250,14,14,28,"(-4.197703,-69.941278)"
2012,Diciembre,Líbano,422,0,2,2,"(10.445761,-75.516429)"
2018,Agosto,Uganda,800,1,0,1,"(3.541112,-76.384584)"
2015,Septiembre,Francia,250,43,64,107,"(0.814836,-77.662532)"
2016,Abril,República de Irlanda,372,8,29,37,"(6.171601,-75.427454)"
2022,Mayo,Perú,604,3,6,9,"(7.927209,-72.507910)"
2016,Junio,Costa Rica,188,2,2,4,"(7.128456,-73.183637)"
2023,Febrero,Panamá,591,130,149,279,"(4.815061,-75.736532)"
2018,Junio,Trinidad y Tobago,780,8,15,23,"(6.171601,-75.427454)"
2015,Diciembre,Estados Unidos de América,840,23,48,71,"(7.927209,-72.507910)"
2016,Noviembre,Portugal,620,203,467,670,"(4.697144,-74.140516)"
2022,Junio,Eslovenia,705,1,0,1,"(7.916725,-72.462544)"
2012,Septiembre,Canadá,124,0,4,4,"(11.117806,-74.232622)"
2023,Marzo,Francia,250,19,14,33,"(0.25129,-76.875963)"
2013,Julio,Alemania,276,10,15,25,"(10.886611,-74.776708)"
2018,Febrero,Francia,250,5,12,17,"(0.25129,-76.875963)"
2014,Octubre,Federación de Rusia,643,1,0,1,"(7.128456,-73.183637)"
2018,Marzo,República Checa,203,14,9,23,"(0.814836,-77.662532)"
2019,Mayo,Guatemala,320,38,143,181,"(6.171601,-75.427454)"
2018,Marzo,India,356,0,1,1,"(8.635765,-77.346578)"
2014,Septiembre,Bermudas/Territorio Británico de Ultramar,60,0,1,1,"(10.445761,-75.516429)"
2017,Abril,Afganistán,4,0,1,1,"(4.697144,-74.140516)"
2012,Octubre,Francia,250,19,48,67,"(3.541112,-76.384584)"
2016,Enero,México,484,0,2,2,"(4.452882,-75.766298)"
2019,Octubre,Federación de Rusia,643,13,20,33,"(10.445761,-75.516429)"
2017,Diciembre,Argentina,32,2,11,13,"(-4.197703,-69.941278)"
2019,Agosto,México,484,4,2,6,"(0.25129,-76.875963)"
2012,Julio,Singapur,702,1,0,1,"(10.408582,-75.538003)"
2017,Julio,Perú,604,483,420,903,"(10.445761,-75.516429)"
2013,Marzo,Japón,392,0,1,1,"(10.408582,-75.538003)"
2021,Septiembre,Portugal,620,0,4,4,"(4.815061,-75.736532)"
2018,Julio,Dominica,212,3,0,3,"(3.541112,-76.384584)"
2018,Diciembre,Canadá,124,44,41,85,"(10.408582,-75.538003)"
2018,Agosto,Venezuela,862,0,1,1,"(-4.223468,-69.945098)"
2014,Junio,Venezuela,862,1060,1683,2743,"(11.360009,-72.129330)"
2014,Septiembre,Islandia,352,1,7,8,"(4.697144,-74.140516)"
2019,Marzo,Etiopia,231,2,3,5,"(3.541112,-76.384584)"
2012,Diciembre,Panamá,591,0,3,3,"(11.360009,-72.129330)"
2017,Abril,Federación de Rusia,643,1,0,1,"(10.886611,-74.776708)"
2017,Abril,Letonia,428,0,2,2,"(3.541112,-76.384584)"
2018,Noviembre,Pakistán,586,2,6,8,"(10.445761,-75.516429)"
2017,Agosto,Chile,152,1,0,1,"(7.128456,-73.183637)"
2023,Enero,Bélgica,56,0,1,1,"(12.5744111,-81.703935)"
2013,Junio,Reino Unido de Gran Bretaña e Irlanda del Norte,826,4,4,8,"(11.360009,-72.129330)"
2014,Febrero,Japón,392,2,0,2,"(-4.197703,-69.941278)"
2023,Mayo,Argentina,32,3,9,12,"(7.916725,-72.462544)"
2018,Julio,Uruguay,858,518,567,1085,"(4.697144,-74.140516)"
2022,Septiembre,Indonesia,360,1,3,4,"(6.171601,-75.427454)"
2014,Octubre,Perú,604,2,6,8,"(0.25129,-76.875963)"
2018,Diciembre,Bélgica,56,1,2,3,"(12.586067,-81.702563)"
2012,Diciembre,Trinidad y Tobago,780,1,1,2,"(7.818934,-72.453226)"
2015,Febrero,Italia,380,0,1,1,"(1.813928,-78.763924)"
2022,Diciembre,Cuba,192,0,1,1,"(0.25129,-76.875963)"
2022,Julio,Taiwán,158,2,0,2,"(0.814836,-77.662532)"
2023,Junio,Honduras,340,313,198,511,"(10.445761,-75.516429)"
2022,Septiembre,Venezuela,862,0,7,7,"(11.247723,-74.213989)"
2023,Abril,Nueva Zelanda,554,0,1,1,"(-4.197703,-69.941278)"
2017,Julio,Eslovaquia,703,1,1,2,"(10.886611,-74.776708)"
2019,Agosto,Argentina,32,8,18,26,"(7.818934,-72.453226)"
2016,Enero,Haití,332,0,1,1,"(0.814836,-77.662532)"
2021,Octubre,Trinidad y Tobago,780,0,1,1,"(11.360009,-72.129330)"
2017,Octubre,República de Corea,410,11,43,54,"(6.171601,-75.427454)"
2012,Mayo,Nepal,524,0,1,1,"(6.171601,-75.427454)"
2023,Abril,Singapur,702,33,30,63,"(4.697144,-74.140516)"
2017,Enero,España,724,316,572,888,"(3.541112,-76.384584)"
2022,Diciembre,Estados Unidos de América,840,7160,9447,16607,"(10.445761,-75.516429)"
2022,Marzo,Bulgaria,100,67,77,144,"(4.697144,-74.140516)"
2020,Febrero,Hong Kong,344,0,1,1,"(7.818934,-72.453226)"
2018,Abril,India,356,0,1,1,"(0.814836,-77.662532)"
2023,Mayo,España,724,2,0,2,"(8.635765,-77.346578)"
2017,Marzo,Reino Unido de Gran Bretaña e Irlanda del Norte,826,2,1,3,"(12.586067,-81.702563)"
2013,Septiembre,Países Bajos,528,373,676,1049,"(4.697144,-74.140516)"
2012,Enero,El Salvador,222,0,1,1,"(3.893038,-77.067921)"
2019,Marzo,Australia,36,0,2,2,"(12.586067,-81.702563)"
2016,Junio,Venezuela,862,1,24,25,"(10.408582,-75.538003)"
2012,Junio,Cuba,192,1,1,2,"(10.408582,-75.538003)"
2023,Mayo,El Salvador,222,717,780,1497,"(4.697144,-74.140516)"
2016,Mayo,Hungría,348,0,2,2,"(10.445761,-75.516429)"
2023,Junio,Polonia,616,2,7,9,"(3.541112,-76.384584)"
2019,Marzo,Surinam,740,13,25,38,"(4.697144,-74.140516)"
2022,Enero,Suiza,756,13,24,37,"(3.541112,-76.384584)"
2017,Noviembre,Cuba,192,1,2,3,"(4.815061,-75.736532)"
2013,Febrero,China,156,154,380,534,"(4.697144,-74.140516)"
2012,Octubre,Estados Unidos de América,840,14,38,52,"(7.818934,-72.453226)"
2015,Noviembre,Marruecos,504,1,3,4,"(10.445761,-75.516429)"
2012,Enero,Federación de Rusia,643,8,8,16,"(7.818934,-72.453226)"
2021,Septiembre,República de Irlanda,372,1,22,23,"(6.171601,-75.427454)"
2023,Enero,Grecia,300,8,27,35,"(6.171601,-75.427454)"
2013,Noviembre,Suecia,752,0,1,1,"(11.360009,-72.129330)"
2016,Abril,Trinidad y Tobago,780,1,4,5,"(12.586067,-81.702563)"
2023,Marzo,Estados Unidos de América,840,7405,15402,22808,"(6.171601,-75.427454)"
2017,Noviembre,República de Irlanda,372,4,8,12,"(10.408582,-75.538003)"
2012,Enero,Tanzania,834,1,2,3,"(4.697144,-74.140516)"
2016,Septiembre,Suiza,756,0,1,1,"(4.815061,-75.736532)"
2016,Julio,Venezuela,862,2193,2807,5000,"(11.360009,-72.129330)"
2014,Enero,República Checa,203,2,1,3,"(3.541112,-76.384584)"
2012,Diciembre,Bulgaria,100,8,12,20,"(4.697144,-74.140516)"
2023,Junio,Suiza,756,0,1,1,"(6.18189,-67.47535)"
2017,Agosto,Myanmar,104,0,1,1,"(3.541112,-76.384584)"
2023,Mayo,Italia,380,5,8,13,"(4.815061,-75.736532)"
2014,Junio,República de Irlanda,372,2,4,6,"(10.408582,-75.538003)"
2021,Noviembre,Países Bajos,528,1,0,1,"(6.17134,-75.427194)"
2012,Abril,Jordania,400,1,0,1,"(4.697144,-74.140516)"
2016,Septiembre,Jamaica,388,1,0,1,"(7.128456,-73.183637)"
2016,Febrero,Cuba,192,10,32,42,"(6.171601,-75.427454)"
2018,Mayo,Ucrania,804,0,2,2,"(11.247723,-74.213989)"
2019,Septiembre,Granada,308,2,2,4,"(4.697144,-74.140516)"
2013,Diciembre,Estonia,233,0,1,1,"(0.814836,-77.662532)"
2012,Diciembre,Portugal,620,0,1,1,"(7.128456,-73.183637)"
2015,Marzo,Estados Unidos de América,840,4,15,19,"(12.5744111,-81.703935)"
2016,Septiembre,Bulgaria,100,2,2,4,"(6.171601,-75.427454)"
2019,Junio,Guatemala,320,7,8,15,"(10.886611,-74.776708)"
2013,Agosto,Filipinas,608,0,36,36,"(10.971302,-74.765397)"
2013,Abril,República Dominicana,214,0,2,2,"(4.452882,-75.766298)"
2018,Noviembre,Ecuador,218,2,5,7,"(7.088729,-70.740253)"
2017,Septiembre,Finlandia,246,5,2,7,"(10.445761,-75.516429)"
2019,Julio,Panamá,591,85,99,184,"(10.886611,-74.776708)"
2018,Octubre,Nicaragua,558,13,24,37,"(6.171601,-75.427454)"
2017,Agosto,Rumania,642,0,3,3,"(3.893038,-77.067921)"
2018,Diciembre,Islas Caimán/Territorio Británico de Ultramar,136,0,5,5,"(12.586067,-81.702563)"
2022,Febrero,Islas Turcas y Caicos/Territorio Británico de Ultramar,796,1,1,2,"(7.128456,-73.183637)"
2016,Mayo,Estados Unidos de América,840,0,1,1,"(11.117806,-74.232622)"
2022,Enero,Serbia,688,1,1,2,"(4.815061,-75.736532)"
2018,Junio,Bélgica,56,3,1,4,"(-4.223468,-69.945098)"
2016,Septiembre,Hong Kong,344,2,0,2,"(10.445761,-75.516429)"
2022,Abril,Panamá,591,19,39,58,"(7.128456,-73.183637)"
2014,Marzo,Costa Rica,188,8,7,15,"(12.586067,-81.702563)"
2020,Noviembre,Bélgica,56,1,5,6,"(3.541112,-76.384584)"
2013,Abril,Grecia,300,1,0,1,"(-4.197703,-69.941278)"
2018,Mayo,Ucrania,804,0,2,2,"(10.971302,-74.765397)"
2013,Diciembre,Estados Unidos de América,840,53,78,131,"(10.408582,-75.538003)"
2023,Mayo,Nigeria,566,1,3,4,"(10.445761,-75.516429)"
2016,Diciembre,Estados Unidos de América,840,15,20,35,"(8.635765,-77.346578)"
2012,Julio,Tíbet/Región Autónoma de China,99999,1,1,2,"(4.697144,-74.140516)"
2022,Octubre,Georgia,268,0,1,1,"(10.971302,-74.765397)"
2022,Junio,Brasil,76,6,13,19,"(4.452882,-75.766298)"
2012,Julio,Bangladesh,50,0,1,1,"(11.360009,-72.129330)"
2018,Enero,Uruguay,858,8,25,33,"(3.541112,-76.384584)"
2018,Junio,Dinamarca,208,7,10,17,"(3.541112,-76.384584)"
2018,Septiembre,Iraq,368,0,1,1,"(3.541112,-76.384584)"
2017,Mayo,Australia,36,3,3,6,"(11.360009,-72.129330)"
2021,Septiembre,Estados Unidos de América,840,0,1,1,"(1.813928,-78.763924)"
2013,Diciembre,Suiza,756,0,1,1,"(1.813928,-78.763924)"
2017,Mayo,Estonia,233,11,18,29,"(4.697144,-74.140516)"
2018,Mayo,Costa Rica,188,1282,1795,3077,"(4.697144,-74.140516)"
2023,Junio,República Dominicana,214,382,373,755,"(10.445761,-75.516429)"
2023,Marzo,Panamá,591,2836,2740,5576,"(4.697144,-74.140516)"
2013,Enero,Estonia,233,0,3,3,"(3.541112,-76.384584)"
2020,Enero,Malasia,458,1,0,1,"(10.408582,-75.538003)"
2016,Septiembre,China,156,0,1,1,"(3.893038,-77.067921)"
2019,Noviembre,Singapur,702,5,4,9,"(6.171601,-75.427454)"
2012,Mayo,Francia,250,3,2,5,"(13.3387613,-81.372937)"
2013,Marzo,Mónaco,492,0,1,1,"(4.697144,-74.140516)"
2018,Abril,Taiwán,158,2,5,7,"(10.445761,-75.516429)"
2013,Diciembre,Venezuela,862,0,3,3,"(4.452882,-75.766298)"
2019,Diciembre,Kirguistán,417,3,0,3,"(4.697144,-74.140516)"
2015,Mayo,Bulgaria,100,0,1,1,"(10.886611,-74.776708)"
2018,Agosto,Honduras,340,0,11,11,"(12.5744111,-81.703935)"
2017,Marzo,Sudán,736,0,1,1,"(4.697144,-74.140516)"
2020,Octubre,Bahamas,44,5,0,5,"(3.541112,-76.384584)"
2022,Agosto,España,724,11,10,21,"(-4.197703,-69.941278)"
2017,Noviembre,Zimbabue,716,2,0,2,"(4.697144,-74.140516)"
2015,Febrero,Polonia,616,1,0,1,"(10.886611,-74.776708)"
2013,Abril,Nicaragua,558,3,1,4,"(12.586067,-81.702563)"
2022,Diciembre,República Democrática del Congo,180,1,0,1,"(12.586067,-81.702563)"
2014,Julio,Nueva Zelanda,554,4,8,12,"(10.445761,-75.516429)"
2012,Marzo,Federación de Rusia,643,49,56,105,"(4.697144,-74.140516)"
2014,Mayo,Dinamarca,208,4,10,14,"(0.814836,-77.662532)"
2020,Enero,Barbados,52,0,1,1,"(4.815061,-75.736532)"
2016,Enero,República de Armenia,51,1,0,1,"(4.697144,-74.140516)"
2021,Enero,Brasil,76,2,1,3,"(4.815061,-75.736532)"
2019,Octubre,Argentina,32,7,5,12,"(-4.197703,-69.941278)"
2014,Diciembre,Turquía,792,1,0,1,"(3.541112,-76.384584)"
2018,Junio,República de Irlanda,372,1,5,6,"(3.541112,-76.384584)"
2012,Junio,Guyana,328,1,0,1,"(10.886611,-74.776708)"
2021,Agosto,Austria,40,1,0,1,"(10.886611,-74.776708)"
2013,Abril,Paraguay,600,5,11,16,"(6.171601,-75.427454)"
2019,Febrero,Ecuador,218,3,0,3,"(-4.197703,-69.941278)"
2016,Septiembre,Kenia,404,5,4,9,"(6.171601,-75.427454)"
2015,Octubre,Bélgica,56,0,1,1,"(4.815061,-75.736532)"
2016,Octubre,Uganda,800,1,1,2,"(3.541112,-76.384584)"
2018,Marzo,Canadá,124,307,290,597,"(12.586067,-81.702563)"
2014,Mayo,Cuba,192,1,0,1,"(7.927209,-72.507910)"
2019,Diciembre,Kenia,404,0,1,1,"(7.128456,-73.183637)"
2023,Enero,Costa Rica,188,12,4,16,"(12.586067,-81.702563)"
2013,Diciembre,España,724,198,417,615,"(3.541112,-76.384584)"
2023,Febrero,Estados Unidos de América,840,83,107,190,"(11.117806,-74.232622)"
2019,Diciembre,Estados Unidos de América,840,14,11,25,"(7.818934,-72.453226)"
2013,Noviembre,Costa Rica,188,97,205,302,"(6.171601,-75.427454)"
2021,Diciembre,Israel,376,6,11,17,"(0.814836,-77.662532)"
2016,Marzo,República Checa,203,2,0,2,"(3.541112,-76.384584)"
2012,Junio,Chile,152,0,1,1,"(10.408582,-75.538003)"
2023,Enero,Venezuela,862,36,38,74,"(6.18189,-67.47535)"
2020,Julio,Francia,250,44,80,124,"(4.697144,-74.140516)"
2022,Febrero,República Dominicana,214,1,14,15,"(0.814836,-77.662532)"
2022,Octubre,República Dominicana,214,0,2,2,"(8.635765,-77.346578)"
2014,Septiembre,Canadá,124,1,4,5,"(11.360009,-72.129330)"
2018,Diciembre,Finlandia,246,3,2,5,"(12.586067,-81.702563)"
2014,Diciembre,Indonesia,360,0,1,1,"(11.247723,-74.213989)"
2015,Septiembre,Brasil,76,8,10,18,"(7.818934,-72.453226)"
2019,Septiembre,Trinidad y Tobago,780,1,0,1,"(10.886611,-74.776708)"
2023,Enero,Islandia,352,10,26,36,"(4.697144,-74.140516)"
2012,Junio,México,484,2,9,11,"(0.814836,-77.662532)"
2022,Abril,El Salvador,222,18,12,30,"(4.815061,-75.736532)"
2020,Agosto,Federación de Rusia,643,0,5,5,"(4.697144,-74.140516)"
2017,Mayo,Alemania,276,7,9,16,"(8.635765,-77.346578)"
2013,Agosto,Italia,380,0,1,1,"(0.25129,-76.875963)"
2020,Febrero,Letonia,428,3,6,9,"(6.171601,-75.427454)"
2015,Marzo,Rumania,642,37,72,109,"(4.697144,-74.140516)"
2019,Mayo,Taiwán,158,0,1,1,"(4.815061,-75.736532)"
2017,Septiembre,Haití,332,0,3,3,"(6.171601,-75.427454)"
2015,Febrero,Italia,380,8,23,31,"(7.818934,-72.453226)"
2019,Junio,Guatemala,320,593,861,1455,"(4.697144,-74.140516)"
2018,Agosto,Suiza,756,1,0,1,"(8.36068,-72.409396)"
2021,Diciembre,Panamá,591,1214,1471,2685,"(6.171601,-75.427454)"
2022,Noviembre,Estados Unidos de América,840,20,43,63,"(0.814836,-77.662532)"
2019,Febrero,Finlandia,246,0,2,2,"(10.408582,-75.538003)"
2018,Agosto,Estados Unidos de América,840,1,4,5,"(13.3387613,-81.372937)"
2022,Diciembre,República Checa,203,1,2,3,"(10.886611,-74.776708)"
2013,Septiembre,Brasil,76,26,9,35,"(12.586067,-81.702563)"
2021,Agosto,Andorra,20,0,1,1,"(6.171601,-75.427454)"
2017,Octubre,Portugal,620,1,2,3,"(11.360009,-72.129330)"
2015,Septiembre,Mauricio,480,1,3,4,"(4.697144,-74.140516)"
2012,Diciembre,Croacia,191,1,1,2,"(10.445761,-75.516429)"
2018,Marzo,Federación de Rusia,643,1,1,2,"(-4.197703,-69.941278)"
2013,Junio,Perú,604,1,1,2,"(7.088729,-70.740253)"
2019,Julio,Portugal,620,37,79,116,"(6.171601,-75.427454)"
2014,Octubre,Jamaica,388,3,14,17,"(10.445761,-75.516429)"
2023,Mayo,Bulgaria,100,0,5,5,"(11.247723,-74.213989)"
2022,Febrero,Argelia,12,0,1,1,"(6.171601,-75.427454)"
2021,Diciembre,Italia,380,3,14,17,"(10.408582,-75.538003)"
2015,Mayo,Nicaragua,558,2,6,8,"(12.586067,-81.702563)"
2016,Septiembre,Nueva Zelanda,554,0,2,2,"(3.541112,-76.384584)"
2014,Junio,Nigeria,566,1,0,1,"(6.171601,-75.427454)"
2014,Noviembre,El Salvador,222,25,29,54,"(10.445761,-75.516429)"
2020,Marzo,India,356,0,9,9,"(3.893038,-77.067921)"
2013,Julio,Barbados,52,3,2,5,"(10.445761,-75.516429)"
2014,Marzo,Haití,332,0,2,2,"(6.171601,-75.427454)"
2018,Julio,Ecuador,218,1,5,6,"(-4.197703,-69.941278)"
2015,Octubre,Uzbekistán,860,1,0,1,"(6.171601,-75.427454)"
2021,Octubre,Bélgica,56,4,5,9,"(3.541112,-76.384584)"
2023,Marzo,Noruega,578,2,1,3,"(4.815061,-75.736532)"
2017,Abril,Irán,364,4,4,8,"(4.697144,-74.140516)"
2013,Marzo,Surinam,740,3,6,9,"(6.171601,-75.427454)"
2021,Octubre,Uruguay,858,94,154,248,"(4.697144,-74.140516)"
2022,Julio,Nicaragua,558,39,40,79,"(6.171601,-75.427454)"
2021,Noviembre,Noruega,578,0,2,2,"(10.886611,-74.776708)"
2017,Diciembre,Kenia,404,5,5,10,"(4.697144,-74.140516)"
2013,Febrero,Perú,604,271,373,644,"(6.171601,-75.427454)"
2016,Mayo,Camerún,120,0,1,1,"(3.541112,-76.384584)"
2018,Junio,Filipinas,608,39,60,99,"(4.697144,-74.140516)"
2016,Mayo,Federación de Rusia,643,2,3,5,"(-4.197703,-69.941278)"
2014,Abril,Finlandia,246,0,1,1,"(10.886611,-74.776708)"
2023,Febrero,Polonia,616,0,6,6,"(11.247723,-74.213989)"
2014,Julio,Canadá,124,0,6,6,"(7.128456,-73.183637)"
2013,Septiembre,Ghana,288,0,2,2,"(10.445761,-75.516429)"
2014,Noviembre,Pakistán,586,0,7,7,"(4.697144,-74.140516)"
2018,Enero,Brasil,76,2,0,2,"(7.088729,-70.740253)"
2016,Marzo,Haití,332,0,1,1,"(7.818934,-72.453226)"
2021,Julio,Reino Unido de Gran Bretaña e Irlanda del Norte,826,1,1,2,"(8.635765,-77.346578)"
2013,Junio,Islandia,352,0,1,1,"(3.541112,-76.384584)"
2023,Enero,Letonia,428,0,2,2,"(0.814836,-77.662532)"
2019,Enero,Polonia,616,5,7,12,"(0.814836,-77.662532)"
2015,Noviembre,Suiza,756,17,11,28,"(0.814836,-77.662532)"
2022,Febrero,Suiza,756,61,93,154,"(6.171601,-75.427454)"
2014,Noviembre,Japón,392,0,1,1,"(12.586067,-81.702563)"
2018,Agosto,Bahamas,44,4,18,22,"(4.697144,-74.140516)"
2012,Octubre,Ecuador,218,388,536,924,"(6.171601,-75.427454)"
2019,Octubre,Myanmar,104,0,8,8,"(10.886611,-74.776708)"
2017,Febrero,Japón,392,9,31,40,"(3.541112,-76.384584)"
2018,Noviembre,Bélgica,56,0,3,3,"(7.128456,-73.183637)"
2019,Marzo,Guatemala,320,6,4,10,"(12.586067,-81.702563)"
2018,Julio,Argelia,12,1,0,1,"(6.171601,-75.427454)"
2017,Abril,Venezuela,862,14,18,32,"(7.128456,-73.183637)"
2016,Junio,Guatemala,320,22,33,55,"(10.886611,-74.776708)"
2016,Febrero,Turquía,792,1,0,1,"(10.408582,-75.538003)"
2014,Julio,Alemania,276,61,64,125,"(3.541112,-76.384584)"
2020,Enero,Grecia,300,35,109,144,"(4.697144,-74.140516)"
2014,Junio,Nueva Zelanda,554,3,9,12,"(6.171601,-75.427454)"
2017,Enero,Bahamas,44,5,12,17,"(4.697144,-74.140516)"
2013,Abril,Sudáfrica,710,2,2,4,"(10.886611,-74.776708)"
2013,Junio,Países Bajos,528,4,2,6,"(7.128456,-73.183637)"
2019,Junio,Perú,604,198,140,338,"(12.586067,-81.702563)"
2018,Noviembre,San  Vicente y las Granadinas,670,1,0,1,"(6.171601,-75.427454)"
2019,Enero,Bulgaria,100,80,77,157,"(4.697144,-74.140516)"
2015,Agosto,Liechtenstein,438,0,3,3,"(4.697144,-74.140516)"
2019,Julio,Bolivia,68,38,40,78,"(6.171601,-75.427454)"
2012,Junio,Austria,40,4,3,7,"(10.445761,-75.516429)"
2012,Junio,República de Corea,410,3,10,13,"(10.445761,-75.516429)"
2019,Abril,Austria,40,0,2,2,"(12.586067,-81.702563)"
2022,Junio,Dinamarca,208,0,1,1,"(4.815061,-75.736532)"
2019,Febrero,El Salvador,222,83,116,199,"(3.541112,-76.384584)"
2013,Noviembre,Francia,250,5,17,22,"(11.360009,-72.129330)"
2014,Junio,Noruega,578,4,11,15,"(10.445761,-75.516429)"
2017,Octubre,Mauricio,480,2,3,5,"(4.697144,-74.140516)"
2013,Julio,Ecuador,218,3,8,11,"(10.886611,-74.776708)"
2019,Junio,Panamá,591,22,19,41,"(7.128456,-73.183637)"
2020,Mayo,Nicaragua,558,0,1,1,"(12.5744111,-81.703935)"
2013,Marzo,Senegal,686,0,1,1,"(4.697144,-74.140516)"
2015,Noviembre,Turquía,792,8,9,17,"(10.445761,-75.516429)"
2015,Enero,República de Irlanda,372,6,11,17,"(3.541112,-76.384584)"
2022,Septiembre,Federación de Rusia,643,3,4,7,"(0.814836,-77.662532)"
2012,Noviembre,Venezuela,862,749,1391,2140,"(11.360009,-72.129330)"
2013,Octubre,Italia,380,5,14,19,"(-4.197703,-69.941278)"
2012,Junio,Venezuela,862,7,10,17,"(7.128456,-73.183637)"
2013,Agosto,India,356,0,2,2,"(10.971302,-74.765397)"
2015,Mayo,Canadá,124,2,4,6,"(-4.197703,-69.941278)"
2018,Julio,Francia,250,0,2,2,"(9.402978,-75.681599)"
2022,Abril,Honduras,340,104,125,229,"(6.171601,-75.427454)"
2016,Mayo,Líbano,422,0,1,1,"(3.541112,-76.384584)"
2015,Marzo,Chile,152,1,5,6,"(-4.197703,-69.941278)"
2023,Marzo,Benín,204,0,1,1,"(4.697144,-74.140516)"
2012,Junio,Bolivia,68,0,4,4,"(7.818934,-72.453226)"
2019,Noviembre,Francia,250,2,4,6,"(12.586067,-81.702563)"
2016,Marzo,Estados Unidos de América,840,12,14,26,"(8.635765,-77.346578)"
2012,Diciembre,Polonia,616,1,2,3,"(3.541112,-76.384584)"
2013,Marzo,Jamaica,388,5,9,14,"(10.445761,-75.516429)"
2021,Julio,Ecuador,218,0,2,2,"(7.916725,-72.462544)"
2019,Febrero,Cuba,192,0,1,1,"(0.25129,-76.875963)"
2021,Septiembre,Luxemburgo,442,0,2,2,"(6.171601,-75.427454)"
2017,Agosto,Líbano,422,0,1,1,"(7.818934,-72.453226)"
2019,Agosto,Suecia,752,17,31,48,"(6.171601,-75.427454)"
2022,Octubre,Estados Unidos de América,840,19,49,68,"(0.814836,-77.662532)"
2012,Noviembre,Islas Fiji,242,0,1,1,"(4.697144,-74.140516)"
2017,Agosto,Georgia,268,0,2,2,"(1.813928,-78.763924)"
2015,Marzo,Chipre,196,1,0,1,"(10.445761,-75.516429)"
2012,Abril,Granada,308,1,0,1,"(12.5744111,-81.703935)"
2012,Agosto,India,356,32,258,290,"(4.697144,-74.140516)"
2014,Diciembre,Malasia,458,0,1,1,"(11.360009,-72.129330)"
2016,Septiembre,Bahamas,44,4,13,17,"(4.697144,-74.140516)"
2017,Agosto,Israel,376,25,59,84,"(0.814836,-77.662532)"
2013,Octubre,Chile,152,3015,4802,7817,"(4.697144,-74.140516)"
2019,Agosto,Ucrania,804,0,2,2,"(3.893038,-77.067921)"
2012,Mayo,Perú,604,0,1,1,"(4.452882,-75.766298)"
2016,Enero,España,724,14,25,39,"(7.818934,-72.453226)"
2022,Octubre,Alemania,276,3,3,6,"(-4.223468,-69.945098)"
2017,Marzo,Santo Tomé y Príncipe,678,0,1,1,"(4.697144,-74.140516)"
2019,Febrero,Turquía,792,1,8,9,"(3.541112,-76.384584)"
2022,Octubre,Brasil,76,11,3,14,"(7.927209,-72.507910)"
2019,Octubre,Austria,40,3,5,8,"(3.541112,-76.384584)"
2016,Junio,Kuwait,414,1,0,1,"(4.697144,-74.140516)"
2021,Septiembre,Perú,604,2,0,2,"(7.128456,-73.183637)"
2016,Mayo,Alemania,276,44,87,131,"(3.541112,-76.384584)"
2021,Junio,Chile,152,6,11,17,"(3.541112,-76.384584)"
2012,Junio,India,356,1,10,11,"(3.541112,-76.384584)"
2022,Marzo,China,156,165,524,689,"(4.697144,-74.140516)"
2015,Febrero,Panamá,591,122,159,281,"(3.541112,-76.384584)"
2013,Febrero,Uruguay,858,98,96,194,"(10.445761,-75.516429)"
2021,Agosto,Marruecos,504,0,1,1,"(6.171601,-75.427454)"
2021,Septiembre,Croacia,191,21,26,47,"(4.697144,-74.140516)"
2015,Junio,Chile,152,57,47,104,"(12.586067,-81.702563)"
2022,Diciembre,Países Bajos,528,21,16,37,"(0.814836,-77.662532)"
2019,Marzo,Taiwán,158,1,2,3,"(0.814836,-77.662532)"
2021,Noviembre,España,724,2159,4658,6817,"(4.697144,-74.140516)"
2018,Enero,Países Bajos,528,0,2,2,"(4.452882,-75.766298)"
2018,Mayo,India,356,2,11,13,"(10.886611,-74.776708)"
2017,Noviembre,República Dominicana,214,88,182,270,"(10.886611,-74.776708)"
2020,Septiembre,Guatemala,320,0,13,13,"(6.171601,-75.427454)"
2012,Diciembre,República Árabe Siria,760,0,1,1,"(11.360009,-72.129330)"
2012,Febrero,Bélgica,56,1,2,3,"(11.360009,-72.129330)"
2018,Mayo,México,484,498,540,1038,"(10.445761,-75.516429)"
2022,Julio,Israel,376,14,25,39,"(-4.197703,-69.941278)"
2016,Julio,Hong Kong,344,4,9,13,"(4.697144,-74.140516)"
2018,Febrero,Eslovenia,705,0,1,1,"(8.635765,-77.346578)"
2023,Junio,Estados Unidos de América,840,9,29,38,"(10.408582,-75.538003)"
2022,Julio,Taiwán,158,0,1,1,"(7.818934,-72.453226)"
2022,Octubre,República Checa,203,74,138,212,"(4.697144,-74.140516)"
2019,Diciembre,Estados Unidos de América,840,12231,20353,32589,"(4.697144,-74.140516)"
2022,Marzo,Croacia,191,5,7,12,"(6.171601,-75.427454)"
2017,Diciembre,Sudáfrica,710,2,3,5,"(6.171601,-75.427454)"
2016,Abril,Polonia,616,1,0,1,"(10.886611,-74.776708)"
2022,Marzo,Singapur,702,1,0,1,"(0.814836,-77.662532)"
2013,Diciembre,Turquía,792,1,0,1,"(0.814836,-77.662532)"
2014,Agosto,Costa Rica,188,0,1,1,"(7.927209,-72.507910)"
2017,Julio,Suecia,752,1,0,1,"(8.36068,-72.409396)"
2022,Agosto,Italia,380,0,2,2,"(0.25129,-76.875963)"
2019,Enero,Polonia,616,0,2,2,"(8.066966,-76.735404)"
2016,Julio,Polonia,616,0,1,1,"(9.402978,-75.681599)"
2014,Julio,Albania,8,0,1,1,"(6.171601,-75.427454)"
2013,Febrero,Francia,250,5,7,12,"(10.886611,-74.776708)"
2012,Diciembre,Senegal,686,0,3,3,"(4.697144,-74.140516)"
2015,Diciembre,Líbano,422,0,1,1,"(10.445761,-75.516429)"
2017,Agosto,Venezuela,862,293,304,597,"(7.088729,-70.740253)"
2012,Noviembre,Jordania,400,0,6,6,"(4.697144,-74.140516)"
2016,Octubre,Uruguay,858,8,112,120,"(10.886611,-74.776708)"
2014,Febrero,Chile,152,3,3,6,"(8.635765,-77.346578)"
2014,Junio,Arabia Saudita,682,0,2,2,"(6.171601,-75.427454)"
2014,Octubre,Surinam,740,1,0,1,"(3.541112,-76.384584)"
2013,Enero,Guyana,328,0,1,1,"(10.445761,-75.516429)"
2017,Febrero,República de Kosovo,901,1,0,1,"(4.697144,-74.140516)"
2018,Octubre,España,724,0,1,1,"(6.185799,-67.483929)"
2018,Enero,Cuba,192,29,33,62,"(6.171601,-75.427454)"
2022,Septiembre,República de Moldavia,498,1,1,2,"(6.171601,-75.427454)"
2015,Enero,Uruguay,858,168,295,463,"(4.697144,-74.140516)"
2014,Noviembre,Perú,604,0,2,2,"(0.25129,-76.875963)"
2017,Junio,Paraguay,600,0,1,1,"(11.360009,-72.129330)"
2012,Julio,India,356,0,4,4,"(10.886611,-74.776708)"
2013,Septiembre,Trinidad y Tobago,780,1,1,2,"(7.927209,-72.507910)"
2013,Abril,Bolivia,68,287,469,756,"(4.697144,-74.140516)"
2014,Enero,Sri Lanka,144,1,2,3,"(4.697144,-74.140516)"
2014,Mayo,Irán,364,6,17,23,"(4.697144,-74.140516)"
2021,Septiembre,Noruega,578,19,57,76,"(4.697144,-74.140516)"
2013,Mayo,Brasil,76,1,0,1,"(0.25129,-76.875963)"
2016,Marzo,Hong Kong,344,1,0,1,"(0.814836,-77.662532)"
2012,Septiembre,Lituania,440,1,0,1,"(10.445761,-75.516429)"
2020,Enero,Suiza,756,103,178,281,"(6.171601,-75.427454)"
2023,Enero,Omán,512,1,1,2,"(4.697144,-74.140516)"
2019,Noviembre,Italia,380,0,6,6,"(-4.223468,-69.945098)"
2013,Marzo,Brasil,76,1721,3054,4775,"(4.697144,-74.140516)"
2020,Enero,Islas Caimán/Territorio Británico de Ultramar,136,2,4,6,"(12.586067,-81.702563)"
2018,Marzo,Ecuador,218,1,2,3,"(-4.223468,-69.945098)"
2015,Junio,India,356,2,20,22,"(3.541112,-76.384584)"
2022,Octubre,Ecuador,218,0,2,2,"(7.128456,-73.183637)"
2020,Enero,Nepal,524,1,1,2,"(4.697144,-74.140516)"
2018,Marzo,Polonia,616,14,17,31,"(6.171601,-75.427454)"
2015,Enero,Argentina,32,131,110,241,"(10.408582,-75.538003)"
2018,Septiembre,Nueva Zelanda,554,0,1,1,"(8.635765,-77.346578)"
2015,Noviembre,España,724,2493,6223,8716,"(4.697144,-74.140516)"
2023,Enero,Noruega,578,1,1,2,"(8.635765,-77.346578)"
2018,Mayo,República Checa,203,1,3,4,"(13.3387613,-81.372937)"
2013,Septiembre,Taiwán,158,12,35,47,"(4.697144,-74.140516)"
2018,Agosto,Cuba,192,12,26,38,"(10.886611,-74.776708)"
2018,Diciembre,Islandia,352,1,4,5,"(6.171601,-75.427454)"
2013,Abril,India,356,0,1,1,"(12.586067,-81.702563)"
2018,Octubre,Francia,250,4,5,9,"(11.247723,-74.213989)"
2017,Octubre,Sudán,736,1,2,3,"(4.697144,-74.140516)"
2016,Mayo,Israel,376,28,23,51,"(3.541112,-76.384584)"
2022,Junio,Francia,250,94,115,209,"(10.445761,-75.516429)"
2018,Enero,Reino Unido de Gran Bretaña e Irlanda del Norte,826,26,62,88,"(3.541112,-76.384584)"
2021,Octubre,Ecuador,218,0,1,1,"(6.228046,-77.404104)"
2023,Marzo,Bélgica,56,1,0,1,"(7.916725,-72.462544)"
2016,Abril,El Salvador,222,88,120,208,"(3.541112,-76.384584)"
2021,Febrero,Italia,380,143,412,555,"(4.697144,-74.140516)"
2019,Mayo,India,356,0,12,12,"(10.971302,-74.765397)"
2014,Junio,Estados Unidos de América,840,1546,2309,3855,"(10.445761,-75.516429)"
2013,Agosto,Reino Unido de Gran Bretaña e Irlanda del Norte,826,0,1,1,"(4.815061,-75.736532)"
2016,Septiembre,Panamá,591,55,66,121,"(4.452882,-75.766298)"
2018,Octubre,Argentina,32,6,20,26,"(7.818934,-72.453226)"
2015,Agosto,Guatemala,320,3,5,8,"(0.814836,-77.662532)"
2019,Octubre,Brasil,76,3958,5104,9062,"(4.697144,-74.140516)"
2019,Abril,Bolivia,68,1,3,4,"(-4.197703,-69.941278)"
2023,Enero,Canadá,124,9,11,20,"(12.586067,-81.702563)"
2016,Octubre,Pakistán,586,0,2,2,"(6.171601,-75.427454)"
2022,Febrero,Costa Rica,188,2,2,4,"(7.128456,-73.183637)"
2016,Agosto,Polonia,616,0,3,3,"(10.971302,-74.765397)"
2016,Marzo,República Democrática del Congo,180,0,1,1,"(7.818934,-72.453226)"
2022,Agosto,Kazajistán,398,6,7,13,"(6.171601,-75.427454)"
2017,Diciembre,Jamaica,388,2,3,5,"(10.886611,-74.776708)"
2023,Mayo,Japón,392,1,3,4,"(9.402978,-75.681599)"
2019,Marzo,Noruega,578,1,0,1,"(11.247723,-74.213989)"
2022,Diciembre,España,724,21,56,77,"(10.886611,-74.776708)"
2016,Julio,San Cristóbal y Nevis,659,1,1,2,"(4.697144,-74.140516)"
2017,Septiembre,Filipinas,608,6,12,18,"(6.171601,-75.427454)"
2015,Septiembre,Argentina,32,526,380,906,"(10.445761,-75.516429)"
2016,Agosto,Australia,36,45,42,87,"(0.814836,-77.662532)"
2018,Mayo,Estados Unidos de América,840,13,14,27,"(7.818934,-72.453226)"
2019,Julio,Polonia,616,1,3,4,"(3.541112,-76.384584)"
2014,Noviembre,Suiza,756,302,629,931,"(4.697144,-74.140516)"
2015,Mayo,Perú,604,1,0,1,"(0.25129,-76.875963)"
2022,Marzo,India,356,2,17,19,"(10.886611,-74.776708)"
2012,Julio,Ecuador,218,0,44,44,"(10.408582,-75.538003)"
2018,Marzo,Sudáfrica,710,1,1,2,"(0.814836,-77.662532)"
2018,Marzo,Taiwán,158,4,3,7,"(3.541112,-76.384584)"
2022,Enero,Perú,604,16,50,66,"(0.814836,-77.662532)"
2019,Enero,Hungría,348,6,5,11,"(3.541112,-76.384584)"
2019,Mayo,Australia,36,1,0,1,"(-4.197703,-69.941278)"
2014,Febrero,Grecia,300,3,1,4,"(-4.197703,-69.941278)"
2019,Marzo,España,724,0,3,3,"(-4.197703,-69.941278)"
2017,Junio,Indonesia,360,0,1,1,"(11.247723,-74.213989)"
2012,Septiembre,Grecia,300,0,2,2,"(10.445761,-75.516429)"
2016,Enero,Filipinas,608,2,3,5,"(4.815061,-75.736532)"
2015,Julio,Guatemala,320,36,49,85,"(12.586067,-81.702563)"
2012,Enero,Kuwait,414,0,1,1,"(4.697144,-74.140516)"
2018,Agosto,Surinam,740,1,3,4,"(6.171601,-75.427454)"
2015,Junio,República de Moldavia,498,4,1,5,"(4.697144,-74.140516)"
2018,Enero,Taiwán,158,3,7,10,"(3.541112,-76.384584)"
2023,Mayo,Chile,152,23,39,62,"(7.818934,-72.453226)"
2021,Julio,Estonia,233,8,5,13,"(4.697144,-74.140516)"
2017,Marzo,Honduras,340,1,2,3,"(12.586067,-81.702563)"
2019,Diciembre,Italia,380,3,0,3,"(7.088729,-70.740253)"
2018,Septiembre,Japón,392,15,27,42,"(10.445761,-75.516429)"
2013,Abril,Filipinas,608,1,2,3,"(6.171601,-75.427454)"
2012,Julio,India,356,0,2,2,"(7.128456,-73.183637)"
2015,Abril,México,484,152,139,291,"(10.445761,-75.516429)"
2014,Julio,Reino Unido de Gran Bretaña e Irlanda del Norte,826,90,121,211,"(0.814836,-77.662532)"
2014,Abril,Malasia,458,13,29,42,"(4.697144,-74.140516)"
2022,Enero,Alemania,276,2,0,2,"(8.36068,-72.409396)"
2014,Noviembre,Uruguay,858,35,72,107,"(6.171601,-75.427454)"
2017,Julio,Surinam,740,22,23,45,"(4.697144,-74.140516)"
2018,Septiembre,Japón,392,1,14,15,"(3.541112,-76.384584)"
2019,Octubre,Suiza,756,1,3,4,"(4.815061,-75.736532)"
2017,Agosto,Ucrania,804,2,2,4,"(6.171601,-75.427454)"
2014,Enero,El Salvador,222,0,1,1,"(8.635765,-77.346578)"
2022,Agosto,Portugal,620,0,1,1,"(0.814836,-77.662532)"
2021,Junio,Bolivia,68,0,1,1,"(6.185799,-67.483929)"
2019,Octubre,Gabón,266,1,0,1,"(4.697144,-74.140516)"
2019,Diciembre,Portugal,620,0,3,3,"(7.088729,-70.740253)"
2014,Junio,Federación de Rusia,643,1,1,2,"(3.541112,-76.384584)"
2023,Mayo,Serbia,688,1,1,2,"(3.541112,-76.384584)"
2017,Enero,Canadá,124,9,9,18,"(8.635765,-77.346578)"
2022,Junio,Suecia,752,1,0,1,"(4.452882,-75.766298)"
2014,Enero,Surinam,740,0,2,2,"(4.815061,-75.736532)"
2022,Febrero,Francia,250,3,3,6,"(11.247723,-74.213989)"
2021,Junio,Filipinas,608,0,4,4,"(10.971302,-74.765397)"
2016,Noviembre,Iraq,368,0,1,1,"(4.697144,-74.140516)"
2018,Junio,Turquía,792,0,3,3,"(10.886611,-74.776708)"
2012,Febrero,Brasil,76,110,101,211,"(10.445761,-75.516429)"
2018,Mayo,Panamá,591,6,6,12,"(7.128456,-73.183637)"
2014,Abril,Etiopia,231,0,1,1,"(3.541112,-76.384584)"
2021,Julio,Rumania,642,2,8,10,"(10.445761,-75.516429)"
2014,Enero,Australia,36,28,45,73,"(10.408582,-75.538003)"
2012,Diciembre,Suiza,756,0,1,1,"(7.927209,-72.507910)"
2015,Mayo,Perú,604,91,89,180,"(10.445761,-75.516429)"
2023,Junio,Australia,36,0,1,1,"(13.3387613,-81.372937)"
2012,Septiembre,Líbano,422,22,36,58,"(4.697144,-74.140516)"
2017,Octubre,República de Kosovo,901,1,0,1,"(4.697144,-74.140516)"
2023,Mayo,Botsuana,72,1,0,1,"(4.697144,-74.140516)"
2016,Marzo,San Cristóbal y Nevis,659,0,1,1,"(4.697144,-74.140516)"
2021,Diciembre,España,724,2,10,12,"(7.128456,-73.183637)"
2017,Diciembre,México,484,24,61,85,"(10.886611,-74.776708)"
2022,Enero,Brasil,76,30,30,60,"(12.586067,-81.702563)"
2021,Agosto,Irán,364,3,9,12,"(4.697144,-74.140516)"
2019,Marzo,Finlandia,246,1,0,1,"(8.635765,-77.346578)"
2019,Marzo,Palestina,99999,3,0,3,"(4.697144,-74.140516)"
2020,Febrero,Benín,204,1,1,2,"(4.697144,-74.140516)"
2013,Marzo,Bosnia y Herzegovina,70,1,1,2,"(4.697144,-74.140516)"
2018,Octubre,Jamaica,388,3,7,10,"(10.886611,-74.776708)"
2018,Mayo,Venezuela,862,150,196,346,"(10.445761,-75.516429)"
2016,Julio,Perú,604,0,1,1,"(10.971302,-74.765397)"
2013,Diciembre,República Checa,203,0,2,2,"(-4.197703,-69.941278)"
2019,Agosto,Jamaica,388,15,12,27,"(10.445761,-75.516429)"
2015,Febrero,Nueva Zelanda,554,3,5,8,"(10.445761,-75.516429)"
2018,Noviembre,Venezuela,862,0,3,3,"(10.971302,-74.765397)"
2017,Abril,Venezuela,862,1,1,2,"(-4.197703,-69.941278)"
2014,Marzo,Francia,250,0,1,1,"(0.25129,-76.875963)"
2019,Noviembre,Países Bajos,528,4,12,16,"(11.360009,-72.129330)"
2021,Enero,Luxemburgo,442,0,1,1,"(10.445761,-75.516429)"
2017,Diciembre,Emiratos Árabes,784,0,1,1,"(10.445761,-75.516429)"
2019,Febrero,Canadá,124,14,17,31,"(8.635765,-77.346578)"
2014,Junio,India,356,0,7,7,"(9.402978,-75.681599)"
2017,Marzo,Bélgica,56,0,1,1,"(7.818934,-72.453226)"
2012,Noviembre,Argentina,32,0,2,2,"(7.927209,-72.507910)"
2016,Agosto,Panamá,591,1,0,1,"(0.25129,-76.875963)"
2014,Diciembre,Bélgica,56,1,1,2,"(12.5744111,-81.703935)"
2017,Noviembre,Argentina,32,58,104,162,"(3.541112,-76.384584)"
2012,Enero,Brasil,76,0,1,1,"(4.452882,-75.766298)"
2021,Julio,Uzbekistán,860,0,1,1,"(4.697144,-74.140516)"
2015,Septiembre,Taiwán,158,1,0,1,"(10.886611,-74.776708)"
2019,Febrero,Líbano,422,0,4,4,"(6.171601,-75.427454)"
2021,Julio,Belice,84,2,3,5,"(4.697144,-74.140516)"
2023,Enero,Nueva Zelanda,554,0,1,1,"(10.886611,-74.776708)"
2018,Febrero,Hong Kong,344,8,10,18,"(4.697144,-74.140516)"
2012,Octubre,Kenia,404,1,0,1,"(6.171601,-75.427454)"
2017,Septiembre,Bélgica,56,278,496,774,"(4.697144,-74.140516)"
2020,Diciembre,Macedonia,807,0,1,1,"(3.541112,-76.384584)"
2015,Noviembre,Uganda,800,0,2,2,"(4.697144,-74.140516)"
2015,Diciembre,Estados Unidos de América,840,52,112,164,"(0.814836,-77.662532)"
2016,Agosto,Austria,40,0,3,3,"(10.886611,-74.776708)"
2014,Agosto,Venezuela,862,4,23,27,"(10.408582,-75.538003)"
2019,Octubre,Malta,470,0,3,3,"(6.171601,-75.427454)"
2019,Agosto,Portugal,620,7,7,14,"(10.886611,-74.776708)"
2018,Febrero,Croacia,191,0,2,2,"(10.886611,-74.776708)"
2020,Marzo,Rumania,642,0,1,1,"(10.408582,-75.538003)"
2014,Diciembre,Estados Unidos de América,840,2830,4996,7826,"(6.171601,-75.427454)"
2022,Julio,República Dominicana,214,1,2,3,"(7.128456,-73.183637)"
2020,Febrero,Perú,604,9,22,31,"(-4.197703,-69.941278)"
2012,Agosto,Canadá,124,0,1,1,"(13.3387613,-81.372937)"
2013,Enero,China,156,1,0,1,"(7.128456,-73.183637)"
2022,Diciembre,Argentina,32,2462,3232,5694,"(4.697144,-74.140516)"
2015,Julio,Italia,380,2,5,7,"(8.635765,-77.346578)"
2018,Septiembre,Polonia,616,0,1,1,"(7.818934,-72.453226)"
2016,Octubre,Guatemala,320,0,2,2,"(7.818934,-72.453226)"
2016,Noviembre,Venezuela,862,115,152,267,"(7.088729,-70.740253)"
2018,Noviembre,Kenia,404,2,2,4,"(3.541112,-76.384584)"
2012,Mayo,Ecuador,218,0,1,1,"(6.185799,-67.483929)"
2017,Octubre,Dinamarca,208,90,161,251,"(4.697144,-74.140516)"
2022,Septiembre,Nueva Zelanda,554,1,1,2,"(10.886611,-74.776708)"
2017,Junio,Ecuador,218,3,4,7,"(4.815061,-75.736532)"
2013,Marzo,Dinamarca,208,9,7,16,"(0.814836,-77.662532)"
2019,Septiembre,Suiza,756,2,2,4,"(0.25129,-76.875963)"
2018,Junio,Ucrania,804,0,1,1,"(10.886611,-74.776708)"
2018,Octubre,Estados Unidos de América,840,7422,13810,21233,"(4.697144,-74.140516)"
2014,Febrero,Honduras,340,8,10,18,"(3.541112,-76.384584)"
2013,Noviembre,Paraguay,600,8,17,25,"(3.541112,-76.384584)"
2017,Abril,Túnez,788,7,5,12,"(4.697144,-74.140516)"
2016,Febrero,Pakistán,586,4,18,22,"(4.697144,-74.140516)"
2022,Junio,Uruguay,858,133,116,249,"(10.445761,-75.516429)"
2014,Julio,Israel,376,0,1,1,"(4.815061,-75.736532)"
2019,Agosto,Canadá,124,0,1,1,"(12.5744111,-81.703935)"
2013,Junio,Italia,380,9,5,14,"(12.586067,-81.702563)"
2017,Mayo,Federación de Rusia,643,3,0,3,"(3.541112,-76.384584)"
2020,Enero,Austria,40,1,1,2,"(4.452882,-75.766298)"
2015,Agosto,Grecia,300,0,2,2,"(7.818934,-72.453226)"
2014,Abril,Mozambique,508,3,8,11,"(4.697144,-74.140516)"
2013,Agosto,México,484,0,3,3,"(8.635765,-77.346578)"
2016,Agosto,Estados Unidos de América,840,1,1,2,"(13.3387613,-81.372937)"
2015,Junio,Guatemala,320,1,0,1,"(4.452882,-75.766298)"
2012,Marzo,Filipinas,608,0,14,14,"(3.893038,-77.067921)"
2018,Julio,Ucrania,804,24,27,51,"(4.697144,-74.140516)"
2022,Enero,Eslovaquia,703,1,1,2,"(0.814836,-77.662532)"
2020,Febrero,China,156,3,14,17,"(3.541112,-76.384584)"
2013,Febrero,Panamá,591,150,249,399,"(6.171601,-75.427454)"
2022,Diciembre,Italia,380,2,7,9,"(7.128456,-73.183637)"
2012,Julio,República Democrática del Congo,180,1,0,1,"(0.814836,-77.662532)"
2014,Septiembre,Rumania,642,1,0,1,"(3.541112,-76.384584)"
2017,Noviembre,República de Irlanda,372,19,19,38,"(0.814836,-77.662532)"
2022,Noviembre,Alemania,276,2,2,4,"(0.25129,-76.875963)"
2020,Enero,Alemania,276,6,9,15,"(7.818934,-72.453226)"
2023,Febrero,Panamá,591,2,2,4,"(7.102626,-77.762647)"
2019,Junio,Trinidad y Tobago,780,2,3,5,"(7.128456,-73.183637)"
2020,Enero,Croacia,191,0,1,1,"(10.408582,-75.538003)"
2014,Enero,Kenia,404,1,2,3,"(4.697144,-74.140516)"
2015,Junio,San  Vicente y las Granadinas,670,2,3,5,"(4.697144,-74.140516)"
2014,Mayo,Suiza,756,10,12,22,"(10.408582,-75.538003)"
2019,Junio,Ecuador,218,1,0,1,"(7.128456,-73.183637)"
2016,Septiembre,Nueva Zelanda,554,0,1,1,"(7.128456,-73.183637)"
2019,Septiembre,Suecia,752,9,13,22,"(10.445761,-75.516429)"
2016,Diciembre,Hong Kong,344,0,1,1,"(-4.197703,-69.941278)"
2015,Julio,Chile,152,44,153,197,"(6.171601,-75.427454)"
2020,Enero,Rumania,642,121,169,290,"(4.697144,-74.140516)"
2021,Diciembre,Venezuela,862,15,27,42,"(-4.197703,-69.941278)"
2021,Octubre,Bermudas/Territorio Británico de Ultramar,60,0,1,1,"(10.445761,-75.516429)"
2020,Abril,Alemania,276,11,12,23,"(4.697144,-74.140516)"
2013,Mayo,Chipre,196,0,3,3,"(4.697144,-74.140516)"
2013,Enero,Reino Unido de Gran Bretaña e Irlanda del Norte,826,2,6,8,"(10.408582,-75.538003)"
2023,Junio,Portugal,620,5,13,18,"(8.364293,-72.405710)"
2021,Julio,Suiza,756,226,429,655,"(4.697144,-74.140516)"
2022,Mayo,República de Irlanda,372,17,25,42,"(10.445761,-75.516429)"
2022,Enero,Canadá,124,0,5,5,"(7.128456,-73.183637)"
2021,Diciembre,Honduras,340,6,3,9,"(7.128456,-73.183637)"
2018,Noviembre,Argentina,32,1,0,1,"(1.813928,-78.763924)"
2015,Junio,Panamá,591,42,52,94,"(12.586067,-81.702563)"
2018,Noviembre,Letonia,428,0,2,2,"(6.171601,-75.427454)"
2013,Abril,Federación de Rusia,643,0,1,1,"(10.408582,-75.538003)"
2022,Diciembre,Portugal,620,64,96,160,"(6.171601,-75.427454)"
2021,Marzo,Paraguay,600,55,44,99,"(10.445761,-75.516429)"
2018,Agosto,Portugal,620,0,1,1,"(-4.223468,-69.945098)"
2020,Enero,Perú,604,0,1,1,"(9.402978,-75.681599)"
2019,Diciembre,Guinea,324,0,1,1,"(4.697144,-74.140516)"
2018,Julio,Bélgica,56,0,1,1,"(0.25129,-76.875963)"
2014,Marzo,Estonia,233,1,3,4,"(0.814836,-77.662532)"
2014,Agosto,Samoa Occidental,882,3,2,5,"(4.697144,-74.140516)"
2013,Febrero,Australia,36,1,0,1,"(4.815061,-75.736532)"
2014,Agosto,Grecia,300,0,4,4,"(10.445761,-75.516429)"
2017,Febrero,Dinamarca,208,4,5,9,"(10.408582,-75.538003)"
2012,Octubre,España,724,170,488,658,"(4.697144,-74.140516)"
2019,Octubre,Nicaragua,558,17,18,35,"(3.541112,-76.384584)"
2022,Marzo,Dinamarca,208,1,1,2,"(-4.197703,-69.941278)"
2015,Enero,Brasil,76,4533,5266,9799,"(4.697144,-74.140516)"
2021,Enero,Francia,250,3,9,12,"(10.408582,-75.538003)"
2016,Noviembre,China,156,24,48,72,"(6.171601,-75.427454)"
2019,Diciembre,Bangladesh,50,0,2,2,"(10.445761,-75.516429)"
2019,Octubre,Kenia,404,8,7,15,"(4.697144,-74.140516)"
2012,Noviembre,Kirguistán,417,2,0,2,"(4.697144,-74.140516)"
2019,Febrero,Croacia,191,1,4,5,"(10.408582,-75.538003)"
2015,Mayo,Arabia Saudita,682,0,3,3,"(10.445761,-75.516429)"
2015,Febrero,Noruega,578,92,137,229,"(4.697144,-74.140516)"
2013,Julio,Bélgica,56,1,2,3,"(10.886611,-74.776708)"
2017,Mayo,Suecia,752,127,220,347,"(4.697144,-74.140516)"
2022,Noviembre,Rumania,642,2,2,4,"(0.814836,-77.662532)"
2016,Marzo,Mozambique,508,0,1,1,"(6.171601,-75.427454)"
2013,Febrero,Estados Unidos de América,840,46,89,135,"(0.814836,-77.662532)"
2022,Diciembre,Austria,40,2,2,4,"(11.117806,-74.232622)"
2020,Noviembre,Azerbaiyán,31,1,0,1,"(4.697144,-74.140516)"
2013,Agosto,Polonia,616,0,3,3,"(10.971302,-74.765397)"
2021,Enero,Finlandia,246,1,3,4,"(6.171601,-75.427454)"
2012,Septiembre,Nueva Zelanda,554,1,4,5,"(10.445761,-75.516429)"
2018,Junio,Mongolia,496,2,0,2,"(4.697144,-74.140516)"
2018,Julio,Perú,604,186,172,358,"(3.541112,-76.384584)"
2021,Septiembre,Panamá,591,0,3,3,"(10.971302,-74.765397)"
2019,Diciembre,Surinam,740,2,1,3,"(7.128456,-73.183637)"
2021,Octubre,Bermudas/Territorio Británico de Ultramar,60,0,7,7,"(4.697144,-74.140516)"
2021,Abril,India,356,0,5,5,"(10.886611,-74.776708)"
2012,Mayo,Reino Unido de Gran Bretaña e Irlanda del Norte,826,1,0,1,"(0.25129,-76.875963)"
2015,Abril,Canadá,124,0,3,3,"(4.452882,-75.766298)"
2020,Marzo,Montenegro,499,0,1,1,"(3.541112,-76.384584)"
2016,Junio,Honduras,340,4,2,6,"(4.815061,-75.736532)"
2012,Diciembre,España,724,1894,4061,5955,"(4.697144,-74.140516)"
2012,Noviembre,Polonia,616,95,110,205,"(4.697144,-74.140516)"
2015,Enero,Luxemburgo,442,1,0,1,"(10.445761,-75.516429)"
2019,Mayo,Estados Unidos de América,840,29,24,53,"(-4.223468,-69.945098)"
2018,Septiembre,Noruega,578,0,1,1,"(0.25129,-76.875963)"
2017,Abril,Indonesia,360,0,4,4,"(3.893038,-77.067921)"
2021,Noviembre,Bélgica,56,0,5,5,"(10.886611,-74.776708)"
2014,Enero,República de Irlanda,372,1,2,3,"(7.818934,-72.453226)"
2021,Junio,Israel,376,13,64,77,"(6.171601,-75.427454)"
2018,Enero,Chile,152,0,6,6,"(8.36068,-72.409396)"
2018,Agosto,Austria,40,22,13,35,"(10.445761,-75.516429)"
2019,Marzo,Australia,36,1,0,1,"(4.815061,-75.736532)"
2012,Diciembre,Ecuador,218,308,383,691,"(3.541112,-76.384584)"
2016,Agosto,Brasil,76,135,217,352,"(6.171601,-75.427454)"
2019,Enero,Etiopia,231,3,42,45,"(4.697144,-74.140516)"
2014,Julio,Trinidad y Tobago,780,0,4,4,"(7.818934,-72.453226)"
2016,Marzo,Chipre,196,0,1,1,"(0.25129,-76.875963)"
2012,Mayo,Finlandia,246,1,1,2,"(10.408582,-75.538003)"
2021,Agosto,Albania,8,4,15,19,"(4.697144,-74.140516)"
2015,Septiembre,Myanmar,104,0,1,1,"(10.408582,-75.538003)"
2022,Agosto,Letonia,428,0,4,4,"(10.445761,-75.516429)"
2017,Febrero,Turquía,792,1,0,1,"(11.360009,-72.129330)"
2016,Febrero,Afganistán,4,0,1,1,"(4.697144,-74.140516)"
2014,Febrero,Bolivia,68,10,20,30,"(3.541112,-76.384584)"
2017,Diciembre,Finlandia,246,2,2,4,"(10.886611,-74.776708)"
2022,Septiembre,Ecuador,218,4,8,12,"(-4.197703,-69.941278)"
2013,Agosto,Reino Unido de Gran Bretaña e Irlanda del Norte,826,17,39,56,"(6.171601,-75.427454)"
2023,Febrero,India,356,119,394,513,"(4.697144,-74.140516)"
2015,Julio,Panamá,591,3,7,10,"(7.818934,-72.453226)"
2016,Julio,Senegal,686,1,1,2,"(4.697144,-74.140516)"
2016,Enero,España,724,42,106,148,"(10.445761,-75.516429)"
2018,Agosto,Australia,36,44,104,148,"(6.171601,-75.427454)"
2023,Enero,México,484,5,12,17,"(4.452882,-75.766298)"
2017,Abril,República de Belarús,112,6,5,11,"(4.697144,-74.140516)"
2017,Junio,Suecia,752,5,9,14,"(10.886611,-74.776708)"
2015,Junio,México,484,12,16,28,"(4.815061,-75.736532)"
2022,Febrero,Turquía,792,0,3,3,"(0.814836,-77.662532)"
2019,Diciembre,Burkina Faso,854,2,4,6,"(4.697144,-74.140516)"
2013,Diciembre,India,356,51,205,256,"(4.697144,-74.140516)"
2017,Agosto,Chile,152,187,119,306,"(12.586067,-81.702563)"
2018,Agosto,Kenia,404,1,0,1,"(10.886611,-74.776708)"
2019,Abril,Perú,604,7,5,12,"(-4.197703,-69.941278)"
2017,Febrero,Filipinas,608,1,26,27,"(11.247723,-74.213989)"
2021,Noviembre,Bolivia,68,0,1,1,"(7.818934,-72.453226)"
2015,Febrero,Irán,364,0,1,1,"(13.3387613,-81.372937)"
2022,Julio,Omán,512,0,6,6,"(4.697144,-74.140516)"
2014,Julio,Nepal,524,0,2,2,"(6.171601,-75.427454)"
2022,Septiembre,Ghana,288,0,3,3,"(6.171601,-75.427454)"
2012,Junio,Kazajistán,398,1,1,2,"(6.171601,-75.427454)"
2017,Marzo,Estados Unidos de América,840,2187,5736,7923,"(6.171601,-75.427454)"
2021,Noviembre,Eslovaquia,703,2,2,4,"(10.445761,-75.516429)"
2016,Diciembre,Reino Unido de Gran Bretaña e Irlanda del Norte,826,0,6,6,"(4.815061,-75.736532)"
2014,Febrero,Líbano,422,1,1,2,"(6.171601,-75.427454)"
2023,Marzo,Serbia,688,21,40,61,"(4.697144,-74.140516)"
2012,Abril,Austria,40,1,6,7,"(10.408582,-75.538003)"
2013,Septiembre,Uruguay,858,163,349,512,"(4.697144,-74.140516)"
2019,Marzo,Argelia,12,1,0,1,"(10.445761,-75.516429)"
2016,Mayo,Panamá,591,0,5,5,"(7.818934,-72.453226)"
2016,Febrero,Hungría,348,2,3,5,"(10.445761,-75.516429)"
2014,Enero,Palestina,99999,1,0,1,"(0.814836,-77.662532)"
2017,Mayo,China,156,1,0,1,"(4.452882,-75.766298)"
2012,Octubre,Polonia,616,2,16,18,"(6.171601,-75.427454)"
2017,Mayo,Italia,380,8,24,32,"(10.886611,-74.776708)"
2018,Junio,República Dominicana,214,3,2,5,"(4.815061,-75.736532)"
2018,Agosto,Francia,250,14,18,32,"(-4.197703,-69.941278)"
2019,Septiembre,Trinidad y Tobago,780,6,3,9,"(3.541112,-76.384584)"
2013,Abril,Portugal,620,1,0,1,"(0.25129,-76.875963)"
2015,Abril,Noruega,578,5,9,14,"(10.445761,-75.516429)"
2021,Marzo,Nueva Zelanda,554,3,9,12,"(4.697144,-74.140516)"
2019,Noviembre,Suiza,756,65,66,131,"(10.445761,-75.516429)"
2018,Marzo,Lesoto,426,1,0,1,"(4.697144,-74.140516)"
2012,Noviembre,Guatemala,320,47,94,141,"(6.171601,-75.427454)"
2016,Diciembre,Hungría,348,2,0,2,"(10.408582,-75.538003)"
2014,Junio,Italia,380,3,1,4,"(7.927209,-72.507910)"
2013,Julio,Lituania,440,1,2,3,"(3.541112,-76.384584)"
2014,Marzo,Venezuela,862,0,2,2,"(8.635765,-77.346578)"
2017,Diciembre,Nueva Zelanda,554,0,1,1,"(-4.197703,-69.941278)"
2013,Enero,España,724,1,1,2,"(0.25129,-76.875963)"
2014,Enero,Alemania,276,0,3,3,"(7.128456,-73.183637)"
2023,Junio,Francia,250,6,5,11,"(-4.197703,-69.941278)"
2019,Septiembre,Panamá,591,2024,2151,4175,"(4.697144,-74.140516)"
2013,Julio,Dinamarca,208,2,2,4,"(7.818934,-72.453226)"
2014,Marzo,Brasil,76,0,6,6,"(7.927209,-72.507910)"
2022,Diciembre,Liechtenstein,438,0,2,2,"(6.171601,-75.427454)"
2018,Julio,Bélgica,56,58,94,152,"(6.171601,-75.427454)"
2017,Abril,Guyana,328,1,2,3,"(3.541112,-76.384584)"
2016,Octubre,Uruguay,858,276,488,764,"(4.697144,-74.140516)"
2013,Noviembre,Hungría,348,1,2,3,"(6.171601,-75.427454)"
2022,Diciembre,República Árabe de Yemen,887,0,1,1,"(0.814836,-77.662532)"
2021,Octubre,Singapur,702,3,5,8,"(4.697144,-74.140516)"
2014,Abril,Reino Unido de Gran Bretaña e Irlanda del Norte,826,5,11,16,"(10.886611,-74.776708)"
2023,Febrero,Vietnam,704,1,3,4,"(6.171601,-75.427454)"
2023,Enero,Panamá,591,3117,2441,5558,"(4.697144,-74.140516)"
2022,Abril,Nicaragua,558,1,1,2,"(4.815061,-75.736532)"
2019,Mayo,México,484,0,5,5,"(1.813928,-78.763924)"
2018,Abril,República de Irlanda,372,2,4,6,"(-4.223468,-69.945098)"
2022,Noviembre,Países Bajos,528,54,102,156,"(10.886611,-74.776708)"
2020,Febrero,Francia,250,3817,4819,8636,"(4.697144,-74.140516)"
2013,Julio,Alemania,276,14,16,30,"(-4.197703,-69.941278)"
2021,Noviembre,Países Bajos,528,67,171,238,"(6.171601,-75.427454)"
2019,Septiembre,Chile,152,6,8,14,"(4.815061,-75.736532)"
2013,Septiembre,Perú,604,2414,3201,5615,"(4.697144,-74.140516)"
2022,Diciembre,España,724,15,23,38,"(11.360009,-72.129330)"
2016,Octubre,Dominica,212,0,1,1,"(6.171601,-75.427454)"
2016,Mayo,Venezuela,862,7,2,9,"(7.128456,-73.183637)"
2014,Abril,Singapur,702,0,1,1,"(6.171601,-75.427454)"
2016,Abril,Cabo Verde,132,1,0,1,"(6.171601,-75.427454)"
2018,Junio,Bolivia,68,5,5,10,"(0.814836,-77.662532)"
2016,Septiembre,España,724,0,5,5,"(11.360009,-72.129330)"
2018,Noviembre,Suecia,752,3,4,7,"(-4.197703,-69.941278)"
2023,Marzo,Montenegro,499,1,0,1,"(10.445761,-75.516429)"
2022,Julio,Reino Unido de Gran Bretaña e Irlanda del Norte,826,102,179,281,"(10.445761,-75.516429)"
2012,Marzo,República de Corea,410,2,0,2,"(7.818934,-72.453226)"
2014,Marzo,Malasia,458,1,0,1,"(6.171601,-75.427454)"
2012,Abril,Perú,604,0,1,1,"(0.25129,-76.875963)"
2018,Mayo,Nicaragua,558,79,97,176,"(4.697144,-74.140516)"
2014,Mayo,Jamaica,388,15,51,66,"(4.697144,-74.140516)"
2020,Septiembre,Filipinas,608,0,11,11,"(10.445761,-75.516429)"
2012,Julio,Turquía,792,0,3,3,"(3.541112,-76.384584)"
2019,Septiembre,Brasil,76,1,3,4,"(11.360009,-72.129330)"
2023,Marzo,República Dominicana,214,1363,1384,2748,"(6.171601,-75.427454)"
2022,Abril,Italia,380,0,1,1,"(6.185799,-67.483929)"
2012,Junio,Honduras,340,10,14,24,"(10.886611,-74.776708)"
2020,Febrero,República de Belarús,112,1,1,2,"(3.541112,-76.384584)"
2015,Julio,Venezuela,862,59,101,160,"(7.088729,-70.740253)"
2023,Junio,Lituania,440,7,6,13,"(6.171601,-75.427454)"
2012,Mayo,Países Bajos,528,32,52,84,"(6.171601,-75.427454)"
2014,Febrero,Estados Unidos de América,840,1097,2820,3917,"(6.171601,-75.427454)"
2019,Agosto,Croacia,191,2,1,3,"(3.541112,-76.384584)"
2017,Enero,Desconocido,99999,58,131,189,"(4.697144,-74.140516)"
2013,Febrero,India,356,31,247,278,"(4.697144,-74.140516)"
2014,Agosto,Francia,250,38,74,112,"(3.541112,-76.384584)"
2017,Agosto,Estados Unidos de América,840,73,139,212,"(0.814836,-77.662532)"
2014,Agosto,Antigua y Barbuda,28,0,5,5,"(4.697144,-74.140516)"
2023,Mayo,Costa Rica,188,991,956,1947,"(6.171601,-75.427454)"
2016,Mayo,Brasil,76,320,248,568,"(12.586067,-81.702563)"
2019,Junio,Italia,380,0,1,1,"(11.117806,-74.232622)"
2014,Octubre,Bahamas,44,0,2,2,"(6.171601,-75.427454)"
2016,Agosto,Panamá,591,27,34,61,"(12.586067,-81.702563)"
2019,Agosto,Chile,152,0,1,1,"(6.185799,-67.483929)"
2019,Diciembre,Bolivia,68,1,0,1,"(10.886611,-74.776708)"
2023,Febrero,Guatemala,320,1,1,2,"(0.814836,-77.662532)"
2020,Octubre,Bolivia,68,1,1,2,"(3.541112,-76.384584)"
2021,Diciembre,República Checa,203,2,2,4,"(3.541112,-76.384584)"
2015,Marzo,San Marino,674,0,2,2,"(4.697144,-74.140516)"
2022,Febrero,Indonesia,360,1,0,1,"(12.5744111,-81.703935)"
2013,Enero,Argentina,32,176,241,417,"(6.171601,-75.427454)"
2021,Noviembre,Estados Unidos de América,840,0,1,1,"(6.17134,-75.427194)"
2016,Agosto,Reino Unido de Gran Bretaña e Irlanda del Norte,826,3,5,8,"(7.818934,-72.453226)"
2016,Junio,Angola,24,0,2,2,"(4.697144,-74.140516)"
2015,Agosto,Tailandia,764,1,0,1,"(0.814836,-77.662532)"
2023,Junio,Georgia,268,0,2,2,"(10.408582,-75.538003)"
2018,Agosto,Bolivia,68,15,20,35,"(3.541112,-76.384584)"
2016,Junio,Ecuador,218,256,358,614,"(3.541112,-76.384584)"
2018,Julio,Ecuador,218,3837,4364,8202,"(4.697144,-74.140516)"
2016,Julio,Polonia,616,0,1,1,"(11.247723,-74.213989)"
2016,Febrero,Argentina,32,6,9,15,"(11.360009,-72.129330)"
2016,Agosto,Dominica,212,0,1,1,"(10.445761,-75.516429)"
2012,Diciembre,Países Bajos,528,15,42,57,"(3.541112,-76.384584)"
2017,Enero,República de Irlanda,372,0,1,1,"(12.5744111,-81.703935)"
2016,Septiembre,Eslovenia,705,3,2,5,"(10.445761,-75.516429)"
2014,Marzo,Trinidad y Tobago,780,4,11,15,"(6.171601,-75.427454)"
2023,Mayo,Ecuador,218,45,64,109,"(3.541112,-76.384584)"
2015,Septiembre,Nepal,524,1,0,1,"(6.171601,-75.427454)"
2016,Julio,Anguila/Territorio Británico de Ultramar,660,0,1,1,"(4.697144,-74.140516)"
2023,Marzo,México,484,5,9,14,"(8.364293,-72.405710)"
2021,Abril,Finlandia,246,1,0,1,"(10.886611,-74.776708)"
2017,Septiembre,Bahamas,44,0,2,2,"(10.886611,-74.776708)"
2017,Febrero,República Democrática del Congo,180,0,2,2,"(6.171601,-75.427454)"
2018,Marzo,Francia,250,4,9,13,"(4.815061,-75.736532)"
2015,Agosto,Croacia,191,0,5,5,"(10.971302,-74.765397)"
2012,Diciembre,Honduras,340,1,5,6,"(10.886611,-74.776708)"
2023,Abril,Brasil,76,0,1,1,"(7.128456,-73.183637)"
2013,Septiembre,Honduras,340,0,5,5,"(12.5744111,-81.703935)"
2019,Agosto,Países Bajos,528,2,8,10,"(7.818934,-72.453226)"
2017,Noviembre,Filipinas,608,0,55,55,"(10.408582,-75.538003)"
2018,Abril,Noruega,578,13,7,20,"(6.171601,-75.427454)"
2016,Abril,Surinam,740,10,6,16,"(10.886611,-74.776708)"
2015,Marzo,Singapur,702,2,6,8,"(10.445761,-75.516429)"
2017,Agosto,República Dominicana,214,7,4,11,"(4.815061,-75.736532)"
2022,Septiembre,Venezuela,862,2049,1700,3749,"(7.916725,-72.462544)"
2022,Noviembre,Francia,250,29,53,82,"(3.541112,-76.384584)"
2014,Abril,República Checa,203,1,0,1,"(6.171601,-75.427454)"
2021,Diciembre,Italia,380,30,66,96,"(10.886611,-74.776708)"
2019,Septiembre,Tonga,776,1,0,1,"(4.697144,-74.140516)"
2022,Noviembre,Bélgica,56,1,6,7,"(-4.223468,-69.945098)"
2019,Noviembre,Federación de Rusia,643,6,7,13,"(0.814836,-77.662532)"
2023,Junio,Marruecos,504,6,4,10,"(10.445761,-75.516429)"
2022,Julio,Singapur,702,2,5,7,"(10.445761,-75.516429)"
2015,Febrero,Argentina,32,1,0,1,"(6.185799,-67.483929)"
2018,Octubre,Honduras,340,0,2,2,"(7.128456,-73.183637)"
2020,Noviembre,Venezuela,862,1,2,3,"(6.185799,-67.483929)"
2012,Abril,Francia,250,3,3,6,"(7.128456,-73.183637)"
2019,Noviembre,Suiza,756,2,3,5,"(10.886611,-74.776708)"
2013,Julio,Alemania,276,1,3,4,"(12.586067,-81.702563)"
2022,Marzo,República de Belarús,112,1,0,1,"(6.171601,-75.427454)"
2013,Septiembre,Botsuana,72,1,2,3,"(4.697144,-74.140516)"
2012,Julio,Suecia,752,0,1,1,"(8.635765,-77.346578)"
2019,Abril,Costa de Marfil,384,1,0,1,"(10.445761,-75.516429)"
2018,Julio,Venezuela,862,64,65,129,"(0.25129,-76.875963)"
2017,Agosto,Alemania,276,114,133,247,"(10.445761,-75.516429)"
2013,Octubre,Georgia,268,0,2,2,"(4.697144,-74.140516)"
2016,Marzo,Bulgaria,100,3,2,5,"(10.445761,-75.516429)"
2019,Mayo,Gambia,270,0,1,1,"(10.445761,-75.516429)"
2014,Agosto,Kuwait,414,3,5,8,"(4.697144,-74.140516)"
2021,Junio,Alemania,276,0,1,1,"(4.815061,-75.736532)"
2012,Diciembre,Italia,380,25,95,120,"(3.541112,-76.384584)"
2017,Marzo,Bermudas/Territorio Británico de Ultramar,60,0,3,3,"(6.171601,-75.427454)"
2023,Mayo,Portugal,620,0,2,2,"(7.128456,-73.183637)"
2016,Junio,Eslovaquia,703,0,1,1,"(3.893038,-77.067921)"
2012,Julio,México,484,0,3,3,"(12.5744111,-81.703935)"
2016,Junio,Cuba,192,0,1,1,"(7.128456,-73.183637)"
2019,Mayo,Singapur,702,1,0,1,"(0.814836,-77.662532)"
2019,Agosto,Chile,152,9,23,32,"(7.818934,-72.453226)"
2016,Noviembre,China,156,5,13,18,"(7.818934,-72.453226)"
2012,Octubre,Israel,376,75,417,492,"(4.697144,-74.140516)"
2012,Agosto,Zimbabue,716,1,0,1,"(6.171601,-75.427454)"
2018,Noviembre,Bahamas,44,3,2,5,"(6.171601,-75.427454)"
2022,Septiembre,Brasil,76,84,71,155,"(12.586067,-81.702563)"
2022,Diciembre,Indonesia,360,29,49,78,"(4.697144,-74.140516)"
2018,Junio,Uruguay,858,0,1,1,"(0.25129,-76.875963)"
2012,Mayo,Israel,376,0,1,1,"(10.408582,-75.538003)"
2018,Diciembre,México,484,2,3,5,"(11.360009,-72.129330)"
2012,Noviembre,Eslovenia,705,2,1,3,"(10.445761,-75.516429)"
2012,Marzo,Ecuador,218,43,28,71,"(12.586067,-81.702563)"
2014,Abril,Países Bajos,528,2,2,4,"(4.815061,-75.736532)"
2017,Enero,Kenia,404,1,0,1,"(-4.197703,-69.941278)"
2017,Octubre,Filipinas,608,0,42,42,"(10.408582,-75.538003)"
2014,Febrero,México,484,2,14,16,"(4.815061,-75.736532)"
2017,Julio,Costa Rica,188,45,63,108,"(3.541112,-76.384584)"
2017,Febrero,Barbados,52,12,13,25,"(4.697144,-74.140516)"
2017,Abril,Canadá,124,8,7,15,"(8.635765,-77.346578)"
2013,Noviembre,República de Moldavia,498,4,1,5,"(4.697144,-74.140516)"
2019,Enero,Turquía,792,0,1,1,"(-4.223468,-69.945098)"
2019,Mayo,Federación de Rusia,643,0,1,1,"(7.128456,-73.183637)"
2017,Septiembre,Filipinas,608,0,11,11,"(9.402978,-75.681599)"
2023,Febrero,República de Irlanda,372,1,0,1,"(0.25129,-76.875963)"
2021,Octubre,Chipre,196,0,2,2,"(3.541112,-76.384584)"
2017,Junio,Ghana,288,0,2,2,"(11.247723,-74.213989)"
2021,Octubre,Italia,380,1,4,5,"(4.815061,-75.736532)"
2022,Octubre,Guyana,328,0,1,1,"(0.814836,-77.662532)"
2013,Octubre,Reino Unido de Gran Bretaña e Irlanda del Norte,826,1,0,1,"(7.818934,-72.453226)"
2022,Julio,Argentina,32,1,0,1,"(8.635765,-77.346578)"
2014,Julio,Rumania,642,0,3,3,"(6.171601,-75.427454)"
2018,Diciembre,Egipto,818,0,1,1,"(6.171601,-75.427454)"
2014,Diciembre,Argentina,32,0,4,4,"(7.128456,-73.183637)"
2013,Junio,Estados Unidos de América,840,5,7,12,"(8.635765,-77.346578)"
2016,Octubre,Filipinas,608,5,4,9,"(6.171601,-75.427454)"
2016,Abril,Alemania,276,69,186,255,"(6.171601,-75.427454)"
2021,Septiembre,Surinam,740,10,5,15,"(4.697144,-74.140516)"
2013,Abril,Jordania,400,1,0,1,"(10.445761,-75.516429)"
2022,Octubre,Austria,40,1,0,1,"(4.452882,-75.766298)"
2016,Septiembre,Chile,152,38,60,98,"(0.814836,-77.662532)"
2020,Marzo,Suecia,752,15,34,49,"(6.171601,-75.427454)"
2022,Septiembre,Panamá,591,0,1,1,"(12.5744111,-81.703935)"
2019,Marzo,Nueva Zelanda,554,7,14,21,"(10.445761,-75.516429)"
2016,Junio,Cuba,192,2,3,5,"(4.815061,-75.736532)"
2013,Abril,El Salvador,222,1,1,2,"(7.927209,-72.507910)"
2013,Agosto,Nueva Zelanda,554,0,1,1,"(12.586067,-81.702563)"
2015,Junio,Turquía,792,5,10,15,"(6.171601,-75.427454)"
2023,Marzo,Portugal,620,1,2,3,"(10.408582,-75.538003)"
2012,Noviembre,Barbados,52,1,1,2,"(4.815061,-75.736532)"
2014,Agosto,Perú,604,0,1,1,"(7.088729,-70.740253)"
2017,Julio,Cuba,192,0,2,2,"(4.815061,-75.736532)"
2013,Enero,Pakistán,586,1,9,10,"(4.697144,-74.140516)"
2018,Marzo,India,356,0,2,2,"(7.128456,-73.183637)"
2018,Marzo,Argentina,32,0,1,1,"(7.102626,-77.762647)"
2019,Julio,Qatar,634,0,3,3,"(4.697144,-74.140516)"
2018,Noviembre,Indonesia,360,13,32,45,"(4.697144,-74.140516)"
2022,Noviembre,República Dominicana,214,0,5,5,"(11.117806,-74.232622)"
2012,Mayo,Suecia,752,0,2,2,"(-4.197703,-69.941278)"
2020,Marzo,Filipinas,608,2,31,33,"(10.445761,-75.516429)"
2015,Abril,Barbados,52,1,12,13,"(4.697144,-74.140516)"
2014,Diciembre,Noruega,578,0,2,2,"(3.893038,-77.067921)"
2014,Noviembre,Australia,36,5,14,19,"(10.886611,-74.776708)"
2015,Octubre,Trinidad y Tobago,780,22,27,49,"(4.697144,-74.140516)"
2013,Octubre,Islas del Canal,238,0,1,1,"(10.886611,-74.776708)"
2016,Septiembre,Singapur,702,1,1,2,"(3.541112,-76.384584)"
2015,Diciembre,Chipre,196,0,4,4,"(4.697144,-74.140516)"
2014,Abril,Montenegro,499,1,1,2,"(4.697144,-74.140516)"
2016,Junio,Egipto,818,1,1,2,"(0.814836,-77.662532)"
2022,Diciembre,Portugal,620,0,1,1,"(9.402978,-75.681599)"
2016,Febrero,Australia,36,1,0,1,"(4.815061,-75.736532)"
2018,Diciembre,Chile,152,3,3,6,"(11.360009,-72.129330)"
2018,Noviembre,República Checa,203,0,1,1,"(10.886611,-74.776708)"
2013,Marzo,Bélgica,56,6,19,25,"(3.541112,-76.384584)"
2014,Septiembre,Argentina,32,4,8,12,"(0.25129,-76.875963)"
2023,Junio,Tailandia,764,1,0,1,"(4.452882,-75.766298)"
2014,Agosto,Honduras,340,7,2,9,"(10.886611,-74.776708)"
2018,Junio,Filipinas,608,1,1,2,"(0.814836,-77.662532)"
2015,Octubre,México,484,65,142,207,"(3.541112,-76.384584)"
2014,Marzo,Eslovaquia,703,3,0,3,"(-4.197703,-69.941278)"
2012,Marzo,Eslovenia,705,0,2,2,"(0.814836,-77.662532)"
2022,Junio,República Dominicana,214,6,14,20,"(0.814836,-77.662532)"
2023,Junio,Nepal,524,1,0,1,"(6.171601,-75.427454)"
2014,Febrero,Andorra,20,8,8,16,"(4.697144,-74.140516)"
2020,Enero,Marruecos,504,1,2,3,"(10.445761,-75.516429)"
2012,Septiembre,Belice,84,3,0,3,"(10.445761,-75.516429)"
2014,Mayo,Alemania,276,26,35,61,"(10.445761,-75.516429)"
2013,Octubre,Estados Unidos de América,840,26,54,80,"(7.818934,-72.453226)"
2015,Abril,Eslovenia,705,16,26,42,"(4.697144,-74.140516)"
2013,Marzo,España,724,3,1,4,"(-4.197703,-69.941278)"
2014,Abril,Guatemala,320,1,5,6,"(0.814836,-77.662532)"
2022,Junio,España,724,2881,4568,7450,"(4.697144,-74.140516)"
2017,Noviembre,Guatemala,320,17,14,31,"(12.586067,-81.702563)"
2015,Septiembre,Ecuador,218,41,57,98,"(7.818934,-72.453226)"
2022,Agosto,México,484,0,16,16,"(10.408582,-75.538003)"
2014,Septiembre,Bolivia,68,23,11,34,"(10.445761,-75.516429)"
2019,Marzo,México,484,1,1,2,"(8.635765,-77.346578)"
2015,Diciembre,India,356,0,4,4,"(10.408582,-75.538003)"
2022,Marzo,Kuwait,414,4,1,5,"(4.697144,-74.140516)"
2020,Febrero,República de Moldavia,498,4,3,7,"(4.697144,-74.140516)"
2021,Diciembre,Alemania,276,1,0,1,"(8.635765,-77.346578)"
2015,Noviembre,Hungría,348,39,40,79,"(4.697144,-74.140516)"
2023,Junio,Sierra Leona,694,0,1,1,"(3.541112,-76.384584)"
2018,Septiembre,Libia,434,1,0,1,"(4.697144,-74.140516)"
2018,Mayo,Mongolia,496,1,0,1,"(6.171601,-75.427454)"
2021,Noviembre,Israel,376,0,1,1,"(7.128456,-73.183637)"
2017,Julio,Irán,364,0,2,2,"(10.445761,-75.516429)"
2019,Mayo,Nicaragua,558,13,26,39,"(6.171601,-75.427454)"
2023,Junio,Bosnia y Herzegovina,70,0,1,1,"(10.408582,-75.538003)"
2019,Julio,Sri Lanka,144,2,6,8,"(10.445761,-75.516429)"
2021,Abril,Hungría,348,11,20,31,"(4.697144,-74.140516)"
2023,Abril,Benín,204,0,2,2,"(6.171601,-75.427454)"
2016,Febrero,Australia,36,6,4,10,"(-4.197703,-69.941278)"
2023,Junio,Francia,250,14,24,38,"(10.886611,-74.776708)"
2012,Junio,Alemania,276,0,1,1,"(11.247723,-74.213989)"
2021,Agosto,Serbia,688,3,7,10,"(6.171601,-75.427454)"
2012,Agosto,Argentina,32,0,1,1,"(1.813928,-78.763924)"
2016,Junio,Líbano,422,0,1,1,"(7.818934,-72.453226)"
2013,Diciembre,República de Irlanda,372,0,1,1,"(7.088729,-70.740253)"
2014,Mayo,Malta,470,1,3,4,"(4.697144,-74.140516)"
2017,Enero,Italia,380,25,64,89,"(0.814836,-77.662532)"
2012,Febrero,Austria,40,3,0,3,"(11.360009,-72.129330)"
2012,Julio,Australia,36,1,3,4,"(11.360009,-72.129330)"
2012,Noviembre,Ecuador,218,1,139,140,"(1.813928,-78.763924)"
2019,Enero,Costa Rica,188,3,4,7,"(7.128456,-73.183637)"
2016,Marzo,China,156,2,7,9,"(7.818934,-72.453226)"
2017,Agosto,Austria,40,210,289,499,"(4.697144,-74.140516)"
2022,Junio,903,99999,1,0,1,"(4.697144,-74.140516)"
2022,Marzo,Turkmenistán,795,0,1,1,"(4.697144,-74.140516)"
2014,Marzo,Chile,152,0,1,1,"(7.088729,-70.740253)"
2016,Enero,Albania,8,1,3,4,"(4.697144,-74.140516)"
2020,Agosto,Perú,604,2,9,11,"(-4.223468,-69.945098)"
2013,Noviembre,Sudáfrica,710,0,3,3,"(10.886611,-74.776708)"
2016,Diciembre,Reino Unido de Gran Bretaña e Irlanda del Norte,826,1,3,4,"(13.3387613,-81.372937)"
2019,Diciembre,Costa Rica,188,27,42,69,"(10.886611,-74.776708)"
2012,Junio,Singapur,702,1,0,1,"(6.171601,-75.427454)"
2019,Marzo,Bahamas,44,5,3,8,"(10.445761,-75.516429)"
2016,Octubre,República de Irlanda,372,2,1,3,"(-4.197703,-69.941278)"
2012,Octubre,Bélgica,56,4,5,9,"(10.445761,-75.516429)"
2018,Agosto,Estados Unidos de América,840,58,70,128,"(0.814836,-77.662532)"
2013,Septiembre,México,484,3,18,21,"(4.815061,-75.736532)"
2015,Septiembre,Reino Unido de Gran Bretaña e Irlanda del Norte,826,1,2,3,"(10.971302,-74.765397)"
2017,Octubre,Bélgica,56,10,17,27,"(3.541112,-76.384584)"
2022,Abril,Polonia,616,0,1,1,"(3.893038,-77.067921)"
2012,Abril,Granada,308,1,5,6,"(10.445761,-75.516429)"
2017,Mayo,Federación de Rusia,643,8,9,17,"(10.445761,-75.516429)"
2016,Febrero,Israel,376,1,2,3,"(8.635765,-77.346578)"
2012,Octubre,Ecuador,218,0,1,1,"(7.128456,-73.183637)"
2019,Octubre,España,724,0,3,3,"(7.128456,-73.183637)"
2021,Julio,Costa Rica,188,9,17,26,"(10.886611,-74.776708)"
2016,Julio,Brasil,76,109,127,236,"(3.541112,-76.384584)"
2014,Julio,Paraguay,600,79,117,196,"(4.697144,-74.140516)"
2015,Octubre,India,356,0,3,3,"(3.893038,-77.067921)"
2016,Febrero,Bolivia,68,9,17,26,"(0.814836,-77.662532)"
2023,Marzo,Desconocido,99999,86,111,197,"(4.697144,-74.140516)"
2022,Agosto,Nicaragua,558,4,5,9,"(10.886611,-74.776708)"
2019,Noviembre,Grecia,300,1,1,2,"(3.541112,-76.384584)"
2012,Junio,Ucrania,804,16,11,27,"(4.697144,-74.140516)"
2017,Julio,Pakistán,586,2,4,6,"(10.445761,-75.516429)"
2021,Abril,Nicaragua,558,1,3,4,"(10.886611,-74.776708)"
2013,Septiembre,Israel,376,1,4,5,"(10.408582,-75.538003)"
2014,Junio,Nueva Zelanda,554,1,3,4,"(3.541112,-76.384584)"
2017,Diciembre,Reino Unido de Gran Bretaña e Irlanda del Norte,826,0,3,3,"(7.128456,-73.183637)"
2020,Enero,Brasil,76,169,130,299,"(10.408582,-75.538003)"
2022,Marzo,España,724,12,16,28,"(4.815061,-75.736532)"
2019,Junio,Suiza,756,34,33,67,"(0.814836,-77.662532)"
2021,Julio,Argentina,32,1,1,2,"(6.228046,-77.404104)"
2014,Marzo,Jamaica,388,3,6,9,"(6.171601,-75.427454)"
2019,Mayo,Países Bajos,528,1,6,7,"(4.815061,-75.736532)"
2017,Octubre,Rumania,642,6,10,16,"(6.171601,-75.427454)"
2016,Agosto,Sudáfrica,710,1,1,2,"(-4.197703,-69.941278)"
2013,Julio,Lituania,440,0,1,1,"(0.814836,-77.662532)"
2019,Agosto,Chile,152,161,94,255,"(10.408582,-75.538003)"
2018,Diciembre,Nigeria,566,0,1,1,"(10.445761,-75.516429)"
2022,Abril,República Dominicana,214,62,64,126,"(3.541112,-76.384584)"
2020,Marzo,Honduras,340,6,10,16,"(10.886611,-74.776708)"
2016,Octubre,Papúa Nueva Guinea,598,5,2,7,"(4.697144,-74.140516)"
2016,Septiembre,Alemania,276,84,104,188,"(3.541112,-76.384584)"
2022,Junio,Austria,40,93,170,263,"(4.697144,-74.140516)"
2016,Enero,Bulgaria,100,5,4,9,"(6.171601,-75.427454)"
2016,Septiembre,Hungría,348,1,0,1,"(0.25129,-76.875963)"
2012,Julio,República de Irlanda,372,13,19,32,"(0.814836,-77.662532)"
2018,Abril,España,724,13,43,56,"(10.886611,-74.776708)"
2012,Marzo,Isla de Man,833,0,1,1,"(11.360009,-72.129330)"
2017,Abril,Serbia,688,2,2,4,"(10.445761,-75.516429)"
2022,Abril,Trinidad y Tobago,780,3,12,15,"(3.541112,-76.384584)"
2012,Diciembre,República de Corea,410,2,4,6,"(3.541112,-76.384584)"
2022,Junio,Hong Kong,344,8,13,21,"(4.697144,-74.140516)"
2012,Octubre,India,356,1,11,12,"(3.541112,-76.384584)"
2019,Marzo,República de Moldavia,498,0,1,1,"(6.171601,-75.427454)"
2014,Abril,Luxemburgo,442,1,0,1,"(10.445761,-75.516429)"
2021,Julio,Eslovaquia,703,0,1,1,"(10.971302,-74.765397)"
2022,Diciembre,Ucrania,804,0,13,13,"(10.971302,-74.765397)"
2019,Junio,Emiratos Árabes,784,0,1,1,"(6.171601,-75.427454)"
2017,Mayo,Finlandia,246,47,66,113,"(4.697144,-74.140516)"
2017,Mayo,Austria,40,0,1,1,"(7.818934,-72.453226)"
2016,Julio,Ghana,288,0,5,5,"(0.814836,-77.662532)"
2016,Abril,Venezuela,862,137,162,299,"(7.927209,-72.507910)"
2018,Febrero,Suiza,756,19,31,50,"(3.541112,-76.384584)"
2019,Junio,Sudáfrica,710,1,1,2,"(0.814836,-77.662532)"
2019,Enero,Iraq,368,1,4,5,"(4.697144,-74.140516)"
2019,Mayo,Jamaica,388,1,1,2,"(12.586067,-81.702563)"
2021,Noviembre,El Salvador,222,16,17,33,"(10.886611,-74.776708)"
2017,Marzo,China,156,0,1,1,"(11.360009,-72.129330)"
2022,Mayo,Dinamarca,208,0,2,2,"(3.893038,-77.067921)"
2014,Agosto,Federación de Rusia,643,4,4,8,"(0.814836,-77.662532)"
2022,Octubre,Japón,392,13,20,33,"(6.171601,-75.427454)"
2020,Febrero,Filipinas,608,1,0,1,"(4.815061,-75.736532)"
2019,Octubre,Perú,604,2,4,6,"(8.36068,-72.409396)"
2012,Marzo,Japón,392,1,7,8,"(10.445761,-75.516429)"
2021,Febrero,Polonia,616,2,7,9,"(10.445761,-75.516429)"
2019,Julio,Venezuela,862,669,566,1236,"(7.088729,-70.740253)"
2017,Enero,Bulgaria,100,1,0,1,"(0.814836,-77.662532)"
2017,Julio,Eslovaquia,703,1,1,2,"(10.408582,-75.538003)"
2016,Marzo,Italia,380,0,2,2,"(8.066966,-76.735404)"
2023,Abril,Sudáfrica,710,1,0,1,"(0.814836,-77.662532)"
2015,Junio,Israel,376,0,1,1,"(7.818934,-72.453226)"
2021,Abril,San Cristóbal y Nevis,659,1,0,1,"(3.541112,-76.384584)"
2022,Julio,Japón,392,21,21,42,"(6.171601,-75.427454)"
2017,Agosto,Bulgaria,100,0,1,1,"(3.893038,-77.067921)"
2012,Mayo,Isla de Man,833,12,23,35,"(6.171601,-75.427454)"
2012,Noviembre,Países Bajos,528,120,177,297,"(6.171601,-75.427454)"
2014,Diciembre,Italia,380,47,122,169,"(6.171601,-75.427454)"
2014,Marzo,Italia,380,0,3,3,"(9.402978,-75.681599)"
2014,Abril,Brasil,76,37,82,119,"(3.541112,-76.384584)"
2023,Junio,Eslovaquia,703,0,3,3,"(10.408582,-75.538003)"
2016,Febrero,Ecuador,218,20,23,43,"(10.886611,-74.776708)"
2017,Marzo,Federación de Rusia,643,0,1,1,"(8.635765,-77.346578)"
2015,Agosto,Desconocido,99999,0,1,1,"(7.088729,-70.740253)"
2014,Marzo,Alemania,276,1,1,2,"(11.247723,-74.213989)"
2012,Julio,Polonia,616,3,8,11,"(10.408582,-75.538003)"
2021,Enero,Estados Unidos de América,840,1,7,8,"(10.408582,-75.538003)"
2017,Junio,España,724,2,3,5,"(-4.197703,-69.941278)"
2014,Agosto,Sri Lanka,144,4,8,12,"(4.697144,-74.140516)"
2022,Julio,Sudán,736,0,2,2,"(4.697144,-74.140516)"
2016,Marzo,México,484,4420,7038,11458,"(4.697144,-74.140516)"
2021,Abril,Argentina,32,2,14,16,"(4.815061,-75.736532)"
2016,Mayo,Estados Unidos de América,840,1,5,6,"(11.247723,-74.213989)"
2012,Julio,Gabón,266,1,0,1,"(4.697144,-74.140516)"
2017,Noviembre,Suiza,756,1,4,5,"(10.886611,-74.776708)"
2018,Septiembre,Uruguay,858,0,2,2,"(8.36068,-72.409396)"
2013,Abril,Dominica,212,0,1,1,"(6.171601,-75.427454)"
2023,Mayo,Estados Unidos de América,840,221,349,570,"(4.452882,-75.766298)"
2016,Abril,Grecia,300,15,38,53,"(4.697144,-74.140516)"
2023,Abril,Trinidad y Tobago,780,0,1,1,"(11.360009,-72.129330)"
2018,Enero,Reino Unido de Gran Bretaña e Irlanda del Norte,826,1,0,1,"(3.893038,-77.067921)"
2021,Abril,Paraguay,600,1,0,1,"(4.815061,-75.736532)"
2013,Abril,Malasia,458,6,24,30,"(4.697144,-74.140516)"
2012,Noviembre,Reino Unido de Gran Bretaña e Irlanda del Norte,826,1,0,1,"(7.927209,-72.507910)"
2018,Mayo,Costa Rica,188,22,25,47,"(10.886611,-74.776708)"
2022,Mayo,Indonesia,360,0,4,4,"(10.445761,-75.516429)"
2021,Noviembre,Desconocido,99999,0,2,2,"(10.886611,-74.776708)"
2015,Octubre,República de Tayikistán,762,0,1,1,"(4.697144,-74.140516)"
2013,Febrero,Eslovaquia,703,6,23,29,"(4.697144,-74.140516)"
2023,Enero,Países Bajos,528,36,25,61,"(10.408582,-75.538003)"
2018,Diciembre,Santa Lucia,662,0,2,2,"(6.171601,-75.427454)"
2014,Agosto,Jamaica,388,3,5,8,"(10.445761,-75.516429)"
2018,Septiembre,Estados Unidos de América,840,1,0,1,"(7.088729,-70.740253)"
2013,Noviembre,Rumania,642,0,1,1,"(3.893038,-77.067921)"
2017,Julio,República de Corea,410,2,2,4,"(-4.197703,-69.941278)"
2014,Noviembre,España,724,7,8,15,"(-4.197703,-69.941278)"
2014,Julio,Bahamas,44,0,1,1,"(10.886611,-74.776708)"
2022,Abril,Países Bajos,528,2,0,2,"(-4.197703,-69.941278)"
2013,Diciembre,Venezuela,862,149,218,367,"(0.814836,-77.662532)"
2021,Octubre,Irán,364,5,7,12,"(4.697144,-74.140516)"
2021,Junio,Bangladesh,50,0,1,1,"(-4.197703,-69.941278)"
2023,Marzo,Indonesia,360,4,1,5,"(6.171601,-75.427454)"
2012,Septiembre,Países Bajos,528,3,3,6,"(7.128456,-73.183637)"
2017,Octubre,Perú,604,130,331,461,"(0.814836,-77.662532)"
2023,Marzo,Belice,84,9,11,20,"(4.697144,-74.140516)"
2012,Agosto,Croacia,191,0,1,1,"(10.408582,-75.538003)"
2022,Diciembre,Italia,380,1,1,2,"(6.18189,-67.47535)"
2013,Diciembre,Bolivia,68,8,13,21,"(7.818934,-72.453226)"
2019,Abril,Bosnia y Herzegovina,70,0,2,2,"(6.171601,-75.427454)"
2014,Mayo,Dinamarca,208,0,6,6,"(-4.197703,-69.941278)"
2022,Junio,Venezuela,862,9,3,12,"(3.866713,-67.927521)"
2022,Abril,Venezuela,862,22,16,38,"(7.128456,-73.183637)"
2023,Febrero,Turquía,792,0,1,1,"(11.117806,-74.232622)"
2012,Noviembre,Argentina,32,268,190,458,"(12.586067,-81.702563)"
2018,Diciembre,Egipto,818,0,1,1,"(10.886611,-74.776708)"
2023,Junio,Filipinas,608,0,45,45,"(11.247723,-74.213989)"
2023,Febrero,México,484,5704,7538,13242,"(4.697144,-74.140516)"
2013,Noviembre,Rumania,642,1,2,3,"(6.171601,-75.427454)"
2016,Agosto,Trinidad y Tobago,780,6,21,27,"(6.171601,-75.427454)"
2016,Septiembre,Paraguay,600,0,4,4,"(0.814836,-77.662532)"
2020,Marzo,Austria,40,0,1,1,"(7.128456,-73.183637)"
2013,Abril,Nueva Zelanda,554,0,1,1,"(10.886611,-74.776708)"
2012,Septiembre,México,484,0,1,1,"(4.452882,-75.766298)"
2012,Mayo,Rumania,642,1,3,4,"(0.814836,-77.662532)"
2020,Noviembre,Alemania,276,0,1,1,"(8.635765,-77.346578)"
2012,Noviembre,Federación de Rusia,643,1,1,2,"(10.408582,-75.538003)"
2017,Julio,Israel,376,0,4,4,"(10.886611,-74.776708)"
2019,Octubre,Israel,376,12,39,51,"(10.445761,-75.516429)"
2017,Septiembre,Austria,40,5,8,13,"(10.408582,-75.538003)"
2017,Mayo,Canadá,124,2,3,5,"(-4.223468,-69.945098)"
2019,Mayo,Federación de Rusia,643,22,18,40,"(10.445761,-75.516429)"
2017,Noviembre,Israel,376,2,2,4,"(-4.223468,-69.945098)"
2015,Julio,Suiza,756,5,6,11,"(7.818934,-72.453226)"
2013,Mayo,Estonia,233,0,1,1,"(10.886611,-74.776708)"
2019,Octubre,Italia,380,35,47,82,"(7.818934,-72.453226)"
2019,Octubre,Francia,250,2,4,6,"(-4.197703,-69.941278)"
2016,Febrero,Estados Unidos de América,840,806,1249,2055,"(3.541112,-76.384584)"
2020,Marzo,Túnez,788,1,0,1,"(10.445761,-75.516429)"
2020,Febrero,Eslovaquia,703,0,1,1,"(0.814836,-77.662532)"
2014,Enero,República Dominicana,214,200,341,541,"(4.697144,-74.140516)"
2022,Mayo,España,724,1,0,1,"(11.117806,-74.232622)"
2018,Junio,Grecia,300,2,5,7,"(6.171601,-75.427454)"
2015,Abril,Uganda,800,1,2,3,"(4.697144,-74.140516)"
2022,Mayo,Nicaragua,558,8,7,15,"(10.886611,-74.776708)"
2023,Junio,Chile,152,2,0,2,"(8.635765,-77.346578)"
2012,Septiembre,Bulgaria,100,4,13,17,"(4.697144,-74.140516)"
2013,Febrero,Panamá,591,69,106,175,"(4.815061,-75.736532)"
2016,Abril,Suiza,756,2,9,11,"(8.635765,-77.346578)"
2016,Febrero,Jamaica,388,2,2,4,"(10.886611,-74.776708)"
2022,Julio,Cuba,192,0,2,2,"(0.814836,-77.662532)"
2022,Febrero,Hungría,348,73,101,174,"(4.697144,-74.140516)"
2014,Diciembre,Bélgica,56,3,4,7,"(13.3387613,-81.372937)"
2021,Diciembre,Costa Rica,188,206,177,383,"(10.445761,-75.516429)"
2017,Julio,Anguila/Territorio Británico de Ultramar,660,0,1,1,"(4.697144,-74.140516)"
2012,Enero,Estados Unidos de América,840,49,101,150,"(4.452882,-75.766298)"
2017,Enero,Suiza,756,2,0,2,"(0.25129,-76.875963)"
2021,Octubre,Líbano,422,0,1,1,"(11.360009,-72.129330)"
2020,Febrero,Polonia,616,1,3,4,"(7.818934,-72.453226)"
2021,Julio,Uruguay,858,1,4,5,"(4.815061,-75.736532)"
2018,Abril,Venezuela,862,39,51,90,"(0.25129,-76.875963)"
2018,Abril,Suiza,756,2,5,7,"(11.247723,-74.213989)"
2013,Julio,Nicaragua,558,5,1,6,"(3.541112,-76.384584)"
2013,Junio,Malí,466,0,1,1,"(4.697144,-74.140516)"
2022,Agosto,Alemania,276,240,343,583,"(6.171601,-75.427454)"
2012,Septiembre,Pakistán,586,2,6,8,"(4.697144,-74.140516)"
2023,Enero,Francia,250,6,9,15,"(7.916725,-72.462544)"
2019,Septiembre,Georgia,268,0,2,2,"(9.402978,-75.681599)"
2017,Abril,Australia,36,1,2,3,"(11.360009,-72.129330)"
2012,Junio,Nueva Zelanda,554,5,7,12,"(6.171601,-75.427454)"
2022,Febrero,Eslovenia,705,0,3,3,"(10.445761,-75.516429)"
2012,Marzo,Canadá,124,0,1,1,"(6.185799,-67.483929)"
2021,Agosto,Curazao,99999,1,1,2,"(4.697144,-74.140516)"
2016,Octubre,Paraguay,600,45,119,164,"(6.171601,-75.427454)"
2018,Octubre,República de Irlanda,372,4,5,9,"(3.541112,-76.384584)"
2012,Septiembre,Costa Rica,188,0,2,2,"(7.128456,-73.183637)"
2016,Febrero,Nicaragua,558,68,56,124,"(4.697144,-74.140516)"
2017,Marzo,España,724,5,40,45,"(10.886611,-74.776708)"
2022,Noviembre,Marruecos,504,2,0,2,"(3.541112,-76.384584)"
2018,Abril,Cuba,192,0,1,1,"(4.452882,-75.766298)"
2012,Septiembre,Panamá,591,1,2,3,"(11.360009,-72.129330)"
2022,Octubre,Líbano,422,0,1,1,"(10.886611,-74.776708)"
2023,Mayo,Israel,376,12,33,45,"(10.445761,-75.516429)"
2013,Mayo,Liechtenstein,438,0,1,1,"(4.697144,-74.140516)"
2014,Junio,Estonia,233,2,3,5,"(4.697144,-74.140516)"
2016,Mayo,República de Tayikistán,762,1,0,1,"(10.445761,-75.516429)"
2016,Julio,República Democrática del Congo,180,1,0,1,"(3.541112,-76.384584)"
2012,Febrero,Panamá,591,2,10,12,"(8.635765,-77.346578)"
2014,Julio,Uruguay,858,0,1,1,"(10.408582,-75.538003)"
2018,Septiembre,Bolivia,68,0,1,1,"(7.128456,-73.183637)"
2022,Julio,Trinidad y Tobago,780,1,2,3,"(7.927209,-72.507910)"
2019,Noviembre,Italia,380,8,21,29,"(0.814836,-77.662532)"
2023,Marzo,México,484,9,8,17,"(7.128456,-73.183637)"
2013,Agosto,Israel,376,14,24,38,"(3.541112,-76.384584)"
2013,Noviembre,España,724,1,5,6,"(7.818934,-72.453226)"
2017,Junio,China,156,4,9,13,"(0.814836,-77.662532)"
2021,Julio,Venezuela,862,17,13,30,"(7.128456,-73.183637)"
2018,Enero,Nueva Zelanda,554,21,24,45,"(10.445761,-75.516429)"
2016,Julio,Filipinas,608,1,0,1,"(7.927209,-72.507910)"
2019,Abril,Ecuador,218,0,3,3,"(-4.223468,-69.945098)"
2022,Noviembre,República Dominicana,214,139,264,403,"(10.886611,-74.776708)"
2015,Agosto,Italia,380,0,1,1,"(7.088729,-70.740253)"
2021,Marzo,Nicaragua,558,2,6,8,"(10.445761,-75.516429)"
2019,Febrero,Guyana,328,1,3,4,"(10.445761,-75.516429)"
2020,Septiembre,Barbados,52,0,1,1,"(6.171601,-75.427454)"
2014,Noviembre,Australia,36,2,3,5,"(7.818934,-72.453226)"
2018,Febrero,Honduras,340,0,13,13,"(10.408582,-75.538003)"
2014,Septiembre,Paraguay,600,34,26,60,"(12.586067,-81.702563)"
2015,Junio,Ecuador,218,0,1,1,"(4.452882,-75.766298)"
2012,Enero,Israel,376,0,3,3,"(12.586067,-81.702563)"
2022,Septiembre,Lituania,440,0,1,1,"(3.541112,-76.384584)"
2013,Mayo,Reino Unido de Gran Bretaña e Irlanda del Norte,826,8,22,30,"(3.541112,-76.384584)"
2023,Abril,Marruecos,504,8,8,16,"(10.445761,-75.516429)"
2019,Mayo,Estados Unidos de América,840,0,1,1,"(10.971302,-74.765397)"
2019,Agosto,Noruega,578,11,10,21,"(10.445761,-75.516429)"
2023,Febrero,Georgia,268,0,2,2,"(10.971302,-74.765397)"
2018,Septiembre,Eslovenia,705,30,28,58,"(4.697144,-74.140516)"
2017,Mayo,Senegal,686,0,1,1,"(10.445761,-75.516429)"
2015,Abril,México,484,27,19,46,"(10.408582,-75.538003)"
2013,Julio,Uruguay,858,26,60,86,"(6.171601,-75.427454)"
2019,Enero,Portugal,620,0,1,1,"(12.586067,-81.702563)"
2016,Marzo,Islandia,352,10,21,31,"(4.697144,-74.140516)"
2014,Junio,Honduras,340,0,1,1,"(11.247723,-74.213989)"
2012,Noviembre,Federación de Rusia,643,1,4,5,"(6.171601,-75.427454)"
2020,Mayo,Perú,604,0,4,4,"(6.171601,-75.427454)"
2014,Septiembre,República de Corea,410,0,1,1,"(-4.197703,-69.941278)"
2019,Septiembre,India,356,2,19,21,"(10.886611,-74.776708)"
2017,Marzo,Haití,332,1,3,4,"(6.171601,-75.427454)"
2014,Octubre,Hungría,348,22,32,54,"(4.697144,-74.140516)"
2013,Octubre,Perú,604,40,30,70,"(10.408582,-75.538003)"
2014,Febrero,Serbia,688,0,1,1,"(10.408582,-75.538003)"
2020,Agosto,Francia,250,0,1,1,"(-4.197703,-69.941278)"
2022,Febrero,Eslovenia,705,0,2,2,"(6.171601,-75.427454)"
2013,Marzo,Guayana Francesa/Departamento de Ultramar Francés,254,0,1,1,"(4.697144,-74.140516)"
2015,Septiembre,Tailandia,764,10,16,26,"(4.697144,-74.140516)"
2017,Julio,República Dominicana,214,1,7,8,"(2.947286,-75.29321)"
2019,Diciembre,República Dominicana,214,0,2,2,"(4.452882,-75.766298)"
2018,Marzo,Alemania,276,244,276,520,"(10.445761,-75.516429)"
2017,Mayo,Belice,84,0,1,1,"(6.171601,-75.427454)"
2019,Abril,Rumania,642,9,11,20,"(6.171601,-75.427454)"
2014,Enero,Argentina,32,291,218,509,"(12.586067,-81.702563)"
2023,Marzo,Luxemburgo,442,1,3,4,"(0.814836,-77.662532)"
2019,Junio,Perú,604,0,1,1,"(7.088729,-70.740253)"
2014,Marzo,Bahamas,44,0,6,6,"(4.697144,-74.140516)"
2019,Enero,Bélgica,56,13,24,37,"(3.541112,-76.384584)"
2021,Noviembre,China,156,20,22,42,"(6.171601,-75.427454)"
2012,Septiembre,España,724,3,8,11,"(12.586067,-81.702563)"
2019,Agosto,México,484,3,11,14,"(8.36068,-72.409396)"
2012,Agosto,Perú,604,88,101,189,"(3.541112,-76.384584)"
2012,Julio,Turquía,792,0,26,26,"(10.445761,-75.516429)"
2022,Febrero,Alemania,276,1,1,2,"(11.247723,-74.213989)"
2016,Julio,Australia,36,0,1,1,"(7.818934,-72.453226)"
2016,Noviembre,Eslovenia,705,12,35,47,"(4.697144,-74.140516)"
2012,Enero,Alemania,276,8,21,29,"(11.360009,-72.129330)"
2016,Diciembre,Polonia,616,1,16,17,"(10.408582,-75.538003)"
2019,Febrero,República de Corea,410,0,2,2,"(10.886611,-74.776708)"
2023,Febrero,Brasil,76,18,29,47,"(10.886611,-74.776708)"
2013,Marzo,Lituania,440,0,1,1,"(10.408582,-75.538003)"
2023,Febrero,México,484,139,203,342,"(3.541112,-76.384584)"
2016,Mayo,Egipto,818,0,1,1,"(0.814836,-77.662532)"
2018,Mayo,Federación de Rusia,643,1,2,3,"(7.128456,-73.183637)"
2022,Julio,India,356,0,2,2,"(-4.197703,-69.941278)"
2021,Mayo,Líbano,422,1,0,1,"(10.886611,-74.776708)"
2012,Enero,España,724,0,1,1,"(11.360009,-72.129330)"
2023,Enero,Tailandia,764,1,0,1,"(10.886611,-74.776708)"
2021,Junio,Nigeria,566,0,1,1,"(-4.197703,-69.941278)"
2012,Abril,Grecia,300,0,1,1,"(11.360009,-72.129330)"
2017,Octubre,República Democrática de Timor Oriental,626,0,1,1,"(4.697144,-74.140516)"
2012,Abril,Países Bajos,528,3,3,6,"(10.886611,-74.776708)"
2012,Julio,Reino Unido de Gran Bretaña e Irlanda del Norte,826,5,16,21,"(-4.197703,-69.941278)"
2022,Febrero,República de Corea,410,6,3,9,"(10.445761,-75.516429)"
2020,Diciembre,Venezuela,862,4118,4393,8511,"(4.697144,-74.140516)"
2020,Enero,Egipto,818,5,31,36,"(4.697144,-74.140516)"
2013,Diciembre,Sudáfrica,710,1,1,2,"(10.971302,-74.765397)"
2018,Octubre,Chile,152,178,120,298,"(12.586067,-81.702563)"
2014,Abril,Zimbabue,716,0,4,4,"(6.171601,-75.427454)"
2014,Diciembre,Dinamarca,208,1,0,1,"(-4.197703,-69.941278)"
2013,Febrero,Perú,604,0,1,1,"(4.452882,-75.766298)"
2016,Mayo,Croacia,191,6,26,32,"(4.697144,-74.140516)"
2022,Septiembre,Libia,434,0,1,1,"(4.697144,-74.140516)"
2014,Junio,Costa Rica,188,13,41,54,"(3.541112,-76.384584)"
2019,Marzo,Guatemala,320,0,2,2,"(11.360009,-72.129330)"
2018,Diciembre,Francia,250,0,2,2,"(7.128456,-73.183637)"
2019,Enero,Taiwán,158,7,3,10,"(3.541112,-76.384584)"
2017,Abril,Rumania,642,5,4,9,"(3.541112,-76.384584)"
2023,Febrero,Francia,250,6,14,20,"(-4.223468,-69.945098)"
2013,Mayo,Italia,380,2,5,7,"(8.635765,-77.346578)"
2012,Septiembre,Canadá,124,1,2,3,"(7.927209,-72.507910)"
2021,Abril,Ecuador,218,6,9,15,"(10.886611,-74.776708)"
2012,Junio,Reino Unido de Gran Bretaña e Irlanda del Norte,826,50,44,94,"(0.814836,-77.662532)"
2013,Septiembre,Bolivia,68,2,0,2,"(10.886611,-74.776708)"
2016,Noviembre,México,484,419,1125,1544,"(6.171601,-75.427454)"
2022,Septiembre,Venezuela,862,5903,5219,11123,"(7.818934,-72.453226)"
2015,Junio,Kazajistán,398,4,4,8,"(4.697144,-74.140516)"
2013,Octubre,Rumania,642,1,2,3,"(10.445761,-75.516429)"
2016,Mayo,Sudáfrica,710,5,3,8,"(0.814836,-77.662532)"
2015,Agosto,China,156,23,35,58,"(6.171601,-75.427454)"
2021,Septiembre,Líbano,422,0,1,1,"(7.818934,-72.453226)"
2018,Abril,Luxemburgo,442,2,1,3,"(10.445761,-75.516429)"
2015,Septiembre,Zambia,894,1,3,4,"(6.171601,-75.427454)"
2022,Julio,Francia,250,11,14,25,"(4.815061,-75.736532)"
2022,Octubre,Trinidad y Tobago,780,0,2,2,"(10.886611,-74.776708)"
2021,Septiembre,Somalia,706,0,1,1,"(4.697144,-74.140516)"
2023,Marzo,Reino Unido de Gran Bretaña e Irlanda del Norte,826,33,48,81,"(3.541112,-76.384584)"
2021,Agosto,San Cristóbal y Nevis,659,0,1,1,"(6.171601,-75.427454)"
2013,Abril,Estados Unidos de América,840,1,1,2,"(6.185799,-67.483929)"
2018,Diciembre,España,724,0,10,10,"(11.360009,-72.129330)"
2018,Septiembre,Brasil,76,1,0,1,"(-4.223468,-69.945098)"
2015,Diciembre,Chile,152,41,20,61,"(10.408582,-75.538003)"
2017,Marzo,Taiwán,158,1,4,5,"(10.886611,-74.776708)"
2013,Octubre,India,356,1,16,17,"(10.445761,-75.516429)"
2022,Marzo,Suiza,756,12,13,25,"(10.408582,-75.538003)"
2020,Febrero,China,156,254,604,858,"(4.697144,-74.140516)"
2015,Septiembre,India,356,0,5,5,"(0.814836,-77.662532)"
2019,Mayo,Bélgica,56,166,333,499,"(4.697144,-74.140516)"
2016,Agosto,España,724,12,14,26,"(12.586067,-81.702563)"
2012,Noviembre,Reino Unido de Gran Bretaña e Irlanda del Norte,826,4,4,8,"(4.697144,-74.140516)"
2014,Mayo,Perú,604,116,93,209,"(10.445761,-75.516429)"
2023,Marzo,Ghana,288,0,2,2,"(10.445761,-75.516429)"
2018,Octubre,Federación de Rusia,643,21,10,31,"(10.445761,-75.516429)"
2015,Diciembre,Líbano,422,0,1,1,"(3.541112,-76.384584)"
2022,Noviembre,México,484,1,1,2,"(8.36068,-72.409396)"
2015,Junio,Australia,36,7,8,15,"(8.635765,-77.346578)"
2015,Diciembre,Paraguay,600,10,6,16,"(6.171601,-75.427454)"
2023,Febrero,Ecuador,218,23,13,36,"(12.586067,-81.702563)"
2016,Febrero,Sudáfrica,710,2,3,5,"(0.814836,-77.662532)"
2020,Octubre,Eslovaquia,703,2,7,9,"(4.697144,-74.140516)"
2013,Enero,Trinidad y Tobago,780,0,2,2,"(12.5744111,-81.703935)"
2015,Marzo,Nicaragua,558,2,0,2,"(10.886611,-74.776708)"
2014,Diciembre,Federación de Rusia,643,1,0,1,"(7.128456,-73.183637)"
2017,Junio,Marruecos,504,0,2,2,"(6.171601,-75.427454)"
2023,Junio,República de Irlanda,372,0,1,1,"(-4.197703,-69.941278)"
2022,Octubre,Paraguay,600,5,2,7,"(11.117806,-74.232622)"
2015,Mayo,México,484,12,17,29,"(0.814836,-77.662532)"
2012,Febrero,Pakistán,586,0,1,1,"(6.171601,-75.427454)"
2012,Junio,Gabón,266,1,2,3,"(4.697144,-74.140516)"
2018,Febrero,Federación de Rusia,643,7,6,13,"(3.541112,-76.384584)"
2012,Enero,Perú,604,182,358,540,"(6.171601,-75.427454)"
2012,Septiembre,Malasia,458,1,4,5,"(10.445761,-75.516429)"
2019,Julio,Brasil,76,116,108,224,"(12.586067,-81.702563)"
2014,Enero,Francia,250,1,5,6,"(12.586067,-81.702563)"
2014,Octubre,Ecuador,218,425,549,974,"(3.541112,-76.384584)"
2013,Agosto,España,724,1,15,16,"(10.886611,-74.776708)"
2023,Mayo,Rumania,642,31,38,69,"(6.171601,-75.427454)"
2017,Abril,Australia,36,13,9,22,"(8.635765,-77.346578)"
2019,Noviembre,Ecuador,218,0,2,2,"(3.866713,-67.927521)"
2014,Agosto,Islandia,352,0,1,1,"(11.247723,-74.213989)"
2014,Julio,Austria,40,1,0,1,"(0.25129,-76.875963)"
2019,Noviembre,Bahréin,48,2,3,5,"(4.697144,-74.140516)"
2017,Mayo,Nigeria,566,0,1,1,"(10.886611,-74.776708)"
2017,Junio,Guatemala,320,417,658,1075,"(4.697144,-74.140516)"
2021,Noviembre,Ghana,288,0,4,4,"(4.697144,-74.140516)"
2019,Febrero,Taiwán,158,4,1,5,"(10.445761,-75.516429)"
2017,Febrero,Bolivia,68,1,0,1,"(8.635765,-77.346578)"
2018,Agosto,Cuba,192,11,15,26,"(10.445761,-75.516429)"
2015,Agosto,San  Vicente y las Granadinas,670,2,2,4,"(4.697144,-74.140516)"
2016,Enero,Ucrania,804,1,11,12,"(10.408582,-75.538003)"
2023,Mayo,Alemania,276,1,1,2,"(13.3387613,-81.372937)"
2015,Diciembre,Suecia,752,1,1,2,"(12.586067,-81.702563)"
2014,Diciembre,Nueva Zelanda,554,9,12,21,"(10.445761,-75.516429)"
2012,Agosto,Portugal,620,4,7,11,"(3.541112,-76.384584)"
2022,Abril,Marruecos,504,9,25,34,"(4.697144,-74.140516)"
2019,Mayo,México,484,459,1209,1669,"(6.171601,-75.427454)"
2019,Julio,Chile,152,7,19,26,"(7.818934,-72.453226)"
2016,Noviembre,Eslovenia,705,0,1,1,"(8.635765,-77.346578)"
2021,Octubre,Cuba,192,14,20,34,"(10.445761,-75.516429)"
2018,Mayo,Taiwán,158,7,17,24,"(6.171601,-75.427454)"
2020,Diciembre,Emiratos Árabes,784,1,2,3,"(4.697144,-74.140516)"
2012,Enero,Lituania,440,2,1,3,"(3.541112,-76.384584)"
2018,Julio,Guatemala,320,0,1,1,"(-0.193180,-74.784874)"
2018,Mayo,República Democrática del Congo,180,1,0,1,"(0.814836,-77.662532)"
2016,Noviembre,Irán,364,0,1,1,"(10.886611,-74.776708)"
2021,Julio,Canadá,124,0,1,1,"(4.452882,-75.766298)"
2020,Diciembre,Perú,604,73,109,182,"(3.541112,-76.384584)"
2019,Febrero,Burkina Faso,854,2,1,3,"(4.697144,-74.140516)"
2019,Septiembre,Francia,250,9,7,16,"(-4.197703,-69.941278)"
2014,Septiembre,Honduras,340,0,1,1,"(11.247723,-74.213989)"
2019,Marzo,Hungría,348,0,1,1,"(0.25129,-76.875963)"
2022,Septiembre,Venezuela,862,6621,6261,12882,"(4.697144,-74.140516)"
2015,Noviembre,Belice,84,1,0,1,"(10.445761,-75.516429)"
2023,Febrero,Ecuador,218,10,11,21,"(4.815061,-75.736532)"
2017,Enero,Lituania,440,1,0,1,"(12.5744111,-81.703935)"
2012,Septiembre,India,356,0,1,1,"(-4.197703,-69.941278)"
2013,Julio,El Salvador,222,0,1,1,"(7.927209,-72.507910)"
2022,Diciembre,Filipinas,608,0,51,51,"(10.971302,-74.765397)"
2014,Septiembre,Jamaica,388,0,1,1,"(4.815061,-75.736532)"
2016,Noviembre,Francia,250,9,10,19,"(11.247723,-74.213989)"
2021,Septiembre,Liberia,430,0,1,1,"(10.445761,-75.516429)"
2019,Noviembre,Brasil,76,748,614,1363,"(10.445761,-75.516429)"
2022,Mayo,Albania,8,2,0,2,"(10.445761,-75.516429)"
2017,Febrero,Croacia,191,0,5,5,"(3.893038,-77.067921)"
2019,Febrero,Venezuela,862,18,40,58,"(7.927209,-72.507910)"
2016,Diciembre,Arabia Saudita,682,0,1,1,"(3.541112,-76.384584)"
2015,Septiembre,Croacia,191,1,2,3,"(3.541112,-76.384584)"
2014,Enero,Federación de Rusia,643,0,4,4,"(9.402978,-75.681599)"
2023,Junio,Italia,380,23,58,81,"(7.818934,-72.453226)"
2017,Marzo,Paraguay,600,1,1,2,"(7.818934,-72.453226)"
2019,Junio,Estados Unidos de América,840,1,1,2,"(6.185799,-67.483929)"
2012,Junio,Noruega,578,105,172,277,"(4.697144,-74.140516)"
2014,Septiembre,Rumania,642,0,1,1,"(10.445761,-75.516429)"
2021,Noviembre,Surinam,740,0,2,2,"(10.445761,-75.516429)"
2020,Enero,Uruguay,858,0,2,2,"(0.25129,-76.875963)"
2021,Octubre,Kenia,404,1,1,2,"(10.445761,-75.516429)"
2018,Julio,Ecuador,218,1,2,3,"(4.452882,-75.766298)"
2017,Mayo,Dominica,212,1,2,3,"(6.171601,-75.427454)"
2016,Febrero,Anguila/Territorio Británico de Ultramar,660,0,1,1,"(4.697144,-74.140516)"
2022,Agosto,Estados Unidos de América,840,114,140,254,"(12.586067,-81.702563)"
2015,Marzo,Israel,376,0,2,2,"(8.635765,-77.346578)"
2015,Diciembre,Indonesia,360,0,3,3,"(3.893038,-77.067921)"
2017,Noviembre,Ecuador,218,0,1,1,"(3.893038,-77.067921)"
2012,Marzo,Eslovenia,705,1,0,1,"(-4.197703,-69.941278)"
2022,Julio,Costa Rica,188,5,2,7,"(7.128456,-73.183637)"
2022,Febrero,Bolivia,68,18,24,42,"(6.171601,-75.427454)"
2023,Marzo,Mauritania,478,0,1,1,"(4.697144,-74.140516)"
2012,Octubre,Perú,604,93,281,374,"(0.814836,-77.662532)"
2016,Noviembre,Costa Rica,188,76,154,230,"(6.171601,-75.427454)"
2023,Febrero,Polonia,616,53,79,132,"(10.445761,-75.516429)"
2015,Agosto,Federación de Rusia,643,7,5,12,"(10.445761,-75.516429)"
2021,Septiembre,Venezuela,862,2,1,3,"(4.452882,-75.766298)"
2012,Mayo,Reino Unido de Gran Bretaña e Irlanda del Norte,826,14,15,29,"(0.814836,-77.662532)"
2016,Julio,Antigua y Barbuda,28,0,1,1,"(6.171601,-75.427454)"
2019,Abril,Argentina,32,9,14,23,"(0.25129,-76.875963)"
2018,Enero,Venezuela,862,3,1,4,"(8.635765,-77.346578)"
2013,Agosto,Granada,308,0,2,2,"(6.171601,-75.427454)"
2014,Abril,Suecia,752,1,1,2,"(6.228046,-77.404104)"
2022,Abril,España,724,0,7,7,"(4.452882,-75.766298)"
2018,Noviembre,Venezuela,862,1078,1011,2089,"(7.088729,-70.740253)"
2016,Diciembre,Estonia,233,1,0,1,"(10.886611,-74.776708)"
2013,Mayo,Países Bajos,528,123,248,371,"(4.697144,-74.140516)"
2022,Abril,Reino Unido de Gran Bretaña e Irlanda del Norte,826,0,5,5,"(4.815061,-75.736532)"
2015,Noviembre,Omán,512,0,1,1,"(4.697144,-74.140516)"
2019,Julio,Panamá,591,1216,1173,2389,"(6.171601,-75.427454)"
2018,Agosto,Bahamas,44,4,1,5,"(3.541112,-76.384584)"
2021,Diciembre,Costa Rica,188,33,39,72,"(10.886611,-74.776708)"
2018,Noviembre,Chile,152,1,0,1,"(-4.197703,-69.941278)"
2018,Diciembre,Kuwait,414,0,3,3,"(10.445761,-75.516429)"
2019,Octubre,Estonia,233,0,2,2,"(10.445761,-75.516429)"
2014,Septiembre,Brasil,76,181,295,476,"(6.171601,-75.427454)"
2019,Noviembre,Letonia,428,2,2,4,"(6.171601,-75.427454)"
2016,Diciembre,Singapur,702,22,29,51,"(4.697144,-74.140516)"
2018,Agosto,Honduras,340,0,1,1,"(7.128456,-73.183637)"
2016,Diciembre,Costa Rica,188,0,1,1,"(7.818934,-72.453226)"
2015,Agosto,Noruega,578,72,125,197,"(4.697144,-74.140516)"
2023,Abril,Japón,392,1,1,2,"(8.635765,-77.346578)"
2015,Mayo,Rumania,642,0,3,3,"(0.814836,-77.662532)"
2018,Septiembre,Irán,364,3,10,14,"(4.697144,-74.140516)"
2013,Febrero,Letonia,428,0,2,2,"(10.408582,-75.538003)"
2018,Septiembre,Cuba,192,20,48,68,"(3.541112,-76.384584)"
2016,Julio,Austria,40,0,3,3,"(12.586067,-81.702563)"
2015,Febrero,Filipinas,608,0,7,7,"(8.066966,-76.735404)"
2022,Febrero,Argentina,32,4,7,11,"(7.818934,-72.453226)"
2016,Septiembre,Portugal,620,0,3,3,"(11.360009,-72.129330)"
2019,Febrero,Argelia,12,1,1,2,"(10.445761,-75.516429)"
2014,Julio,Ecuador,218,3,9,12,"(10.886611,-74.776708)"
2023,Enero,Francia,250,1,1,2,"(7.088729,-70.740253)"
2021,Julio,Islas Heard Y Mcdonald,334,1,0,1,"(4.697144,-74.140516)"
2016,Noviembre,Suecia,752,1,2,3,"(-4.197703,-69.941278)"
2019,Abril,Bélgica,56,1,0,1,"(7.128456,-73.183637)"
2019,Agosto,Suiza,756,20,29,49,"(3.541112,-76.384584)"
2019,Junio,Reino Unido de Gran Bretaña e Irlanda del Norte,826,115,167,282,"(10.445761,-75.516429)"
2023,Abril,Paraguay,600,0,1,1,"(7.916725,-72.462544)"
2012,Febrero,Países Bajos,528,2,2,4,"(7.927209,-72.507910)"
2016,Junio,República de Moldavia,498,4,0,4,"(4.697144,-74.140516)"
2016,Abril,Ecuador,218,11,7,18,"(4.815061,-75.736532)"
2015,Abril,Noruega,578,2,3,5,"(10.886611,-74.776708)"
2017,Mayo,Federación de Rusia,643,0,1,1,"(11.247723,-74.213989)"
2019,Julio,Islas Vírgenes Británicas/Territorio Británico de Ultramar,92,0,1,1,"(4.697144,-74.140516)"
2017,Abril,Polonia,616,1,0,1,"(0.25129,-76.875963)"
2021,Diciembre,Perú,604,0,1,1,"(12.165168,-71.983761)"
2020,Marzo,Burundi,108,1,0,1,"(3.541112,-76.384584)"
2015,Agosto,Senegal,686,1,4,5,"(4.697144,-74.140516)"
2014,Julio,Estados Unidos de América,840,69,66,135,"(-4.197703,-69.941278)"
2013,Septiembre,México,484,3,6,9,"(7.927209,-72.507910)"
2019,Noviembre,España,724,2,5,7,"(12.586067,-81.702563)"
2019,Mayo,Bulgaria,100,0,1,1,"(8.36068,-72.409396)"
2013,Enero,Nepal,524,0,2,2,"(4.697144,-74.140516)"
2018,Abril,Zimbabue,716,0,3,3,"(4.697144,-74.140516)"
2017,Febrero,Perú,604,7,11,18,"(0.25129,-76.875963)"
2022,Diciembre,China,156,4,2,6,"(7.128456,-73.183637)"
2013,Abril,Trinidad y Tobago,780,1,0,1,"(4.815061,-75.736532)"
2022,Junio,China,156,200,515,715,"(4.697144,-74.140516)"
2015,Julio,Canadá,124,135,236,371,"(6.171601,-75.427454)"
2021,Octubre,Ecuador,218,2,1,3,"(4.452882,-75.766298)"
2023,Junio,Serbia,688,0,1,1,"(3.541112,-76.384584)"
2019,Septiembre,Surinam,740,1,0,1,"(3.541112,-76.384584)"
2017,Octubre,Islas Caimán/Territorio Británico de Ultramar,136,1,0,1,"(3.541112,-76.384584)"
2018,Abril,Líbano,422,1,0,1,"(11.360009,-72.129330)"
2019,Junio,Japón,392,0,1,1,"(8.635765,-77.346578)"
2023,Marzo,Austria,40,1,0,1,"(4.815061,-75.736532)"
2017,Noviembre,Brasil,76,99,96,195,"(-4.197703,-69.941278)"
2019,Abril,Tailandia,764,21,16,37,"(4.697144,-74.140516)"
2018,Agosto,Bélgica,56,4,2,6,"(-4.197703,-69.941278)"
2018,Marzo,Taiwán,158,1,0,1,"(-4.197703,-69.941278)"
2018,Junio,República de Corea,410,1,2,3,"(10.408582,-75.538003)"
2016,Julio,Cabo Verde,132,1,0,1,"(6.171601,-75.427454)"
2017,Abril,Indonesia,360,1,17,18,"(10.445761,-75.516429)"
2017,Octubre,Países Bajos,528,15,21,36,"(0.814836,-77.662532)"
2015,Julio,Taiwán,158,3,9,12,"(6.171601,-75.427454)"
2023,Junio,Reino Unido de Gran Bretaña e Irlanda del Norte,826,1,1,2,"(11.360009,-72.129330)"
2016,Octubre,Turquía,792,2,23,25,"(6.171601,-75.427454)"
2016,Mayo,Costa Rica,188,1,0,1,"(7.927209,-72.507910)"
2021,Julio,México,484,1,5,6,"(4.452882,-75.766298)"
2018,Julio,Países Bajos,528,0,1,1,"(8.36068,-72.409396)"
2018,Julio,Santa Lucia,662,1,3,4,"(10.445761,-75.516429)"
2022,Diciembre,Granada,308,0,1,1,"(7.818934,-72.453226)"
2017,Junio,Federación de Rusia,643,148,157,305,"(4.697144,-74.140516)"
2012,Septiembre,Chile,152,0,1,1,"(10.408582,-75.538003)"
2018,Julio,Brasil,76,2,1,3,"(7.128456,-73.183637)"
2022,Agosto,México,484,6,7,13,"(11.117806,-74.232622)"
2022,Junio,Países Bajos,528,34,65,99,"(3.541112,-76.384584)"
2016,Noviembre,Federación de Rusia,643,0,2,2,"(11.360009,-72.129330)"
2022,Marzo,España,724,12,13,25,"(11.360009,-72.129330)"
2014,Octubre,Turquía,792,28,104,132,"(4.697144,-74.140516)"
2013,Mayo,España,724,38,62,100,"(3.541112,-76.384584)"
2017,Octubre,Argentina,32,3,0,3,"(4.452882,-75.766298)"
2019,Agosto,Japón,392,192,476,668,"(4.697144,-74.140516)"
2023,Enero,Noruega,578,24,37,61,"(6.171601,-75.427454)"
2017,Noviembre,Alemania,276,105,161,266,"(10.445761,-75.516429)"
2012,Julio,República Dominicana,214,35,54,89,"(6.171601,-75.427454)"
2013,Agosto,Honduras,340,3,1,4,"(-4.197703,-69.941278)"
2015,Mayo,Guinea,324,0,1,1,"(4.697144,-74.140516)"
2012,Septiembre,Argentina,32,1,1,2,"(4.452882,-75.766298)"
2019,Febrero,Alemania,276,7,13,20,"(-4.197703,-69.941278)"
2022,Septiembre,Polonia,616,173,203,376,"(4.697144,-74.140516)"
2020,Noviembre,Australia,36,0,1,1,"(3.541112,-76.384584)"
2019,Mayo,República de Kosovo,901,2,0,2,"(4.697144,-74.140516)"
2021,Marzo,Sudáfrica,710,0,1,1,"(10.408582,-75.538003)"
2016,Febrero,Costa Rica,188,653,958,1611,"(4.697144,-74.140516)"
2013,Septiembre,Nicaragua,558,0,1,1,"(12.5744111,-81.703935)"
2012,Julio,Estados Unidos de América,840,0,1,1,"(12.5744111,-81.703935)"
2013,Agosto,Bolivia,68,28,23,51,"(10.445761,-75.516429)"
2017,Agosto,Sudáfrica,710,2,3,5,"(-4.197703,-69.941278)"
2016,Febrero,Sudán,736,0,2,2,"(4.697144,-74.140516)"
2020,Marzo,Israel,376,0,3,3,"(10.886611,-74.776708)"
2013,Febrero,Venezuela,862,6493,7160,13653,"(4.697144,-74.140516)"
2013,Mayo,Argentina,32,0,1,1,"(6.185799,-67.483929)"
2015,Junio,Italia,380,30,99,129,"(6.171601,-75.427454)"
2022,Febrero,Bélgica,56,4,9,13,"(3.541112,-76.384584)"
2017,Enero,España,724,0,1,1,"(4.452882,-75.766298)"
2017,Abril,Kazajistán,398,3,3,6,"(4.697144,-74.140516)"
2019,Mayo,Guatemala,320,405,751,1156,"(4.697144,-74.140516)"
2023,Enero,Francia,250,2,8,10,"(8.364293,-72.405710)"
2023,Febrero,Reino Unido de Gran Bretaña e Irlanda del Norte,826,15,16,31,"(10.408582,-75.538003)"
2014,Abril,Eslovaquia,703,1,2,3,"(0.814836,-77.662532)"
2016,Junio,Grecia,300,0,3,3,"(9.402978,-75.681599)"
2012,Septiembre,Alemania,276,8,5,13,"(7.818934,-72.453226)"
2013,Diciembre,Ecuador,218,7,12,19,"(10.886611,-74.776708)"
2016,Diciembre,Estados Unidos de América,840,57,78,135,"(12.586067,-81.702563)"
2016,Febrero,México,484,3048,5932,8980,"(4.697144,-74.140516)"
2014,Mayo,Canadá,124,3,4,7,"(-4.197703,-69.941278)"
2017,Septiembre,Desconocido,99999,0,1,1,"(11.360009,-72.129330)"
2021,Junio,Grecia,300,0,1,1,"(10.408582,-75.538003)"
2012,Octubre,Letonia,428,0,3,3,"(6.171601,-75.427454)"
2014,Enero,Países Bajos,528,2,7,9,"(8.635765,-77.346578)"
2013,Mayo,Argentina,32,0,1,1,"(13.3387613,-81.372937)"
2013,Agosto,Estados Unidos de América,840,2,0,2,"(0.25129,-76.875963)"
2012,Mayo,Ecuador,218,240,312,552,"(3.541112,-76.384584)"
2015,Mayo,Nigeria,566,0,1,1,"(7.818934,-72.453226)"
2015,Mayo,Kenia,404,1,1,2,"(10.445761,-75.516429)"
2020,Octubre,Tailandia,764,0,1,1,"(6.171601,-75.427454)"
2022,Enero,Nicaragua,558,22,18,40,"(3.541112,-76.384584)"
2019,Julio,Hong Kong,344,14,23,37,"(4.697144,-74.140516)"
2012,Junio,Ecuador,218,1,11,12,"(10.886611,-74.776708)"
2014,Diciembre,Antigua y Barbuda,28,0,1,1,"(11.360009,-72.129330)"
2012,Septiembre,República de Irlanda,372,1,5,6,"(10.886611,-74.776708)"
2016,Diciembre,Paraguay,600,1,10,11,"(10.886611,-74.776708)"
2019,Noviembre,México,484,0,2,2,"(8.635765,-77.346578)"
2022,Agosto,Reino Unido de Gran Bretaña e Irlanda del Norte,826,21,19,40,"(0.814836,-77.662532)"
2020,Enero,España,724,57,91,148,"(0.814836,-77.662532)"
2022,Marzo,Bolivia,68,0,1,1,"(7.916725,-72.462544)"
2018,Noviembre,Bolivia,68,1,0,1,"(11.360009,-72.129330)"
2023,Marzo,Brasil,76,0,1,1,"(3.866713,-67.927521)"
2017,Febrero,Bolivia,68,10,14,24,"(0.814836,-77.662532)"
2018,Agosto,Francia,250,18,17,35,"(4.815061,-75.736532)"
2022,Agosto,Honduras,340,3,3,6,"(7.818934,-72.453226)"
2014,Mayo,Venezuela,862,909,1464,2373,"(11.360009,-72.129330)"
2023,Enero,Macedonia,807,2,8,10,"(6.171601,-75.427454)"
2017,Diciembre,Croacia,191,0,1,1,"(10.408582,-75.538003)"
2014,Febrero,Nueva Zelanda,554,2,2,4,"(11.360009,-72.129330)"
2022,Diciembre,Malawi,454,0,1,1,"(4.697144,-74.140516)"
2014,Septiembre,Ecuador,218,27,67,94,"(0.25129,-76.875963)"
2020,Marzo,Italia,380,1,1,2,"(0.25129,-76.875963)"
2020,Febrero,México,484,0,1,1,"(7.916725,-72.462544)"
2012,Septiembre,Surinam,740,13,15,28,"(4.697144,-74.140516)"
2015,Julio,Países Bajos,528,0,1,1,"(11.247723,-74.213989)"
2022,Noviembre,Chile,152,4,8,12,"(11.360009,-72.129330)"
2021,Junio,El Salvador,222,10,8,18,"(3.541112,-76.384584)"
2022,Abril,Panamá,591,567,475,1042,"(10.445761,-75.516429)"
2021,Enero,Ucrania,804,71,88,159,"(4.697144,-74.140516)"
2018,Junio,Suiza,756,373,593,966,"(4.697144,-74.140516)"
2013,Abril,Brasil,76,104,127,231,"(10.445761,-75.516429)"
2018,Abril,Honduras,340,0,2,2,"(7.818934,-72.453226)"
2020,Febrero,México,484,0,12,12,"(1.813928,-78.763924)"
2019,Noviembre,Costa Rica,188,7,8,15,"(4.815061,-75.736532)"
2013,Mayo,Dinamarca,208,1,0,1,"(-4.197703,-69.941278)"
2022,Febrero,Kazajistán,398,0,2,2,"(3.541112,-76.384584)"
2021,Diciembre,Noruega,578,0,3,3,"(10.408582,-75.538003)"
2012,Noviembre,Andorra,20,0,1,1,"(4.815061,-75.736532)"
2023,Abril,Sudáfrica,710,2,0,2,"(10.408582,-75.538003)"
2019,Noviembre,Croacia,191,1,0,1,"(0.814836,-77.662532)"
2021,Octubre,Bélgica,56,0,1,1,"(7.128456,-73.183637)"
2021,Septiembre,Perú,604,0,4,4,"(12.5744111,-81.703935)"
2015,Enero,Eslovenia,705,0,2,2,"(10.445761,-75.516429)"
2023,Febrero,Francia,250,54,96,150,"(3.541112,-76.384584)"
2023,Abril,Costa Rica,188,1,1,2,"(8.364293,-72.405710)"
2017,Agosto,Italia,380,6,16,22,"(-4.197703,-69.941278)"
2019,Abril,Cuba,192,1,3,4,"(7.128456,-73.183637)"
2023,Junio,Israel,376,12,2,14,"(12.586067,-81.702563)"
2018,Mayo,Austria,40,8,11,19,"(3.541112,-76.384584)"
2012,Octubre,Reino Unido de Gran Bretaña e Irlanda del Norte,826,0,2,2,"(-4.197703,-69.941278)"
2014,Febrero,Venezuela,862,265,398,663,"(6.171601,-75.427454)"
2015,Junio,Bélgica,56,10,12,22,"(10.445761,-75.516429)"
2018,Abril,Sudáfrica,710,2,5,7,"(6.171601,-75.427454)"
2012,Junio,Macedonia,807,0,1,1,"(0.814836,-77.662532)"
2022,Mayo,Barbados,52,0,1,1,"(6.171601,-75.427454)"
2023,Febrero,Montenegro,499,0,2,2,"(9.402978,-75.681599)"
2017,Febrero,Estados Unidos de América,840,26,42,68,"(7.128456,-73.183637)"
2020,Septiembre,Alemania,276,0,1,1,"(6.171601,-75.427454)"
2016,Junio,Chad,148,0,1,1,"(6.171601,-75.427454)"
2019,Mayo,Suiza,756,0,2,2,"(13.3387613,-81.372937)"
2016,Diciembre,Panamá,591,1397,1626,3023,"(4.697144,-74.140516)"
2018,Febrero,Canadá,124,4,6,10,"(7.128456,-73.183637)"
2018,Junio,Honduras,340,12,19,31,"(3.541112,-76.384584)"
2022,Febrero,Trinidad y Tobago,780,7,5,12,"(3.541112,-76.384584)"
2021,Noviembre,Ecuador,218,32,28,60,"(10.886611,-74.776708)"
2019,Noviembre,Myanmar,104,0,6,6,"(10.408582,-75.538003)"
2018,Mayo,México,484,16,33,49,"(4.815061,-75.736532)"
2014,Septiembre,República Checa,203,28,46,74,"(4.697144,-74.140516)"
2017,Abril,Alemania,276,2,3,5,"(12.586067,-81.702563)"
2017,Febrero,España,724,9,44,53,"(7.818934,-72.453226)"
2016,Julio,Santa Lucia,662,0,1,1,"(3.541112,-76.384584)"
2013,Octubre,Haití,332,0,15,15,"(6.171601,-75.427454)"
2014,Noviembre,Marruecos,504,1,10,11,"(4.697144,-74.140516)"
2015,Enero,Alemania,276,0,4,4,"(4.815061,-75.736532)"
2018,Junio,Nicaragua,558,4,7,11,"(3.541112,-76.384584)"
2019,Julio,Panamá,591,1,0,1,"(4.452882,-75.766298)"
2016,Septiembre,República Dominicana,214,105,137,242,"(10.445761,-75.516429)"
2016,Junio,Ecuador,218,3,17,20,"(7.102626,-77.762647)"
2012,Febrero,República Democrática del Congo,180,3,1,4,"(4.697144,-74.140516)"
2018,Octubre,Antigua y Barbuda,28,4,2,6,"(4.697144,-74.140516)"
2021,Agosto,Bélgica,56,12,33,45,"(6.171601,-75.427454)"
2018,Enero,Polonia,616,200,236,436,"(4.697144,-74.140516)"
2017,Noviembre,Panamá,591,2948,2686,5634,"(4.697144,-74.140516)"
2017,Enero,Australia,36,5,12,17,"(-4.197703,-69.941278)"
2020,Febrero,Indonesia,360,0,1,1,"(3.541112,-76.384584)"
2019,Septiembre,Nueva Zelanda,554,13,26,39,"(6.171601,-75.427454)"
2019,Noviembre,Montenegro,499,1,1,2,"(10.445761,-75.516429)"
2013,Febrero,Polonia,616,2,2,4,"(3.541112,-76.384584)"
2015,Agosto,Luxemburgo,442,0,1,1,"(10.408582,-75.538003)"
2023,Enero,Suecia,752,33,83,116,"(6.171601,-75.427454)"
2013,Marzo,Argentina,32,1,14,15,"(8.635765,-77.346578)"
2018,Diciembre,El Salvador,222,1,3,4,"(10.408582,-75.538003)"
2012,Septiembre,República de Corea,410,3,2,5,"(7.818934,-72.453226)"
2023,Junio,Uruguay,858,0,1,1,"(8.364293,-72.405710)"
2019,Julio,Pakistán,586,0,2,2,"(6.171601,-75.427454)"
2020,Octubre,Uruguay,858,5,18,23,"(4.697144,-74.140516)"
2017,Junio,Dinamarca,208,102,158,260,"(4.697144,-74.140516)"
2012,Junio,Venezuela,862,11,10,21,"(12.586067,-81.702563)"
2015,Julio,Kazajistán,398,4,1,5,"(4.697144,-74.140516)"
2013,Junio,Canadá,124,3,1,4,"(8.635765,-77.346578)"
2019,Marzo,República de Corea,410,3,5,8,"(3.541112,-76.384584)"
2012,Julio,Estados Unidos de América,840,1,3,4,"(11.247723,-74.213989)"
2022,Agosto,Italia,380,1,6,7,"(-4.197703,-69.941278)"
2018,Septiembre,Tailandia,764,7,14,21,"(4.697144,-74.140516)"
2022,Junio,Francia,250,0,2,2,"(7.818934,-72.453226)"
2012,Septiembre,Reino Unido de Gran Bretaña e Irlanda del Norte,826,2,3,5,"(0.814836,-77.662532)"
2015,Diciembre,Uruguay,858,0,1,1,"(7.818934,-72.453226)"
2014,Mayo,España,724,1,2,3,"(4.452882,-75.766298)"
2021,Junio,Costa Rica,188,26,25,51,"(3.541112,-76.384584)"
2016,Febrero,Suecia,752,22,17,39,"(0.814836,-77.662532)"
2019,Mayo,Venezuela,862,12,44,56,"(11.117806,-74.232622)"
2012,Marzo,Lituania,440,0,2,2,"(10.408582,-75.538003)"
2014,Febrero,Suiza,756,22,46,68,"(6.171601,-75.427454)"
2016,Marzo,Federación de Rusia,643,1,9,10,"(9.402978,-75.681599)"
2017,Marzo,Dominica,212,0,1,1,"(6.171601,-75.427454)"
2021,Septiembre,México,484,0,1,1,"(10.408582,-75.538003)"
2018,Febrero,Chile,152,21,23,44,"(10.886611,-74.776708)"
2012,Octubre,Venezuela,862,51,89,140,"(6.185799,-67.483929)"
2021,Abril,Portugal,620,2,3,5,"(10.886611,-74.776708)"
2014,Agosto,Arabia Saudita,682,6,16,22,"(4.697144,-74.140516)"
2012,Enero,República Dominicana,214,0,4,4,"(0.814836,-77.662532)"
2013,Febrero,Grecia,300,0,1,1,"(10.408582,-75.538003)"
2017,Diciembre,Honduras,340,47,81,128,"(6.171601,-75.427454)"
2013,Octubre,Benín,204,2,2,4,"(4.697144,-74.140516)"
2012,Febrero,Austria,40,2,2,4,"(12.586067,-81.702563)"
2014,Mayo,Honduras,340,27,36,63,"(6.171601,-75.427454)"
2012,Mayo,Polonia,616,3,1,4,"(10.886611,-74.776708)"
2014,Marzo,Grecia,300,5,9,14,"(10.445761,-75.516429)"
2013,Noviembre,Honduras,340,0,3,3,"(10.408582,-75.538003)"
2022,Enero,Qatar,634,0,1,1,"(4.697144,-74.140516)"
2021,Noviembre,Montenegro,499,0,1,1,"(0.814836,-77.662532)"
2019,Julio,Alemania,276,0,1,1,"(10.971302,-74.765397)"
2021,Mayo,Singapur,702,0,1,1,"(10.445761,-75.516429)"
2013,Junio,Bulgaria,100,0,1,1,"(10.445761,-75.516429)"
2012,Julio,Suiza,756,53,62,115,"(3.541112,-76.384584)"
2014,Agosto,Croacia,191,1,1,2,"(10.445761,-75.516429)"
2023,Marzo,Andorra,20,0,1,1,"(6.171601,-75.427454)"
2017,Julio,Finlandia,246,3,3,6,"(10.886611,-74.776708)"
2018,Noviembre,Chile,152,1,1,2,"(6.185799,-67.483929)"
2012,Octubre,República CentroÁfricana,140,0,2,2,"(4.697144,-74.140516)"
2022,Junio,Turquía,792,0,1,1,"(0.814836,-77.662532)"
2016,Octubre,Suecia,752,8,13,21,"(10.445761,-75.516429)"
2023,Febrero,Filipinas,608,0,216,216,"(10.408582,-75.538003)"
2018,Enero,India,356,2,1,3,"(11.247723,-74.213989)"
2022,Octubre,República Dominicana,214,5,5,10,"(7.927209,-72.507910)"
2013,Mayo,Portugal,620,1,0,1,"(8.635765,-77.346578)"
2014,Agosto,Argentina,32,5,6,11,"(-4.197703,-69.941278)"
2012,Julio,República de Irlanda,372,5,5,10,"(3.541112,-76.384584)"
2017,Mayo,Kiribati,296,0,1,1,"(10.408582,-75.538003)"
2015,Diciembre,Grecia,300,0,1,1,"(11.247723,-74.213989)"
2016,Mayo,Suiza,756,0,2,2,"(7.818934,-72.453226)"
2013,Octubre,Zimbabue,716,1,3,4,"(4.697144,-74.140516)"
2022,Mayo,Islandia,352,1,2,3,"(10.445761,-75.516429)"
2018,Enero,Guatemala,320,165,144,309,"(10.445761,-75.516429)"
2016,Agosto,Austria,40,14,18,32,"(6.171601,-75.427454)"
2019,Febrero,República de Irlanda,372,0,6,6,"(10.886611,-74.776708)"
2015,Noviembre,Perú,604,6,7,13,"(4.815061,-75.736532)"
2014,Marzo,Perú,604,0,4,4,"(4.815061,-75.736532)"
2018,Enero,Venezuela,862,0,3,3,"(12.165168,-71.983761)"
2019,Noviembre,Myanmar,104,0,2,2,"(11.247723,-74.213989)"
2022,Septiembre,San Cristóbal y Nevis,659,0,2,2,"(3.541112,-76.384584)"
2016,Julio,Vietnam,704,22,22,44,"(4.697144,-74.140516)"
2018,Enero,República de Irlanda,372,0,1,1,"(7.818934,-72.453226)"
2014,Agosto,Ecuador,218,230,252,482,"(7.818934,-72.453226)"
2015,Enero,Ecuador,218,18,22,40,"(11.360009,-72.129330)"
2017,Febrero,Nicaragua,558,65,75,140,"(4.697144,-74.140516)"
2013,Septiembre,El Salvador,222,0,1,1,"(12.586067,-81.702563)"
2015,Noviembre,Uruguay,858,0,1,1,"(0.25129,-76.875963)"
2019,Agosto,Costa Rica,188,128,86,214,"(10.445761,-75.516429)"
2013,Abril,Aruba,533,0,1,1,"(3.541112,-76.384584)"
2021,Diciembre,Estonia,233,1,1,2,"(3.541112,-76.384584)"
2017,Enero,República Checa,203,0,1,1,"(11.360009,-72.129330)"
2021,Junio,República Checa,203,3,11,14,"(6.171601,-75.427454)"
2017,Junio,República Árabe Siria,760,1,1,2,"(4.697144,-74.140516)"
2012,Noviembre,Guatemala,320,3,1,4,"(7.128456,-73.183637)"
2016,Junio,Australia,36,35,48,83,"(10.445761,-75.516429)"
2017,Octubre,Sudáfrica,710,1,1,2,"(3.541112,-76.384584)"
2020,Enero,República Checa,203,0,1,1,"(-4.197703,-69.941278)"
2022,Julio,Cuba,192,10,16,26,"(10.886611,-74.776708)"
2019,Marzo,Bélgica,56,1,0,1,"(0.25129,-76.875963)"
2022,Febrero,Perú,604,3,4,7,"(8.36068,-72.409396)"
2016,Mayo,Desconocido,99999,0,2,2,"(10.445761,-75.516429)"
2023,Marzo,Chile,152,286,424,710,"(6.171601,-75.427454)"
2013,Octubre,Pakistán,586,0,9,9,"(4.697144,-74.140516)"
2017,Marzo,Francia,250,1,1,2,"(12.5744111,-81.703935)"
2013,Marzo,Filipinas,608,1,24,25,"(10.408582,-75.538003)"
2012,Noviembre,México,484,0,3,3,"(4.452882,-75.766298)"
2019,Agosto,Turquía,792,0,4,4,"(3.541112,-76.384584)"
2023,Mayo,Filipinas,608,3,7,10,"(3.541112,-76.384584)"
2021,Agosto,Desconocido,99999,1,0,1,"(10.445761,-75.516429)"
2016,Mayo,España,724,265,423,688,"(3.541112,-76.384584)"
2013,Febrero,Francia,250,0,1,1,"(4.452882,-75.766298)"
2021,Septiembre,Ecuador,218,0,5,5,"(6.228046,-77.404104)"
2017,Diciembre,Honduras,340,46,39,85,"(3.541112,-76.384584)"
2018,Junio,Australia,36,2,8,10,"(-4.223468,-69.945098)"
2015,Octubre,Albania,8,0,1,1,"(-4.197703,-69.941278)"
2018,Junio,Islandia,352,0,1,1,"(3.541112,-76.384584)"
2012,Diciembre,Georgia,268,0,1,1,"(4.697144,-74.140516)"
2016,Marzo,Jamaica,388,3,7,10,"(6.171601,-75.427454)"
2022,Noviembre,Palestina,99999,0,1,1,"(10.445761,-75.516429)"
2013,Octubre,República Dominicana,214,11,12,23,"(10.886611,-74.776708)"
2013,Febrero,República de Corea,410,1,1,2,"(7.927209,-72.507910)"
2019,Junio,España,724,6,17,23,"(11.360009,-72.129330)"
2022,Febrero,Canadá,124,1,3,4,"(12.5744111,-81.703935)"
2022,Septiembre,India,356,0,13,13,"(3.893038,-77.067921)"
2014,Septiembre,Trinidad y Tobago,780,0,2,2,"(4.815061,-75.736532)"
2014,Enero,Montenegro,499,0,2,2,"(4.697144,-74.140516)"
2017,Abril,México,484,3,2,5,"(-4.223468,-69.945098)"
2021,Agosto,Guyana,328,0,2,2,"(6.171601,-75.427454)"
2020,Septiembre,Panamá,591,0,2,2,"(1.813928,-78.763924)"
2012,Junio,República de Irlanda,372,3,6,9,"(10.445761,-75.516429)"
2021,Junio,España,724,17,28,45,"(7.818934,-72.453226)"
2015,Febrero,Pakistán,586,3,9,12,"(4.697144,-74.140516)"
2017,Febrero,Grecia,300,0,1,1,"(0.814836,-77.662532)"
2017,Enero,Finlandia,246,0,4,4,"(11.247723,-74.213989)"
2019,Marzo,Cuba,192,1,2,3,"(4.815061,-75.736532)"
2017,Septiembre,Venezuela,862,7,11,18,"(0.25129,-76.875963)"
2017,Agosto,Alemania,276,32,46,78,"(10.886611,-74.776708)"
2017,Julio,Honduras,340,0,3,3,"(11.360009,-72.129330)"
2013,Febrero,Países Bajos,528,15,22,37,"(4.452882,-75.766298)"
2013,Enero,Perú,604,0,2,2,"(10.971302,-74.765397)"
2021,Marzo,Italia,380,9,6,15,"(10.886611,-74.776708)"
2012,Septiembre,Guyana,328,1,2,3,"(6.171601,-75.427454)"
2017,Agosto,India,356,0,2,2,"(10.408582,-75.538003)"
2015,Noviembre,Austria,40,0,4,4,"(8.635765,-77.346578)"
2023,Junio,Bangladesh,50,0,40,40,"(3.893038,-77.067921)"
2014,Agosto,Micronesia,583,1,0,1,"(6.171601,-75.427454)"
2022,Julio,Federación de Rusia,643,0,7,7,"(10.971302,-74.765397)"
2021,Enero,Costa Rica,188,369,414,783,"(4.697144,-74.140516)"
2017,Marzo,Guatemala,320,44,164,208,"(6.171601,-75.427454)"
2022,Abril,Federación de Rusia,643,8,7,15,"(3.541112,-76.384584)"
2021,Octubre,Federación de Rusia,643,0,1,1,"(8.066966,-76.735404)"
2021,Julio,Países Bajos,528,4,4,8,"(4.815061,-75.736532)"
2019,Enero,Barbados,52,1,0,1,"(10.408582,-75.538003)"
2021,Abril,Liechtenstein,438,0,1,1,"(6.171601,-75.427454)"
2023,Mayo,Serbia,688,4,13,17,"(6.171601,-75.427454)"
2018,Julio,Argentina,32,346,238,584,"(10.408582,-75.538003)"
2013,Agosto,Alemania,276,2,2,4,"(7.128456,-73.183637)"
2019,Febrero,Jamaica,388,3,5,8,"(10.886611,-74.776708)"
2019,Enero,Panamá,591,141,144,285,"(10.886611,-74.776708)"
2015,Abril,India,356,1,5,6,"(9.402978,-75.681599)"
2015,Enero,Suiza,756,26,33,59,"(0.814836,-77.662532)"
2018,Junio,República Checa,203,4,3,7,"(10.886611,-74.776708)"
2013,Noviembre,Singapur,702,9,11,20,"(4.697144,-74.140516)"
2019,Noviembre,Antigua y Barbuda,28,1,0,1,"(7.818934,-72.453226)"
2020,Enero,Austria,40,1,1,2,"(-4.197703,-69.941278)"
2014,Marzo,República Dominicana,214,1,0,1,"(4.452882,-75.766298)"
2012,Abril,Suiza,756,8,9,17,"(-4.197703,-69.941278)"
2013,Julio,Argelia,12,2,8,10,"(4.697144,-74.140516)"
2013,Abril,Cuba,192,2,0,2,"(4.452882,-75.766298)"
2021,Abril,Estados Unidos de América,840,319,612,931,"(10.886611,-74.776708)"
2015,Noviembre,Hungría,348,1,0,1,"(4.815061,-75.736532)"
2015,Diciembre,España,724,0,1,1,"(11.360009,-72.129330)"
2013,Abril,Madagascar,450,2,1,3,"(4.697144,-74.140516)"
2017,Junio,Pakistán,586,1,2,3,"(10.445761,-75.516429)"
2019,Abril,Finlandia,246,0,1,1,"(8.635765,-77.346578)"
2016,Agosto,Sri Lanka,144,0,4,4,"(0.814836,-77.662532)"
2013,Agosto,Países Bajos,528,72,93,165,"(6.171601,-75.427454)"
2012,Agosto,Honduras,340,11,18,29,"(3.541112,-76.384584)"
2018,Noviembre,Guatemala,320,1,0,1,"(8.36068,-72.409396)"
2021,Mayo,Costa Rica,188,3,1,4,"(4.815061,-75.736532)"
2019,Junio,Arabia Saudita,682,0,1,1,"(3.541112,-76.384584)"
2014,Febrero,Emiratos Árabes,784,0,5,5,"(4.697144,-74.140516)"
2023,Mayo,Brasil,76,2,1,3,"(11.360009,-72.129330)"
2018,Septiembre,Malasia,458,14,55,69,"(4.697144,-74.140516)"
2013,Diciembre,Países Bajos,528,690,1292,1982,"(4.697144,-74.140516)"
2018,Noviembre,República Árabe Siria,760,0,1,1,"(10.886611,-74.776708)"
2016,Mayo,Uruguay,858,19,11,30,"(12.586067,-81.702563)"
2023,Enero,Canadá,124,3,6,9,"(7.818934,-72.453226)"
2023,Abril,Bélgica,56,14,10,24,"(3.541112,-76.384584)"
2014,Mayo,Suecia,752,1,0,1,"(12.586067,-81.702563)"
2012,Agosto,Mozambique,508,0,1,1,"(0.25129,-76.875963)"
2022,Junio,Venezuela,862,0,5,5,"(11.247723,-74.213989)"
2022,Junio,Malí,466,0,2,2,"(4.697144,-74.140516)"
2014,Noviembre,Noruega,578,3,2,5,"(0.814836,-77.662532)"
2022,Marzo,Honduras,340,75,98,173,"(6.171601,-75.427454)"
2021,Febrero,Chile,152,8,8,16,"(4.815061,-75.736532)"
2016,Diciembre,Federación de Rusia,643,0,1,1,"(8.36068,-72.409396)"
2022,Abril,Uruguay,858,3,5,8,"(7.818934,-72.453226)"
2016,Diciembre,India,356,0,1,1,"(12.586067,-81.702563)"
2021,Junio,Israel,376,1,1,2,"(-4.197703,-69.941278)"
2014,Mayo,Turquía,792,0,1,1,"(11.360009,-72.129330)"
2020,Febrero,Estados Unidos de América,840,4,5,9,"(12.5744111,-81.703935)"
2013,Abril,Eslovaquia,703,0,1,1,"(6.171601,-75.427454)"
2014,Diciembre,Bolivia,68,0,1,1,"(7.128456,-73.183637)"
2012,Agosto,Reino Unido de Gran Bretaña e Irlanda del Norte,826,0,2,2,"(7.818934,-72.453226)"
2016,Diciembre,Austria,40,4,1,5,"(10.408582,-75.538003)"
2015,Enero,India,356,1,50,51,"(6.171601,-75.427454)"
2018,Marzo,Uruguay,858,14,23,37,"(3.541112,-76.384584)"
2019,Marzo,Perú,604,38,71,109,"(-4.223468,-69.945098)"
2016,Enero,Bolivia,68,18,24,42,"(0.814836,-77.662532)"
2012,Enero,España,724,14,27,41,"(0.814836,-77.662532)"
2020,Noviembre,Estados Unidos de América,840,2606,5687,8294,"(4.697144,-74.140516)"
2013,Agosto,Reino Unido de Gran Bretaña e Irlanda del Norte,826,0,4,4,"(7.818934,-72.453226)"
2012,Octubre,Lituania,440,1,0,1,"(6.171601,-75.427454)"
2015,Enero,Cuba,192,9,26,35,"(10.445761,-75.516429)"
2016,Enero,Bulgaria,100,0,1,1,"(10.971302,-74.765397)"
2014,Agosto,Venezuela,862,3,6,9,"(12.586067,-81.702563)"
2015,Septiembre,Uganda,800,2,5,7,"(6.171601,-75.427454)"
2017,Noviembre,Hungría,348,0,1,1,"(12.586067,-81.702563)"
2019,Diciembre,Islas Caimán/Territorio Británico de Ultramar,136,11,7,18,"(12.586067,-81.702563)"
2021,Agosto,República de Moldavia,498,1,1,2,"(4.697144,-74.140516)"
2012,Junio,Argentina,32,0,1,1,"(8.635765,-77.346578)"
2012,Enero,Estonia,233,1,1,2,"(10.408582,-75.538003)"
2019,Agosto,Letonia,428,3,2,5,"(6.171601,-75.427454)"
2022,Febrero,Dinamarca,208,27,23,50,"(10.445761,-75.516429)"
2012,Noviembre,El Salvador,222,1,3,4,"(4.815061,-75.736532)"
2023,Mayo,Argentina,32,43,47,90,"(12.586067,-81.702563)"
2021,Octubre,Eslovaquia,703,5,4,9,"(10.445761,-75.516429)"
2023,Febrero,Gabón,266,1,0,1,"(4.697144,-74.140516)"
2014,Noviembre,Guatemala,320,5,14,19,"(10.886611,-74.776708)"
2019,Julio,Granada,308,0,1,1,"(6.171601,-75.427454)"
2023,Abril,Suiza,756,3,4,7,"(10.886611,-74.776708)"
2021,Marzo,Azerbaiyán,31,0,1,1,"(3.541112,-76.384584)"
2019,Mayo,Nueva Zelanda,554,3,2,5,"(-4.223468,-69.945098)"
2012,Febrero,Jamaica,388,8,11,19,"(4.697144,-74.140516)"
2023,Enero,Letonia,428,0,1,1,"(10.408582,-75.538003)"
2017,Mayo,Chile,152,3,5,8,"(11.360009,-72.129330)"
2020,Diciembre,Croacia,191,5,13,18,"(4.697144,-74.140516)"
2015,Agosto,El Salvador,222,2,1,3,"(4.815061,-75.736532)"
2019,Junio,Argentina,32,102,156,258,"(3.541112,-76.384584)"
2014,Mayo,República Dominicana,214,0,1,1,"(7.128456,-73.183637)"
2014,Agosto,Grecia,300,0,2,2,"(6.171601,-75.427454)"
2012,Junio,República Dominicana,214,23,56,79,"(6.171601,-75.427454)"
2015,Diciembre,Países Bajos,528,55,89,144,"(10.886611,-74.776708)"
2016,Septiembre,Italia,380,0,3,3,"(0.25129,-76.875963)"
2019,Marzo,Ecuador,218,4,5,9,"(11.360009,-72.129330)"
2019,Noviembre,Guatemala,320,2,3,5,"(12.586067,-81.702563)"
2021,Marzo,India,356,0,5,5,"(11.247723,-74.213989)"
2016,Enero,Noruega,578,16,25,41,"(10.445761,-75.516429)"
2015,Julio,Ecuador,218,30,27,57,"(10.886611,-74.776708)"
2019,Noviembre,México,484,1,0,1,"(7.088729,-70.740253)"
2015,Mayo,Noruega,578,2,10,12,"(10.445761,-75.516429)"
2017,Diciembre,Perú,604,0,1,1,"(6.185799,-67.483929)"
2012,Marzo,Dinamarca,208,0,1,1,"(11.360009,-72.129330)"
2014,Julio,Francia,250,12,26,38,"(10.408582,-75.538003)"
2012,Mayo,Sierra Leona,694,0,1,1,"(6.171601,-75.427454)"
2020,Marzo,Costa Rica,188,7,8,15,"(12.586067,-81.702563)"
2022,Septiembre,India,356,0,18,18,"(1.813928,-78.763924)"
2017,Mayo,Nicaragua,558,19,28,47,"(6.171601,-75.427454)"
2015,Mayo,México,484,4,3,7,"(6.185799,-67.483929)"
2018,Noviembre,Bulgaria,100,7,7,14,"(10.445761,-75.516429)"
2021,Julio,Francia,250,0,1,1,"(11.360009,-72.129330)"
2018,Abril,Finlandia,246,3,7,10,"(10.445761,-75.516429)"
2021,Octubre,República Dominicana,214,24,63,87,"(10.886611,-74.776708)"
2012,Agosto,Austria,40,4,10,14,"(10.445761,-75.516429)"
2019,Enero,Suecia,752,5,6,11,"(0.814836,-77.662532)"
2017,Noviembre,India,356,1,1,2,"(4.815061,-75.736532)"
2016,Abril,Eslovaquia,703,2,1,3,"(6.171601,-75.427454)"
2022,Marzo,Alemania,276,0,1,1,"(7.927209,-72.507910)"
2014,Abril,Túnez,788,3,4,7,"(4.697144,-74.140516)"
2016,Junio,Grecia,300,0,2,2,"(3.541112,-76.384584)"
2018,Octubre,Suecia,752,1,0,1,"(12.586067,-81.702563)"
2017,Mayo,Suiza,756,3,1,4,"(0.25129,-76.875963)"
2015,Abril,Guinea,324,1,0,1,"(4.697144,-74.140516)"
2012,Septiembre,Italia,380,9,11,20,"(0.814836,-77.662532)"
2020,Noviembre,Taiwán,158,1,1,2,"(3.541112,-76.384584)"
2015,Marzo,Albania,8,0,1,1,"(7.818934,-72.453226)"
2023,Abril,Liechtenstein,438,8,3,11,"(4.697144,-74.140516)"
2018,Abril,Burkina Faso,854,0,2,2,"(4.697144,-74.140516)"
2022,Diciembre,Islas Caimán/Territorio Británico de Ultramar,136,0,1,1,"(6.171601,-75.427454)"
2013,Agosto,Países Bajos,528,3,4,7,"(8.635765,-77.346578)"
2013,Septiembre,Países Bajos,528,1,1,2,"(10.408582,-75.538003)"
2017,Agosto,Palestina,99999,0,1,1,"(6.171601,-75.427454)"
2015,Agosto,Brasil,76,75,198,273,"(6.171601,-75.427454)"
2013,Enero,Estados Unidos de América,840,398,825,1223,"(3.541112,-76.384584)"
2020,Octubre,Ghana,288,0,1,1,"(4.697144,-74.140516)"
2018,Marzo,Taiwán,158,7,8,15,"(10.445761,-75.516429)"
2020,Marzo,Perú,604,130,133,263,"(3.541112,-76.384584)"
2017,Septiembre,Honduras,340,323,342,665,"(4.697144,-74.140516)"
2016,Septiembre,Irán,364,10,64,74,"(4.697144,-74.140516)"
2016,Diciembre,Venezuela,862,12,16,28,"(4.815061,-75.736532)"
2018,Junio,Paraguay,600,1,0,1,"(7.088729,-70.740253)"
2018,Octubre,Países Bajos,528,1,3,4,"(0.25129,-76.875963)"
2012,Diciembre,Ecuador,218,5,6,11,"(7.927209,-72.507910)"
2015,Octubre,Haití,332,1,2,3,"(10.886611,-74.776708)"
2013,Mayo,Dinamarca,208,4,6,10,"(3.541112,-76.384584)"
2012,Noviembre,Italia,380,16,16,32,"(10.408582,-75.538003)"
2018,Septiembre,Reino Unido de Gran Bretaña e Irlanda del Norte,826,0,1,1,"(11.247723,-74.213989)"
2018,Noviembre,Camboya,116,0,1,1,"(4.697144,-74.140516)"
2014,Febrero,Eslovenia,705,0,2,2,"(10.408582,-75.538003)"
2019,Noviembre,Serbia,688,4,6,10,"(6.171601,-75.427454)"
2017,Agosto,Singapur,702,3,1,4,"(10.445761,-75.516429)"
2017,Mayo,Islas Fiji,242,1,0,1,"(10.445761,-75.516429)"
2022,Marzo,China,156,3,9,12,"(3.541112,-76.384584)"
2017,Febrero,Honduras,340,1,0,1,"(6.185799,-67.483929)"
2022,Diciembre,Brasil,76,0,1,1,"(8.635765,-77.346578)"
2013,Diciembre,Brasil,76,92,121,213,"(-4.197703,-69.941278)"
2021,Abril,Reino Unido de Gran Bretaña e Irlanda del Norte,826,0,2,2,"(11.117806,-74.232622)"
2012,Diciembre,Canadá,124,3,2,5,"(11.247723,-74.213989)"
2017,Julio,Haití,332,1,1,2,"(7.818934,-72.453226)"
2014,Octubre,República de Corea,410,0,1,1,"(10.886611,-74.776708)"
2012,Octubre,Panamá,591,0,1,1,"(11.360009,-72.129330)"
2013,Diciembre,Eslovenia,705,0,2,2,"(10.408582,-75.538003)"
2012,Junio,Italia,380,19,73,92,"(6.171601,-75.427454)"
2020,Octubre,Ecuador,218,0,4,4,"(7.818934,-72.453226)"
2019,Septiembre,Paraguay,600,3,4,7,"(10.886611,-74.776708)"
2021,Julio,Perú,604,0,1,1,"(7.088729,-70.740253)"
2015,Octubre,Panamá,591,0,1,1,"(4.452882,-75.766298)"
2014,Noviembre,Israel,376,0,3,3,"(10.408582,-75.538003)"
2022,Junio,Letonia,428,0,2,2,"(9.402978,-75.681599)"
2017,Mayo,Noruega,578,6,6,12,"(10.408582,-75.538003)"
2023,Marzo,Polonia,616,0,2,2,"(11.360009,-72.129330)"
2015,Mayo,Turquía,792,3,7,10,"(6.171601,-75.427454)"
2013,Mayo,Argentina,32,0,1,1,"(7.088729,-70.740253)"
2014,Enero,México,484,22,39,61,"(10.408582,-75.538003)"
2015,Junio,Bolivia,68,22,8,30,"(12.586067,-81.702563)"
2018,Mayo,Bélgica,56,0,1,1,"(7.128456,-73.183637)"
2021,Diciembre,Guatemala,320,3,3,6,"(4.815061,-75.736532)"
2019,Marzo,Argentina,32,106,158,264,"(0.814836,-77.662532)"
2018,Septiembre,Italia,380,1,5,6,"(4.815061,-75.736532)"
2013,Abril,Nigeria,566,0,1,1,"(3.541112,-76.384584)"
2018,Octubre,Etiopia,231,0,1,1,"(10.886611,-74.776708)"
2012,Mayo,Irán,364,2,21,23,"(4.697144,-74.140516)"
2013,Abril,Perú,604,5,7,12,"(4.815061,-75.736532)"
2019,Octubre,Surinam,740,0,1,1,"(10.445761,-75.516429)"
2013,Junio,India,356,0,2,2,"(12.586067,-81.702563)"
2012,Marzo,Ecuador,218,8,8,16,"(10.886611,-74.776708)"
2014,Octubre,Costa Rica,188,5,3,8,"(7.128456,-73.183637)"
2019,Julio,Kazajistán,398,0,1,1,"(0.814836,-77.662532)"
2023,Enero,Venezuela,862,2843,2917,5760,"(11.360009,-72.129330)"
2015,Diciembre,Honduras,340,39,37,76,"(3.541112,-76.384584)"
2013,Septiembre,Turquía,792,0,1,1,"(7.818934,-72.453226)"
2016,Enero,Estados Unidos de América,840,502,865,1367,"(10.886611,-74.776708)"
2022,Marzo,Hong Kong,344,2,0,2,"(10.445761,-75.516429)"
2014,Diciembre,Bulgaria,100,2,0,2,"(10.445761,-75.516429)"
2021,Marzo,Italia,380,23,90,113,"(6.171601,-75.427454)"
2012,Septiembre,Reino Unido de Gran Bretaña e Irlanda del Norte,826,10,18,28,"(10.445761,-75.516429)"
2016,Marzo,Nepal,524,1,2,3,"(4.697144,-74.140516)"
2015,Agosto,Guatemala,320,22,87,109,"(3.541112,-76.384584)"
2015,Junio,Chile,152,0,1,1,"(7.128456,-73.183637)"
2013,Octubre,Montenegro,499,0,1,1,"(4.697144,-74.140516)"
2018,Abril,Turquía,792,0,5,5,"(3.541112,-76.384584)"
2013,Julio,Aruba,533,4,3,7,"(4.697144,-74.140516)"
2018,Octubre,Japón,392,13,39,52,"(6.171601,-75.427454)"
2015,Noviembre,Perú,604,0,2,2,"(11.360009,-72.129330)"
2017,Febrero,Francia,250,0,1,1,"(4.452882,-75.766298)"
2022,Noviembre,Burundi,108,0,1,1,"(6.171601,-75.427454)"
2017,Abril,México,484,15,22,37,"(7.818934,-72.453226)"
2016,Marzo,Croacia,191,13,24,37,"(4.697144,-74.140516)"
2016,Noviembre,Ghana,288,1,0,1,"(3.541112,-76.384584)"
2016,Noviembre,Venezuela,862,0,12,12,"(11.117806,-74.232622)"
2017,Junio,Andorra,20,0,2,2,"(3.541112,-76.384584)"
2016,Octubre,Nueva Zelanda,554,6,14,20,"(0.814836,-77.662532)"
2013,Mayo,Ecuador,218,11,23,34,"(10.445761,-75.516429)"
2018,Diciembre,Bolivia,68,28,44,72,"(6.171601,-75.427454)"
2014,Enero,Nicaragua,558,0,1,1,"(4.815061,-75.736532)"
2018,Mayo,Estados Unidos de América,840,606,1010,1617,"(10.886611,-74.776708)"
2019,Enero,Panamá,591,0,1,1,"(8.36068,-72.409396)"
2016,Mayo,Guyana,328,2,2,4,"(6.171601,-75.427454)"
2019,Agosto,Emiratos Árabes,784,9,12,21,"(4.697144,-74.140516)"
2017,Mayo,Desconocido,99999,0,1,1,"(0.814836,-77.662532)"
2022,Diciembre,Dinamarca,208,105,209,314,"(4.697144,-74.140516)"
2017,Septiembre,México,484,2,1,3,"(8.635765,-77.346578)"
2023,Junio,Alemania,276,19,28,47,"(10.408582,-75.538003)"
2019,Agosto,Bélgica,56,2,5,7,"(10.886611,-74.776708)"
2018,Febrero,Venezuela,862,10064,12466,22530,"(11.360009,-72.129330)"
2013,Junio,Uruguay,858,36,26,62,"(12.586067,-81.702563)"
2020,Febrero,Suiza,756,116,190,306,"(6.171601,-75.427454)"
2023,Enero,El Salvador,222,686,794,1480,"(4.697144,-74.140516)"
2018,Febrero,Suiza,756,15,24,39,"(10.408582,-75.538003)"
2018,Febrero,República de Irlanda,372,4,2,6,"(8.635765,-77.346578)"
2022,Febrero,Suiza,756,0,1,1,"(11.360009,-72.129330)"
2012,Marzo,Federación de Rusia,643,0,9,9,"(10.971302,-74.765397)"
2022,Marzo,República de Corea,410,3,10,13,"(10.445761,-75.516429)"
2018,Mayo,Nicaragua,558,1,0,1,"(12.586067,-81.702563)"
2022,Octubre,Dinamarca,208,0,1,1,"(-4.223468,-69.945098)"
2014,Enero,Japón,392,1,2,3,"(7.818934,-72.453226)"
2021,Julio,Ecuador,218,124,157,281,"(6.171601,-75.427454)"
2022,Abril,India,356,2,22,24,"(3.541112,-76.384584)"
2017,Junio,Croacia,191,0,1,1,"(10.408582,-75.538003)"
2016,Octubre,Grecia,300,0,3,3,"(8.066966,-76.735404)"
2014,Octubre,Perú,604,90,106,196,"(7.818934,-72.453226)"
2022,Noviembre,Portugal,620,5,4,9,"(7.927209,-72.507910)"
2019,Junio,Túnez,788,0,1,1,"(11.360009,-72.129330)"
2015,Febrero,Italia,380,0,2,2,"(7.128456,-73.183637)"
2015,Septiembre,Sri Lanka,144,2,3,5,"(4.697144,-74.140516)"
2017,Septiembre,Argentina,32,29,44,73,"(10.886611,-74.776708)"
2013,Enero,Santa Lucia,662,0,1,1,"(12.586067,-81.702563)"
2013,Septiembre,República Dominicana,214,2,2,4,"(12.586067,-81.702563)"
2017,Abril,Países Bajos,528,4,7,11,"(-4.223468,-69.945098)"
2012,Mayo,Malasia,458,1,3,4,"(10.445761,-75.516429)"
2023,Marzo,Granada,308,1,2,3,"(6.171601,-75.427454)"
2023,Abril,Turquía,792,0,4,4,"(0.814836,-77.662532)"
2022,Noviembre,Kenia,404,1,1,2,"(6.171601,-75.427454)"
2013,Junio,Honduras,340,1,0,1,"(7.128456,-73.183637)"
2021,Julio,Vietnam,704,1,1,2,"(6.171601,-75.427454)"
2018,Febrero,Nueva Zelanda,554,1,1,2,"(10.886611,-74.776708)"
2022,Mayo,República Dominicana,214,0,1,1,"(12.586067,-81.702563)"
2012,Agosto,Territorio Antártico Británico/Territorio Británico de Ultramar,260,0,1,1,"(11.360009,-72.129330)"
2015,Marzo,Brasil,76,8,17,25,"(7.818934,-72.453226)"
2019,Mayo,Alemania,276,0,2,2,"(3.893038,-77.067921)"
2022,Marzo,Ecuador,218,230,293,523,"(6.171601,-75.427454)"
2013,Diciembre,Suiza,756,0,3,3,"(4.815061,-75.736532)"
2012,Mayo,Eslovenia,705,0,2,2,"(6.171601,-75.427454)"
2019,Diciembre,Indonesia,360,23,30,53,"(4.697144,-74.140516)"
2023,Febrero,Islandia,352,2,0,2,"(10.445761,-75.516429)"
2022,Febrero,Chile,152,0,2,2,"(10.408582,-75.538003)"
2021,Enero,Ecuador,218,12,78,90,"(10.445761,-75.516429)"
2022,Marzo,Estados Unidos de América,840,228,301,529,"(4.452882,-75.766298)"
2014,Enero,República Checa,203,1,3,4,"(8.635765,-77.346578)"
2017,Mayo,Australia,36,2,1,3,"(11.247723,-74.213989)"
2017,Mayo,Rumania,642,0,1,1,"(11.247723,-74.213989)"
2017,Febrero,Noruega,578,0,1,1,"(11.247723,-74.213989)"
2018,Julio,Eslovaquia,703,1,1,2,"(3.541112,-76.384584)"
2016,Febrero,Noruega,578,2,0,2,"(8.635765,-77.346578)"
2012,Febrero,Brasil,76,60,42,102,"(12.586067,-81.702563)"
2017,Octubre,Argentina,32,157,97,254,"(10.408582,-75.538003)"
2015,Diciembre,Japón,392,4,9,13,"(7.818934,-72.453226)"
2019,Marzo,Singapur,702,0,1,1,"(10.886611,-74.776708)"
2015,Julio,Argentina,32,0,2,2,"(7.128456,-73.183637)"
2023,Enero,Bolivia,68,3,6,9,"(10.886611,-74.776708)"
2016,Marzo,México,484,5,1,6,"(0.25129,-76.875963)"
2015,Agosto,República Dominicana,214,0,1,1,"(12.5744111,-81.703935)"
2017,Febrero,India,356,0,2,2,"(11.247723,-74.213989)"
2017,Julio,Noruega,578,0,4,4,"(8.635765,-77.346578)"
2021,Junio,México,484,1124,2209,3333,"(4.697144,-74.140516)"
2019,Julio,Bolivia,68,0,3,3,"(7.818934,-72.453226)"
2016,Abril,España,724,10,20,30,"(10.408582,-75.538003)"
2016,Abril,Liechtenstein,438,1,0,1,"(4.697144,-74.140516)"
2014,Septiembre,Honduras,340,1,6,7,"(10.408582,-75.538003)"
2019,Julio,Eslovaquia,703,3,1,4,"(0.814836,-77.662532)"
2019,Febrero,Irán,364,0,2,2,"(0.814836,-77.662532)"
2014,Marzo,Suiza,756,1,2,3,"(11.360009,-72.129330)"
2016,Febrero,República Dominicana,214,5,16,21,"(0.814836,-77.662532)"
2017,Octubre,Italia,380,0,2,2,"(7.088729,-70.740253)"
2020,Junio,Estados Unidos de América,840,0,1,1,"(6.171601,-75.427454)"
2017,Septiembre,Madagascar,450,3,0,3,"(4.697144,-74.140516)"
2012,Febrero,Federación de Rusia,643,0,2,2,"(8.635765,-77.346578)"
2022,Octubre,Estados Unidos de América,840,1979,2520,4500,"(3.541112,-76.384584)"
2012,Enero,Austria,40,0,1,1,"(7.818934,-72.453226)"
2017,Febrero,Chile,152,11,21,32,"(7.818934,-72.453226)"
2019,Octubre,Líbano,422,1,0,1,"(7.128456,-73.183637)"
2017,Octubre,México,484,2,3,5,"(12.586067,-81.702563)"
2020,Enero,Estados Unidos de América,840,5456,7570,13026,"(10.445761,-75.516429)"
2015,Junio,Panamá,591,913,1226,2139,"(4.697144,-74.140516)"
2018,Agosto,Japón,392,35,30,65,"(6.171601,-75.427454)"
2022,Mayo,Venezuela,862,0,8,8,"(11.247723,-74.213989)"
2017,Enero,República de Corea,410,0,1,1,"(8.635765,-77.346578)"
2015,Abril,Francia,250,30,52,82,"(3.541112,-76.384584)"
2013,Marzo,Trinidad y Tobago,780,3,8,11,"(10.445761,-75.516429)"
2016,Noviembre,Polonia,616,24,19,43,"(0.814836,-77.662532)"
2021,Enero,República Dominicana,214,1,1,2,"(7.128456,-73.183637)"
2013,Febrero,Trinidad y Tobago,780,0,1,1,"(10.408582,-75.538003)"
2021,Enero,Bangladesh,50,0,2,2,"(4.697144,-74.140516)"
2017,Septiembre,Argentina,32,0,1,1,"(7.088729,-70.740253)"
2019,Marzo,Kenia,404,7,12,19,"(4.697144,-74.140516)"
2020,Diciembre,Túnez,788,0,2,2,"(4.697144,-74.140516)"
2019,Junio,Sudáfrica,710,4,4,8,"(10.445761,-75.516429)"
2021,Septiembre,Cuba,192,8,20,28,"(10.445761,-75.516429)"
2019,Julio,República Dominicana,214,5,2,7,"(4.815061,-75.736532)"
2015,Junio,Costa Rica,188,1,0,1,"(7.927209,-72.507910)"
2016,Julio,México,484,1,1,2,"(0.25129,-76.875963)"
2021,Junio,Francia,250,2,2,4,"(11.247723,-74.213989)"
2019,Junio,Filipinas,608,65,63,128,"(4.697144,-74.140516)"
2021,Julio,Grecia,300,18,38,56,"(4.697144,-74.140516)"
2017,Agosto,Sudáfrica,710,0,1,1,"(11.247723,-74.213989)"
2020,Enero,Grecia,300,2,20,22,"(6.171601,-75.427454)"
2015,Abril,Francia,250,1,1,2,"(12.586067,-81.702563)"
2012,Septiembre,Polonia,616,1,9,10,"(10.408582,-75.538003)"
2017,Marzo,Australia,36,1,0,1,"(12.5744111,-81.703935)"
2020,Enero,Bélgica,56,0,4,4,"(-4.197703,-69.941278)"
2019,Enero,Nueva Zelanda,554,15,19,34,"(10.445761,-75.516429)"
2019,Marzo,Reino Unido de Gran Bretaña e Irlanda del Norte,826,1282,2205,3487,"(4.697144,-74.140516)"
2012,Diciembre,República de Armenia,51,1,0,1,"(0.814836,-77.662532)"
2018,Diciembre,Israel,376,0,1,1,"(-4.197703,-69.941278)"
2018,Septiembre,Sudáfrica,710,1,1,2,"(13.3387613,-81.372937)"
2012,Julio,Ecuador,218,330,392,722,"(3.541112,-76.384584)"
2017,Marzo,Bangladesh,50,2,2,4,"(4.697144,-74.140516)"
2012,Febrero,India,356,0,1,1,"(11.528919,-72.919681)"
2016,Noviembre,Bermudas/Territorio Británico de Ultramar,60,0,1,1,"(3.541112,-76.384584)"
2012,Mayo,Honduras,340,0,1,1,"(7.128456,-73.183637)"
2017,Noviembre,Alemania,276,46,72,118,"(3.541112,-76.384584)"
2016,Agosto,India,356,1,9,10,"(10.408582,-75.538003)"
2015,Diciembre,Ecuador,218,1,4,5,"(7.927209,-72.507910)"
2022,Septiembre,Islas Fiji,242,0,1,1,"(4.697144,-74.140516)"
2019,Mayo,Reino Unido de Gran Bretaña e Irlanda del Norte,826,139,310,449,"(6.171601,-75.427454)"
2021,Octubre,Haití,332,1,2,3,"(10.445761,-75.516429)"
2014,Agosto,Filipinas,608,0,18,18,"(3.893038,-77.067921)"
2017,Febrero,Dominica,212,0,2,2,"(3.541112,-76.384584)"
2016,Julio,Federación de Rusia,643,0,3,3,"(9.402978,-75.681599)"
2016,Mayo,Honduras,340,15,19,34,"(10.445761,-75.516429)"
2013,Septiembre,Egipto,818,1,21,22,"(4.697144,-74.140516)"
2015,Julio,China,156,0,1,1,"(10.408582,-75.538003)"
2017,Febrero,Nueva Zelanda,554,49,92,141,"(4.697144,-74.140516)"
2012,Agosto,Costa Rica,188,1,0,1,"(8.635765,-77.346578)"
2013,Agosto,Paraguay,600,3,0,3,"(12.586067,-81.702563)"
2022,Diciembre,Honduras,340,0,1,1,"(10.408582,-75.538003)"
2023,Abril,México,484,13,28,41,"(7.927209,-72.507910)"
2014,Mayo,Guatemala,320,17,32,49,"(10.445761,-75.516429)"
2016,Febrero,Perú,604,1,9,10,"(11.360009,-72.129330)"
2017,Agosto,Canadá,124,36,65,101,"(10.886611,-74.776708)"
2016,Agosto,Estados Unidos de América,840,11,12,23,"(7.927209,-72.507910)"
2013,Febrero,Bolivia,68,32,44,76,"(0.814836,-77.662532)"
2019,Junio,República de Tayikistán,762,0,1,1,"(0.814836,-77.662532)"
2021,Octubre,Egipto,818,0,1,1,"(10.408582,-75.538003)"
2015,Julio,Bélgica,56,0,2,2,"(11.360009,-72.129330)"
2018,Enero,Nigeria,566,3,7,10,"(4.697144,-74.140516)"
2014,Diciembre,Reino Unido de Gran Bretaña e Irlanda del Norte,826,65,126,191,"(10.445761,-75.516429)"
2023,Febrero,Tailandia,764,18,6,24,"(4.697144,-74.140516)"
2016,Septiembre,Bélgica,56,1,0,1,"(7.128456,-73.183637)"
2023,Enero,Hungría,348,16,22,38,"(10.445761,-75.516429)"
2020,Octubre,Lituania,440,1,0,1,"(6.171601,-75.427454)"
2015,Octubre,Filipinas,608,0,1,1,"(4.815061,-75.736532)"
2016,Septiembre,México,484,2,3,5,"(4.452882,-75.766298)"
2018,Diciembre,México,484,0,2,2,"(12.5744111,-81.703935)"
2012,Febrero,España,724,66,197,263,"(6.171601,-75.427454)"
2021,Diciembre,Azerbaiyán,31,5,3,8,"(4.697144,-74.140516)"
2014,Agosto,Australia,36,25,32,57,"(10.445761,-75.516429)"
2015,Julio,Islandia,352,1,0,1,"(0.814836,-77.662532)"
2017,Julio,Israel,376,1,2,3,"(0.25129,-76.875963)"
2015,Agosto,Lituania,440,1,0,1,"(-4.197703,-69.941278)"
2023,Febrero,Suecia,752,47,59,106,"(10.445761,-75.516429)"
2014,Abril,Sudáfrica,710,58,96,154,"(4.697144,-74.140516)"
2015,Mayo,Japón,392,1,2,3,"(8.635765,-77.346578)"
2015,Julio,Sudáfrica,710,7,3,10,"(0.814836,-77.662532)"
2022,Enero,Austria,40,1,3,4,"(3.541112,-76.384584)"
2015,Septiembre,Venezuela,862,278,357,635,"(0.814836,-77.662532)"
2020,Enero,Suiza,756,1,0,1,"(7.128456,-73.183637)"
2016,Febrero,Chile,152,1,1,2,"(0.25129,-76.875963)"
2015,Octubre,España,724,1,1,2,"(8.066966,-76.735404)"
2017,Agosto,Guatemala,320,0,1,1,"(7.818934,-72.453226)"
2019,Junio,República Dominicana,214,0,2,2,"(4.452882,-75.766298)"
2018,Enero,Guatemala,320,7,10,17,"(4.815061,-75.736532)"
2018,Noviembre,Eslovenia,705,1,0,1,"(0.814836,-77.662532)"
2017,Noviembre,Ecuador,218,12,35,47,"(10.408582,-75.538003)"
2022,Julio,Malasia,458,1,0,1,"(10.445761,-75.516429)"
2021,Mayo,México,484,0,1,1,"(-4.197703,-69.941278)"
2023,Marzo,Afganistán,4,0,4,4,"(4.697144,-74.140516)"
2013,Septiembre,Chile,152,9,19,28,"(7.818934,-72.453226)"
2016,Abril,Vietnam,704,0,5,5,"(10.408582,-75.538003)"
2020,Febrero,China,156,1,0,1,"(8.36068,-72.409396)"
2016,Junio,Perú,604,19,39,58,"(7.818934,-72.453226)"
2013,Mayo,Ecuador,218,1,0,1,"(8.635765,-77.346578)"
2016,Septiembre,Perú,604,440,605,1045,"(6.171601,-75.427454)"
2019,Marzo,Malasia,458,1,0,1,"(3.541112,-76.384584)"
2015,Octubre,Nueva Zelanda,554,2,1,3,"(9.402978,-75.681599)"
2014,Septiembre,Uganda,800,0,2,2,"(3.541112,-76.384584)"
2019,Febrero,Hungría,348,2,3,5,"(0.814836,-77.662532)"
2018,Noviembre,Francia,250,57,80,137,"(0.814836,-77.662532)"
2023,Mayo,Polonia,616,97,157,254,"(4.697144,-74.140516)"
2022,Mayo,Portugal,620,0,1,1,"(3.893038,-77.067921)"
2016,Mayo,Rumania,642,0,1,1,"(12.586067,-81.702563)"
2018,Septiembre,India,356,0,6,6,"(4.815061,-75.736532)"
2014,Mayo,Nicaragua,558,55,74,129,"(4.697144,-74.140516)"
2017,Julio,Lituania,440,19,14,33,"(4.697144,-74.140516)"
2014,Enero,República Checa,203,1,4,5,"(10.445761,-75.516429)"
2012,Noviembre,Túnez,788,0,1,1,"(0.814836,-77.662532)"
2023,Mayo,Letonia,428,4,1,5,"(10.445761,-75.516429)"
2013,Febrero,Taiwán,158,0,1,1,"(0.814836,-77.662532)"
2023,Enero,Filipinas,608,4,190,194,"(10.408582,-75.538003)"
2023,Febrero,Japón,392,148,310,458,"(4.697144,-74.140516)"
2023,Febrero,Países Bajos,528,4,3,7,"(7.128456,-73.183637)"
2022,Julio,Brasil,76,11,18,29,"(0.814836,-77.662532)"
2021,Mayo,Paraguay,600,0,3,3,"(10.886611,-74.776708)"
2017,Mayo,Uganda,800,0,4,4,"(4.697144,-74.140516)"
2016,Julio,Reino Unido de Gran Bretaña e Irlanda del Norte,826,1,2,3,"(7.818934,-72.453226)"
2015,Noviembre,Estados Unidos de América,840,1,1,2,"(11.360009,-72.129330)"
2013,Septiembre,Turquía,792,0,1,1,"(0.814836,-77.662532)"
2014,Mayo,Sri Lanka,144,1,2,3,"(4.697144,-74.140516)"
2013,Noviembre,Ucrania,804,0,3,3,"(3.893038,-77.067921)"
2020,Marzo,Ecuador,218,2,0,2,"(7.916725,-72.462544)"
2012,Marzo,República Democrática del Congo,180,1,6,7,"(4.697144,-74.140516)"
2012,Diciembre,Taiwán,158,0,1,1,"(4.815061,-75.736532)"
2017,Abril,Dinamarca,208,1,0,1,"(1.813928,-78.763924)"
2022,Diciembre,Venezuela,862,0,1,1,"(10.971302,-74.765397)"
2021,Abril,Polonia,616,38,63,101,"(4.697144,-74.140516)"
2016,Enero,Panamá,591,105,161,266,"(4.452882,-75.766298)"
2012,Febrero,República de Corea,410,0,1,1,"(12.586067,-81.702563)"
2019,Agosto,Guyana,328,0,1,1,"(12.586067,-81.702563)"
2016,Noviembre,Alemania,276,58,105,163,"(3.541112,-76.384584)"
2012,Julio,Federación de Rusia,643,3,1,4,"(10.445761,-75.516429)"
2021,Octubre,Croacia,191,22,31,53,"(4.697144,-74.140516)"
2019,Agosto,Australia,36,13,8,21,"(10.408582,-75.538003)"
2023,Marzo,Chile,152,25,32,59,"(7.818934,-72.453226)"
2016,Mayo,Países Bajos,528,1,0,1,"(13.3387613,-81.372937)"
2018,Marzo,Arabia Saudita,682,1,0,1,"(0.814836,-77.662532)"
2016,Marzo,Estados Unidos de América,840,0,4,4,"(0.25129,-76.875963)"
2019,Octubre,República de Irlanda,372,1,7,8,"(8.635765,-77.346578)"
2015,Enero,Panamá,591,0,2,2,"(7.102626,-77.762647)"
2023,Marzo,Estados Unidos de América,840,11,8,19,"(11.360009,-72.129330)"
2012,Mayo,Alemania,276,23,55,78,"(6.171601,-75.427454)"
2012,Junio,Dinamarca,208,1,3,4,"(10.408582,-75.538003)"
2023,Junio,Burkina Faso,854,1,3,4,"(4.697144,-74.140516)"
2022,Agosto,India,356,0,1,1,"(11.117806,-74.232622)"
2022,Enero,Dinamarca,208,1,1,2,"(4.815061,-75.736532)"
2019,Marzo,Países Bajos,528,13,27,40,"(10.886611,-74.776708)"
2015,Marzo,Perú,604,37,27,64,"(10.408582,-75.538003)"
2016,Febrero,Países Bajos,528,0,2,2,"(4.697144,-74.140516)"
2018,Marzo,Emiratos Árabes,784,1,0,1,"(10.445761,-75.516429)"
2016,Mayo,India,356,0,2,2,"(10.971302,-74.765397)"
2019,Enero,India,356,0,1,1,"(10.971302,-74.765397)"
2015,Agosto,Malí,466,0,2,2,"(4.697144,-74.140516)"
2022,Noviembre,Estados Unidos de América,840,0,5,5,"(6.17134,-75.427194)"
2023,Junio,Malawi,454,0,1,1,"(4.697144,-74.140516)"
2021,Noviembre,Portugal,620,172,385,557,"(4.697144,-74.140516)"
2017,Mayo,Portugal,620,3,14,17,"(3.541112,-76.384584)"
2017,Mayo,Líbano,422,1,1,2,"(6.171601,-75.427454)"
2015,Marzo,Australia,36,1,6,7,"(10.886611,-74.776708)"
2012,Octubre,Nueva Zelanda,554,0,1,1,"(-4.197703,-69.941278)"
2012,Agosto,Taiwán,158,3,10,13,"(6.171601,-75.427454)"
2019,Julio,Nicaragua,558,0,1,1,"(12.5744111,-81.703935)"
2019,Junio,Grecia,300,0,2,2,"(10.886611,-74.776708)"
2016,Octubre,Italia,380,0,2,2,"(4.452882,-75.766298)"
2013,Noviembre,Federación de Rusia,643,0,1,1,"(3.893038,-77.067921)"
2012,Octubre,República de Corea,410,2,4,6,"(10.445761,-75.516429)"
2015,Enero,Reino Unido de Gran Bretaña e Irlanda del Norte,826,11,11,22,"(11.247723,-74.213989)"
2018,Junio,España,724,0,2,2,"(12.586067,-81.702563)"
2018,Julio,Finlandia,246,3,8,11,"(6.171601,-75.427454)"
2015,Agosto,Ecuador,218,0,1,1,"(11.117806,-74.232622)"
2021,Marzo,Ecuador,218,0,4,4,"(7.128456,-73.183637)"
2019,Febrero,Filipinas,608,0,11,11,"(10.886611,-74.776708)"
2019,Noviembre,Honduras,340,28,31,59,"(3.541112,-76.384584)"
2019,Noviembre,Honduras,340,549,553,1102,"(4.697144,-74.140516)"
2014,Octubre,Guyana,328,0,2,2,"(6.171601,-75.427454)"
2016,Febrero,Honduras,340,0,2,2,"(7.818934,-72.453226)"
2020,Enero,Arabia Saudita,682,1,0,1,"(6.171601,-75.427454)"
2019,Octubre,Reino Unido de Gran Bretaña e Irlanda del Norte,826,0,3,3,"(7.818934,-72.453226)"
2017,Junio,Dinamarca,208,4,6,10,"(3.541112,-76.384584)"
2015,Enero,Serbia,688,12,11,23,"(4.697144,-74.140516)"
2017,Octubre,Polonia,616,2,1,3,"(-4.197703,-69.941278)"
2013,Enero,Perú,604,144,194,338,"(3.541112,-76.384584)"
2012,Abril,Federación de Rusia,643,0,2,2,"(10.408582,-75.538003)"
2016,Diciembre,Países Bajos,528,81,191,272,"(3.541112,-76.384584)"
2012,Marzo,Ghana,288,2,3,5,"(4.697144,-74.140516)"
2022,Octubre,Francia,250,5,8,13,"(7.818934,-72.453226)"
2012,Marzo,Cuba,192,9,25,34,"(6.171601,-75.427454)"
2021,Agosto,Suecia,752,1,3,4,"(3.541112,-76.384584)"
2012,Junio,Guyana,328,0,1,1,"(10.445761,-75.516429)"
2019,Mayo,República Checa,203,7,13,20,"(0.814836,-77.662532)"
2018,Julio,Jordania,400,1,7,8,"(4.697144,-74.140516)"
2019,Noviembre,Suecia,752,234,316,550,"(4.697144,-74.140516)"
2012,Septiembre,Canadá,124,0,1,1,"(7.128456,-73.183637)"
2013,Marzo,Venezuela,862,4,10,14,"(10.408582,-75.538003)"
2014,Octubre,Canadá,124,2,3,5,"(8.635765,-77.346578)"
2019,Julio,Panamá,591,1,0,1,"(-4.223468,-69.945098)"
2018,Septiembre,Nicaragua,558,3,3,6,"(10.886611,-74.776708)"
2014,Diciembre,Portugal,620,1,1,2,"(7.927209,-72.507910)"
2014,Diciembre,Hungría,348,3,2,5,"(3.541112,-76.384584)"
2012,Julio,República Dominicana,214,6,0,6,"(7.128456,-73.183637)"
2018,Marzo,Suiza,756,21,22,43,"(10.408582,-75.538003)"
2019,Julio,México,484,1,0,1,"(-4.197703,-69.941278)"
2021,Julio,Sudáfrica,710,0,2,2,"(4.452882,-75.766298)"
2018,Septiembre,Serbia,688,0,1,1,"(12.586067,-81.702563)"
2014,Junio,Chipre,196,0,1,1,"(6.171601,-75.427454)"
2015,Enero,Reino Unido de Gran Bretaña e Irlanda del Norte,826,65,131,196,"(10.445761,-75.516429)"
2016,Marzo,Cuba,192,0,1,1,"(6.185799,-67.483929)"
2022,Septiembre,Italia,380,8,36,44,"(10.886611,-74.776708)"
2017,Diciembre,Islandia,352,0,2,2,"(4.452882,-75.766298)"
2013,Agosto,Bolivia,68,14,29,43,"(6.171601,-75.427454)"
2017,Mayo,Perú,604,291,398,689,"(6.171601,-75.427454)"
2018,Noviembre,Malta,470,0,1,1,"(6.171601,-75.427454)"
2013,Marzo,Venezuela,862,44,74,118,"(3.541112,-76.384584)"
2012,Marzo,Países Bajos,528,23,23,46,"(11.528919,-72.919681)"
2017,Septiembre,Francia,250,114,228,342,"(6.171601,-75.427454)"
2015,Diciembre,Bermudas/Territorio Británico de Ultramar,60,0,1,1,"(3.541112,-76.384584)"
2018,Diciembre,Argentina,32,1,4,5,"(8.635765,-77.346578)"
2015,Septiembre,Ecuador,218,21,15,36,"(7.927209,-72.507910)"
2016,Febrero,Australia,36,0,4,4,"(12.586067,-81.702563)"
2022,Junio,Brasil,76,63,53,116,"(12.586067,-81.702563)"
2013,Noviembre,Costa de Marfil,384,0,7,7,"(4.697144,-74.140516)"
2018,Septiembre,Canadá,124,11,32,43,"(10.886611,-74.776708)"
2020,Febrero,El Salvador,222,4,6,10,"(10.886611,-74.776708)"
2015,Abril,Haití,332,0,1,1,"(7.818934,-72.453226)"
2023,Junio,Alemania,276,12,14,26,"(10.886611,-74.776708)"
2013,Febrero,Islandia,352,2,3,5,"(4.697144,-74.140516)"
2019,Marzo,México,484,15,22,37,"(0.814836,-77.662532)"
2023,Febrero,Bolivia,68,10,10,20,"(10.886611,-74.776708)"
2018,Octubre,Portugal,620,7,8,15,"(3.541112,-76.384584)"
2016,Agosto,Mozambique,508,2,3,5,"(4.697144,-74.140516)"
2018,Noviembre,Alemania,276,113,207,320,"(6.171601,-75.427454)"
2020,Febrero,Bélgica,56,1,5,6,"(10.886611,-74.776708)"
2012,Febrero,Myanmar,104,1,0,1,"(4.697144,-74.140516)"
2023,Abril,Tailandia,764,2,0,2,"(6.171601,-75.427454)"
2016,Mayo,Bermudas/Territorio Británico de Ultramar,60,1,1,2,"(12.5744111,-81.703935)"
2018,Noviembre,Países Bajos,528,1739,2391,4130,"(4.697144,-74.140516)"
2019,Marzo,Guyana,328,0,1,1,"(10.408582,-75.538003)"
2015,Enero,Suecia,752,1,2,3,"(11.247723,-74.213989)"
2012,Noviembre,Costa Rica,188,42,42,84,"(10.445761,-75.516429)"
2013,Mayo,Japón,392,1,4,5,"(7.818934,-72.453226)"
2014,Julio,Guatemala,320,0,1,1,"(13.3387613,-81.372937)"
2015,Febrero,Reino Unido de Gran Bretaña e Irlanda del Norte,826,31,109,140,"(6.171601,-75.427454)"
2017,Octubre,Portugal,620,258,525,783,"(4.697144,-74.140516)"
2015,Septiembre,Bélgica,56,0,21,21,"(3.541112,-76.384584)"
2015,Septiembre,Letonia,428,0,4,4,"(10.408582,-75.538003)"
2013,Septiembre,Barbados,52,0,8,8,"(3.541112,-76.384584)"
2019,Diciembre,Tailandia,764,1,0,1,"(3.541112,-76.384584)"
2019,Enero,Ecuador,218,49,253,302,"(0.25129,-76.875963)"
2015,Marzo,Estados Unidos de América,840,891,1322,2213,"(3.541112,-76.384584)"
2021,Mayo,Ucrania,804,0,3,3,"(11.247723,-74.213989)"
2018,Septiembre,Desconocido,99999,1,0,1,"(7.818934,-72.453226)"
2014,Marzo,Austria,40,5,8,13,"(6.171601,-75.427454)"
2017,Octubre,Italia,380,0,1,1,"(11.247723,-74.213989)"
2022,Octubre,Grecia,300,1,10,11,"(10.445761,-75.516429)"
2017,Marzo,Rwanda,646,1,0,1,"(4.697144,-74.140516)"
2023,Marzo,República Dominicana,214,158,200,358,"(10.886611,-74.776708)"
2023,Febrero,Chile,152,4,3,7,"(-4.223468,-69.945098)"
2014,Diciembre,Cuba,192,16,22,38,"(6.171601,-75.427454)"
2013,Mayo,Francia,250,2,14,16,"(10.886611,-74.776708)"
2016,Noviembre,Países Bajos,528,1,0,1,"(12.586067,-81.702563)"
2017,Junio,Indonesia,360,0,5,5,"(10.971302,-74.765397)"
2015,Enero,Perú,604,0,2,2,"(6.185799,-67.483929)"
2023,Junio,Alemania,276,197,304,501,"(6.171601,-75.427454)"
2012,Abril,Nicaragua,558,0,3,3,"(10.408582,-75.538003)"
2019,Marzo,Nicaragua,558,2,6,8,"(4.815061,-75.736532)"
2017,Enero,Filipinas,608,0,9,9,"(10.886611,-74.776708)"
2019,Febrero,Alemania,276,0,1,1,"(11.360009,-72.129330)"
2022,Enero,México,484,0,6,6,"(10.408582,-75.538003)"
2021,Diciembre,Polonia,616,3,2,5,"(10.886611,-74.776708)"
2017,Abril,Brasil,76,1,1,2,"(7.128456,-73.183637)"
2018,Marzo,Reino Unido de Gran Bretaña e Irlanda del Norte,826,1,2,3,"(11.360009,-72.129330)"
2023,Febrero,Sierra Leona,694,0,2,2,"(4.697144,-74.140516)"
2019,Enero,Federación de Rusia,643,7,11,18,"(3.541112,-76.384584)"
2021,Abril,Macedonia,807,0,3,3,"(4.697144,-74.140516)"
2018,Junio,Venezuela,862,1,2,3,"(12.165168,-71.983761)"
2014,Abril,Brasil,76,10,18,28,"(10.886611,-74.776708)"
2023,Junio,Indonesia,360,0,13,13,"(3.893038,-77.067921)"
2014,Noviembre,Grecia,300,2,2,4,"(10.408582,-75.538003)"
2022,Diciembre,Guatemala,320,0,1,1,"(10.971302,-74.765397)"
2020,Diciembre,Argentina,32,9,21,30,"(10.886611,-74.776708)"
2023,Mayo,Ecuador,218,4,4,8,"(4.815061,-75.736532)"
2018,Diciembre,Reino Unido de Gran Bretaña e Irlanda del Norte,826,0,1,1,"(8.36068,-72.409396)"
2018,Febrero,Nigeria,566,1,0,1,"(10.445761,-75.516429)"
2012,Agosto,Italia,380,1,5,6,"(7.927209,-72.507910)"
2021,Noviembre,Jamaica,388,4,21,25,"(6.171601,-75.427454)"
2016,Abril,Argentina,32,4,8,12,"(-4.197703,-69.941278)"
2012,Abril,Uruguay,858,1,1,2,"(10.408582,-75.538003)"
2015,Octubre,República de Corea,410,0,1,1,"(7.818934,-72.453226)"
2018,Enero,Panamá,591,39,36,75,"(4.452882,-75.766298)"
2016,Enero,Bermudas/Territorio Británico de Ultramar,60,0,1,1,"(6.171601,-75.427454)"
2017,Noviembre,Austria,40,0,1,1,"(11.360009,-72.129330)"
2022,Abril,Trinidad y Tobago,780,0,1,1,"(7.916725,-72.462544)"
2013,Septiembre,Islas Vírgenes Británicas/Territorio Británico de Ultramar,92,1,0,1,"(10.445761,-75.516429)"
2016,Diciembre,Surinam,740,14,24,38,"(4.697144,-74.140516)"
2017,Noviembre,Filipinas,608,2,5,7,"(3.541112,-76.384584)"
2019,Abril,Argelia,12,0,1,1,"(3.541112,-76.384584)"
2017,Marzo,Ecuador,218,7,13,20,"(10.886611,-74.776708)"
2020,Diciembre,Estados Unidos de América,840,195,312,507,"(4.452882,-75.766298)"
2018,Febrero,Santa Lucia,662,0,3,3,"(4.697144,-74.140516)"
2013,Marzo,Países Bajos,528,1,5,6,"(10.886611,-74.776708)"
2023,Enero,Costa Rica,188,5,4,9,"(7.818934,-72.453226)"
2015,Enero,Perú,604,247,282,529,"(3.541112,-76.384584)"
2019,Septiembre,Suecia,752,1,2,3,"(0.814836,-77.662532)"
2017,Julio,Polonia,616,1,0,1,"(8.635765,-77.346578)"
2021,Abril,Filipinas,608,0,17,17,"(3.893038,-77.067921)"
2017,Agosto,Guatemala,320,16,78,94,"(3.541112,-76.384584)"
2017,Septiembre,Paraguay,600,68,34,102,"(12.586067,-81.702563)"
2021,Marzo,Cuba,192,0,1,1,"(7.128456,-73.183637)"
2023,Enero,Mauricio,480,0,1,1,"(10.408582,-75.538003)"
2012,Julio,Suiza,756,0,1,1,"(6.228046,-77.404104)"
2019,Agosto,Bolivia,68,2,1,3,"(4.815061,-75.736532)"
2018,Septiembre,Países Bajos,528,0,1,1,"(-4.223468,-69.945098)"
2013,Junio,Estados Unidos de América,840,43,56,99,"(7.128456,-73.183637)"
2013,Septiembre,España,724,13,20,33,"(10.408582,-75.538003)"
2014,Julio,Ecuador,218,5,9,14,"(7.927209,-72.507910)"
2021,Agosto,Guatemala,320,2,2,4,"(7.128456,-73.183637)"
2013,Agosto,Austria,40,8,6,14,"(10.445761,-75.516429)"
2017,Enero,Suiza,756,49,40,89,"(10.445761,-75.516429)"
2015,Enero,Nicaragua,558,3,0,3,"(7.128456,-73.183637)"
2018,Febrero,Brasil,76,10,11,21,"(7.818934,-72.453226)"
2015,Abril,Rumania,642,1,2,3,"(10.445761,-75.516429)"
2022,Junio,Canadá,124,48,63,111,"(3.541112,-76.384584)"
2016,Enero,Malasia,458,0,1,1,"(-4.197703,-69.941278)"
2012,Julio,Noruega,578,2,1,3,"(11.360009,-72.129330)"
2015,Noviembre,Perú,604,250,429,679,"(6.171601,-75.427454)"
2022,Agosto,Estados Unidos de América,840,80,125,205,"(11.117806,-74.232622)"
2020,Octubre,España,724,11,22,33,"(10.445761,-75.516429)"
2021,Septiembre,Portugal,620,4,5,9,"(10.886611,-74.776708)"
2022,Diciembre,Paraguay,600,28,16,44,"(6.171601,-75.427454)"
2018,Septiembre,Nicaragua,558,15,40,55,"(10.445761,-75.516429)"
2014,Abril,Japón,392,109,407,516,"(4.697144,-74.140516)"
2021,Julio,Ecuador,218,55,77,132,"(3.541112,-76.384584)"
2019,Enero,Argentina,32,2466,1878,4345,"(10.445761,-75.516429)"
2016,Octubre,Ecuador,218,0,3,3,"(6.228046,-77.404104)"
2013,Octubre,Países Bajos,528,0,8,8,"(3.893038,-77.067921)"
2012,Julio,Estonia,233,2,0,2,"(4.697144,-74.140516)"
2016,Diciembre,Federación de Rusia,643,9,15,24,"(10.445761,-75.516429)"
2017,Noviembre,Surinam,740,0,1,1,"(12.586067,-81.702563)"
2019,Enero,Chile,152,3,3,6,"(0.25129,-76.875963)"
2012,Abril,Federación de Rusia,643,0,1,1,"(10.408582,-75.538003)"
2012,Noviembre,Ucrania,804,4,0,4,"(6.171601,-75.427454)"
2015,Abril,Suecia,752,150,216,366,"(4.697144,-74.140516)"
2012,Abril,Canadá,124,1,1,2,"(10.971302,-74.765397)"
2016,Noviembre,Estados Unidos de América,840,33,40,73,"(12.586067,-81.702563)"
2014,Mayo,Argentina,32,112,264,376,"(6.171601,-75.427454)"
2015,Junio,República Checa,203,4,6,10,"(6.171601,-75.427454)"
2019,Mayo,Marruecos,504,0,2,2,"(10.445761,-75.516429)"
2013,Octubre,Turquía,792,1,0,1,"(10.886611,-74.776708)"
2021,Junio,Haití,332,1,1,2,"(3.541112,-76.384584)"
2018,Noviembre,Palestina,99999,2,3,5,"(4.697144,-74.140516)"
2012,Septiembre,Chile,152,1,2,3,"(8.635765,-77.346578)"
2016,Agosto,Venezuela,862,5234,4829,10063,"(7.088729,-70.740253)"
2017,Febrero,Suiza,756,3,1,4,"(11.247723,-74.213989)"
2017,Febrero,Kenia,404,0,1,1,"(3.541112,-76.384584)"
2020,Enero,Bolivia,68,6,7,14,"(10.886611,-74.776708)"
2020,Febrero,Francia,250,10,5,15,"(0.25129,-76.875963)"
2019,Febrero,Dominica,212,1,0,1,"(3.541112,-76.384584)"
2013,Julio,Turquía,792,0,1,1,"(0.814836,-77.662532)"
2022,Mayo,Belice,84,6,7,13,"(4.697144,-74.140516)"
2022,Octubre,Argentina,32,0,5,5,"(7.916725,-72.462544)"
2020,Marzo,Federación de Rusia,643,120,180,300,"(4.697144,-74.140516)"
2021,Junio,Portugal,620,59,127,187,"(4.697144,-74.140516)"
2012,Febrero,Chile,152,37,32,69,"(12.586067,-81.702563)"
2012,Septiembre,Estados Unidos de América,840,16,11,27,"(12.586067,-81.702563)"
2016,Diciembre,Letonia,428,0,4,4,"(10.886611,-74.776708)"
2013,Marzo,Filipinas,608,0,1,1,"(11.247723,-74.213989)"
2018,Enero,Federación de Rusia,643,5,16,21,"(3.541112,-76.384584)"
2021,Agosto,Albania,8,0,2,2,"(10.445761,-75.516429)"
2014,Abril,Tailandia,764,3,3,6,"(6.171601,-75.427454)"
2015,Abril,Sudáfrica,710,2,2,4,"(10.408582,-75.538003)"
2012,Marzo,Pakistán,586,1,25,26,"(4.697144,-74.140516)"
2015,Diciembre,Perú,604,3623,4279,7902,"(4.697144,-74.140516)"
2019,Marzo,Kazajistán,398,8,4,12,"(4.697144,-74.140516)"
2013,Diciembre,Canadá,124,89,133,222,"(3.541112,-76.384584)"
2019,Agosto,Costa Rica,188,1,3,4,"(8.36068,-72.409396)"
2019,Septiembre,Suecia,752,0,1,1,"(0.25129,-76.875963)"
2022,Febrero,Austria,40,1,0,1,"(10.408582,-75.538003)"
2023,Febrero,Bangladesh,50,0,3,3,"(3.893038,-77.067921)"
2012,Mayo,Líbano,422,0,1,1,"(3.541112,-76.384584)"
2022,Agosto,Túnez,788,3,9,12,"(4.697144,-74.140516)"
2017,Abril,Países Bajos,528,4,5,9,"(11.360009,-72.129330)"
2012,Mayo,España,724,2,6,8,"(4.815061,-75.736532)"
2015,Septiembre,Cuba,192,2,2,4,"(6.185799,-67.483929)"
2017,Julio,República Checa,203,7,7,14,"(10.445761,-75.516429)"
2015,Junio,Suecia,752,28,22,50,"(3.541112,-76.384584)"
2012,Noviembre,Francia,250,0,2,2,"(7.088729,-70.740253)"
2014,Diciembre,Marruecos,504,0,1,1,"(3.541112,-76.384584)"
2012,Abril,Portugal,620,63,235,298,"(4.697144,-74.140516)"
2022,Julio,Indonesia,360,0,1,1,"(10.408582,-75.538003)"
2020,Enero,Argentina,32,1,2,3,"(8.36068,-72.409396)"
2015,Marzo,Albania,8,1,0,1,"(10.445761,-75.516429)"
2016,Enero,Nueva Zelanda,554,1,2,3,"(10.886611,-74.776708)"
2013,Agosto,Polonia,616,2,3,5,"(7.818934,-72.453226)"
2014,Febrero,Indonesia,360,2,3,5,"(6.171601,-75.427454)"
2012,Septiembre,Irán,364,0,1,1,"(6.171601,-75.427454)"
2015,Mayo,Angola,24,1,3,4,"(4.697144,-74.140516)"
2019,Octubre,República de Belarús,112,0,1,1,"(6.171601,-75.427454)"
2017,Julio,Venezuela,862,19046,21872,40918,"(7.818934,-72.453226)"
2015,Marzo,Chile,152,25,102,127,"(6.171601,-75.427454)"
2018,Junio,Suiza,756,16,15,31,"(10.408582,-75.538003)"
2014,Octubre,Lituania,440,1,0,1,"(7.818934,-72.453226)"
2017,Septiembre,Estados Unidos de América,840,1,0,1,"(10.971302,-74.765397)"
2013,Septiembre,Ucrania,804,0,21,21,"(10.971302,-74.765397)"
2018,Junio,Suecia,752,6,6,12,"(0.814836,-77.662532)"
2016,Octubre,México,484,4,8,12,"(11.360009,-72.129330)"
2014,Noviembre,Suecia,752,1,0,1,"(8.635765,-77.346578)"
2022,Mayo,Venezuela,862,1313,1053,2375,"(7.916725,-72.462544)"
2018,Agosto,Brasil,76,1,0,1,"(4.452882,-75.766298)"
2014,Mayo,Australia,36,4,9,13,"(10.886611,-74.776708)"
2022,Septiembre,Bolivia,68,676,814,1491,"(4.697144,-74.140516)"
2015,Septiembre,Burundi,108,0,1,1,"(4.697144,-74.140516)"
2012,Septiembre,Canadá,124,0,2,2,"(11.360009,-72.129330)"
2013,Septiembre,Nueva Zelanda,554,0,1,1,"(7.927209,-72.507910)"
2018,Julio,Argentina,32,1489,1087,2576,"(10.445761,-75.516429)"
2013,Diciembre,Australia,36,0,6,6,"(11.360009,-72.129330)"
2016,Octubre,Nueva Zelanda,554,0,1,1,"(4.815061,-75.736532)"
2013,Abril,Estados Unidos de América,840,4,20,24,"(8.635765,-77.346578)"
2023,Mayo,República de Irlanda,372,30,64,94,"(6.171601,-75.427454)"
2018,Noviembre,Paraguay,600,81,48,129,"(10.445761,-75.516429)"
2020,Diciembre,Kazajistán,398,0,1,1,"(6.171601,-75.427454)"
2014,Abril,Zimbabue,716,5,8,13,"(4.697144,-74.140516)"
2015,Febrero,República Dominicana,214,0,4,4,"(11.360009,-72.129330)"
2022,Agosto,Portugal,620,24,36,60,"(7.818934,-72.453226)"
2016,Marzo,Hungría,348,1,2,3,"(3.541112,-76.384584)"
2019,Octubre,España,724,27,43,70,"(0.814836,-77.662532)"
2018,Mayo,Belice,84,0,1,1,"(0.814836,-77.662532)"
2021,Diciembre,República Dominicana,214,0,2,2,"(7.916725,-72.462544)"
2018,Marzo,Canadá,124,5,18,23,"(4.815061,-75.736532)"
2018,Septiembre,Rumania,642,1,1,2,"(0.814836,-77.662532)"
2014,Julio,Estados Unidos de América,840,31,40,71,"(7.927209,-72.507910)"
2012,Mayo,Australia,36,1,1,2,"(4.452882,-75.766298)"
2016,Abril,Malasia,458,2,1,3,"(10.445761,-75.516429)"
2017,Marzo,Estonia,233,1,3,4,"(0.814836,-77.662532)"
2023,Abril,India,356,0,91,91,"(10.971302,-74.765397)"
2018,Marzo,Estonia,233,1,2,3,"(6.171601,-75.427454)"
2019,Enero,República Checa,203,13,25,38,"(10.445761,-75.516429)"
2018,Enero,Federación de Rusia,643,249,272,521,"(4.697144,-74.140516)"
2023,Enero,Ecuador,218,14,13,27,"(4.815061,-75.736532)"
2018,Diciembre,Malta,470,0,2,2,"(0.814836,-77.662532)"
2018,Octubre,Brasil,76,3,7,10,"(7.818934,-72.453226)"
2022,Febrero,Canadá,124,3,0,3,"(4.452882,-75.766298)"
2015,Abril,Ecuador,218,23,58,81,"(6.171601,-75.427454)"
2013,Junio,Líbano,422,0,1,1,"(7.128456,-73.183637)"
2022,Septiembre,Costa Rica,188,0,2,2,"(12.5744111,-81.703935)"
2019,Abril,Alemania,276,4,9,13,"(0.25129,-76.875963)"
2014,Mayo,Bolivia,68,13,14,27,"(10.445761,-75.516429)"
2018,Julio,Guatemala,320,0,3,3,"(10.408582,-75.538003)"
2020,Enero,Brasil,76,694,547,1241,"(10.445761,-75.516429)"
2018,Noviembre,Suiza,756,1,0,1,"(8.36068,-72.409396)"
2017,Agosto,México,484,0,3,3,"(11.247723,-74.213989)"
2016,Octubre,República Checa,203,1,0,1,"(8.635765,-77.346578)"
2012,Marzo,Reino Unido de Gran Bretaña e Irlanda del Norte,826,1,0,1,"(-4.197703,-69.941278)"
2021,Abril,Chile,152,2,5,7,"(7.128456,-73.183637)"
2022,Mayo,Malta,470,0,2,2,"(10.445761,-75.516429)"
2013,Enero,Nueva Zelanda,554,2,2,4,"(10.408582,-75.538003)"
2018,Julio,República Árabe Siria,760,0,1,1,"(6.171601,-75.427454)"
2013,Septiembre,Uzbekistán,860,0,3,3,"(4.697144,-74.140516)"
2021,Enero,Francia,250,36,67,103,"(10.445761,-75.516429)"
2014,Enero,El Salvador,222,1,0,1,"(0.814836,-77.662532)"
2013,Octubre,Israel,376,0,2,2,"(10.408582,-75.538003)"
2022,Febrero,Guatemala,320,2,10,12,"(4.815061,-75.736532)"
2014,Junio,Austria,40,0,2,2,"(10.886611,-74.776708)"
2013,Mayo,República de Irlanda,372,8,18,26,"(0.814836,-77.662532)"
2016,Junio,República de Corea,410,226,454,680,"(4.697144,-74.140516)"
2023,Enero,Panamá,591,997,828,1825,"(10.445761,-75.516429)"
2017,Mayo,Ecuador,218,11,6,17,"(11.360009,-72.129330)"
2017,Febrero,Eslovenia,705,0,3,3,"(6.171601,-75.427454)"
2016,Octubre,Nicaragua,558,1,0,1,"(7.128456,-73.183637)"
2012,Julio,Perú,604,0,1,1,"(7.927209,-72.507910)"
2018,Febrero,Uruguay,858,1,2,3,"(8.36068,-72.409396)"
2016,Julio,Suecia,752,4,2,6,"(10.408582,-75.538003)"
2014,Septiembre,Noruega,578,0,5,5,"(11.247723,-74.213989)"
2019,Septiembre,República de Belarús,112,1,0,1,"(10.408582,-75.538003)"
2019,Junio,Reino Unido de Gran Bretaña e Irlanda del Norte,826,176,310,486,"(6.171601,-75.427454)"
2017,Agosto,Bolivia,68,15,12,27,"(12.586067,-81.702563)"
2015,Noviembre,Guinea,324,0,1,1,"(0.814836,-77.662532)"
2023,Junio,República de Corea,410,0,1,1,"(7.088729,-70.740253)"
2015,Septiembre,Dinamarca,208,0,1,1,"(4.815061,-75.736532)"
2015,Agosto,San Cristóbal y Nevis,659,0,1,1,"(6.171601,-75.427454)"
2013,Marzo,Suecia,752,1,8,9,"(10.408582,-75.538003)"
2021,Julio,Desconocido,99999,0,1,1,"(3.541112,-76.384584)"
2020,Diciembre,República Dominicana,214,24,37,61,"(10.445761,-75.516429)"
2022,Enero,Estados Unidos de América,840,0,2,2,"(6.185799,-67.483929)"
2015,Junio,Rumania,642,33,65,98,"(4.697144,-74.140516)"
2017,Mayo,Albania,8,1,1,2,"(10.445761,-75.516429)"
2014,Marzo,Reino Unido de Gran Bretaña e Irlanda del Norte,826,11,19,30,"(10.408582,-75.538003)"
2017,Enero,Cuba,192,12,19,31,"(10.886611,-74.776708)"
2015,Diciembre,Uruguay,858,5,9,14,"(0.814836,-77.662532)"
2012,Diciembre,Eslovaquia,703,1,1,2,"(0.814836,-77.662532)"
2018,Mayo,Luxemburgo,442,1,1,2,"(-4.223468,-69.945098)"
2013,Enero,Argentina,32,1,1,2,"(1.813928,-78.763924)"
2019,Abril,Reino Unido de Gran Bretaña e Irlanda del Norte,826,1,6,7,"(13.3387613,-81.372937)"
2019,Octubre,Suiza,756,0,1,1,"(11.528919,-72.919681)"
2018,Marzo,Malawi,454,1,1,2,"(6.171601,-75.427454)"
2015,Julio,Portugal,620,3,7,10,"(0.814836,-77.662532)"
2013,Agosto,Ecuador,218,0,1,1,"(12.5744111,-81.703935)"
2018,Junio,Chile,152,3,4,7,"(0.25129,-76.875963)"
2016,Abril,Australia,36,19,12,31,"(8.635765,-77.346578)"
2013,Mayo,Rumania,642,3,2,5,"(3.541112,-76.384584)"
2015,Junio,Suecia,752,0,1,1,"(7.128456,-73.183637)"
2015,Marzo,Honduras,340,0,1,1,"(8.066966,-76.735404)"
2018,Junio,Polonia,616,8,14,22,"(10.445761,-75.516429)"
2022,Octubre,Italia,380,0,1,1,"(8.635765,-77.346578)"
2014,Mayo,Polonia,616,10,3,13,"(11.360009,-72.129330)"
2019,Diciembre,Jamaica,388,0,2,2,"(7.818934,-72.453226)"
2021,Diciembre,Malasia,458,1,0,1,"(10.445761,-75.516429)"
2012,Octubre,China,156,3,6,9,"(3.541112,-76.384584)"
2022,Octubre,Ucrania,804,0,6,6,"(10.971302,-74.765397)"
2016,Septiembre,Arabia Saudita,682,0,1,1,"(6.171601,-75.427454)"
2014,Septiembre,Letonia,428,3,3,6,"(4.697144,-74.140516)"
2015,Diciembre,Bélgica,56,14,47,61,"(6.171601,-75.427454)"
2018,Febrero,República de Moldavia,498,1,1,2,"(4.697144,-74.140516)"
2022,Agosto,Chile,152,1,0,1,"(6.18189,-67.47535)"
2019,Febrero,Dinamarca,208,3,7,10,"(3.541112,-76.384584)"
2019,Diciembre,Suiza,756,0,1,1,"(7.818934,-72.453226)"
2015,Marzo,Canadá,124,35,45,80,"(10.408582,-75.538003)"
2018,Julio,Ucrania,804,0,6,6,"(10.971302,-74.765397)"
2018,Agosto,Bermudas/Territorio Británico de Ultramar,60,0,3,3,"(3.541112,-76.384584)"
2016,Julio,Costa Rica,188,168,217,385,"(6.171601,-75.427454)"
2021,Abril,Ucrania,804,0,3,3,"(6.171601,-75.427454)"
2015,Noviembre,Trinidad y Tobago,780,0,1,1,"(7.818934,-72.453226)"
2016,Octubre,Brasil,76,21,33,54,"(0.814836,-77.662532)"
2017,Febrero,Turquía,792,0,6,6,"(10.971302,-74.765397)"
2019,Mayo,Angola,24,0,7,7,"(4.697144,-74.140516)"
2014,Julio,Nicaragua,558,8,5,13,"(3.541112,-76.384584)"
2017,Mayo,Portugal,620,1,1,2,"(-4.223468,-69.945098)"
2016,Enero,Letonia,428,0,1,1,"(10.886611,-74.776708)"
2012,Octubre,Curazao,99999,3,0,3,"(6.171601,-75.427454)"
2012,Abril,Trinidad y Tobago,780,6,3,9,"(4.815061,-75.736532)"
2015,Junio,Georgia,268,2,0,2,"(10.445761,-75.516429)"
2022,Abril,Uruguay,858,100,75,175,"(10.445761,-75.516429)"
2018,Marzo,Venezuela,862,0,8,8,"(12.165168,-71.983761)"
2017,Octubre,Chipre,196,2,2,4,"(4.697144,-74.140516)"
2013,Febrero,Trinidad y Tobago,780,13,31,44,"(4.697144,-74.140516)"
2016,Abril,República Checa,203,2,1,3,"(10.445761,-75.516429)"
2013,Agosto,Sri Lanka,144,0,1,1,"(3.541112,-76.384584)"
2014,Mayo,Panamá,591,59,87,146,"(10.886611,-74.776708)"
2016,Abril,Cuba,192,1,0,1,"(13.3387613,-81.372937)"
2012,Septiembre,Curazao,99999,6,9,15,"(6.171601,-75.427454)"
2018,Abril,Ucrania,804,0,1,1,"(3.893038,-77.067921)"
2017,Septiembre,Venezuela,862,15,26,41,"(10.408582,-75.538003)"
2016,Junio,Italia,380,4,10,14,"(10.408582,-75.538003)"
2014,Julio,Taiwán,158,2,5,7,"(6.171601,-75.427454)"
2023,Febrero,Venezuela,862,2134,1799,3933,"(8.364293,-72.405710)"
2021,Diciembre,Marruecos,504,2,3,5,"(3.541112,-76.384584)"
2019,Octubre,Suiza,756,0,2,2,"(7.818934,-72.453226)"
2012,Mayo,Uruguay,858,0,1,1,"(7.128456,-73.183637)"
2012,Julio,Islas Aland/Provincia de Finlandia,248,1,1,2,"(4.697144,-74.140516)"
2018,Noviembre,Costa Rica,188,1376,1883,3259,"(4.697144,-74.140516)"
2012,Junio,Azerbaiyán,31,0,2,2,"(4.697144,-74.140516)"
2019,Julio,Estonia,233,0,1,1,"(3.541112,-76.384584)"
2014,Mayo,República de Irlanda,372,53,128,181,"(4.697144,-74.140516)"
2013,Noviembre,República Dominicana,214,23,71,94,"(10.445761,-75.516429)"
2021,Abril,República de Corea,410,0,1,1,"(10.445761,-75.516429)"
2021,Octubre,Italia,380,5,7,12,"(8.36068,-72.409396)"
2021,Febrero,Italia,380,0,6,6,"(7.818934,-72.453226)"
2019,Junio,Chile,152,0,1,1,"(8.36068,-72.409396)"
2012,Mayo,Reino Unido de Gran Bretaña e Irlanda del Norte,826,2,8,10,"(10.408582,-75.538003)"
2017,Agosto,Polonia,616,1,0,1,"(0.25129,-76.875963)"
2013,Octubre,Francia,250,1,1,2,"(6.228046,-77.404104)"
2018,Octubre,Filipinas,608,4,6,10,"(6.171601,-75.427454)"
2016,Julio,Brasil,76,1,4,5,"(7.927209,-72.507910)"
2017,Diciembre,Bermudas/Territorio Británico de Ultramar,60,1,0,1,"(10.445761,-75.516429)"
2016,Marzo,Japón,392,0,2,2,"(8.635765,-77.346578)"
2012,Diciembre,Cuba,192,1,1,2,"(10.408582,-75.538003)"
2018,Marzo,Argentina,32,2,2,4,"(4.452882,-75.766298)"
2014,Octubre,Etiopia,231,0,3,3,"(10.445761,-75.516429)"
2017,Julio,Brasil,76,719,531,1250,"(10.445761,-75.516429)"
2012,Noviembre,Polonia,616,0,2,2,"(7.927209,-72.507910)"
2021,Noviembre,Italia,380,20,43,63,"(3.541112,-76.384584)"
2013,Enero,Rumania,642,1,1,2,"(11.360009,-72.129330)"
2014,Agosto,Namibia,516,0,2,2,"(4.697144,-74.140516)"
2019,Octubre,Bermudas/Territorio Británico de Ultramar,60,0,1,1,"(6.171601,-75.427454)"
2015,Octubre,República de Corea,410,0,3,3,"(10.886611,-74.776708)"
2022,Marzo,Suiza,756,334,490,824,"(4.697144,-74.140516)"
2016,Agosto,Países Bajos,528,0,1,1,"(0.25129,-76.875963)"
2013,Marzo,Croacia,191,0,3,3,"(3.893038,-77.067921)"
2014,Marzo,Etiopia,231,0,2,2,"(4.697144,-74.140516)"
2019,Junio,Ucrania,804,1,4,5,"(10.445761,-75.516429)"
2017,Septiembre,Alemania,276,84,58,142,"(0.814836,-77.662532)"
2015,Agosto,Bolivia,68,3,10,13,"(10.886611,-74.776708)"
2015,Octubre,Ucrania,804,5,8,13,"(3.541112,-76.384584)"
2017,Abril,Portugal,620,0,1,1,"(7.088729,-70.740253)"
2012,Marzo,San  Vicente y las Granadinas,670,1,1,2,"(6.171601,-75.427454)"
2018,Septiembre,Mozambique,508,1,1,2,"(4.697144,-74.140516)"
2019,Mayo,India,356,0,1,1,"(7.128456,-73.183637)"
2015,Diciembre,Estados Unidos de América,840,3,3,6,"(11.247723,-74.213989)"
2014,Diciembre,Uruguay,858,41,43,84,"(10.445761,-75.516429)"
2021,Junio,Venezuela,862,1712,1630,3342,"(7.818934,-72.453226)"
2018,Agosto,Francia,250,2,3,5,"(7.128456,-73.183637)"
2012,Junio,Honduras,340,10,21,31,"(6.171601,-75.427454)"
2023,Mayo,España,724,1,1,2,"(11.247723,-74.213989)"
2023,Junio,Polonia,616,0,1,1,"(4.815061,-75.736532)"
2019,Septiembre,Portugal,620,4,14,18,"(3.541112,-76.384584)"
2018,Abril,Hong Kong,344,0,1,1,"(0.814836,-77.662532)"
2017,Enero,Honduras,340,0,3,3,"(10.971302,-74.765397)"
2015,Junio,Alemania,276,0,2,2,"(7.927209,-72.507910)"
2015,Junio,República Checa,203,0,1,1,"(8.635765,-77.346578)"
2018,Febrero,India,356,0,3,3,"(9.402978,-75.681599)"
2013,Noviembre,Países Bajos,528,17,42,59,"(3.541112,-76.384584)"
2022,Mayo,Mónaco,492,1,0,1,"(4.697144,-74.140516)"
2012,Noviembre,Líbano,422,1,0,1,"(10.445761,-75.516429)"
2022,Febrero,El Salvador,222,2,2,4,"(4.815061,-75.736532)"
2019,Septiembre,Líbano,422,0,1,1,"(4.815061,-75.736532)"
2022,Marzo,México,484,6,13,19,"(0.814836,-77.662532)"
2019,Junio,Bolivia,68,1,0,1,"(8.635765,-77.346578)"
2013,Abril,Chile,152,0,1,1,"(0.25129,-76.875963)"
2016,Abril,Noruega,578,3,1,4,"(10.408582,-75.538003)"
2020,Marzo,México,484,6,6,12,"(7.818934,-72.453226)"
2015,Agosto,Italia,380,4,12,16,"(-4.197703,-69.941278)"
2014,Mayo,República de Irlanda,372,1,2,3,"(8.635765,-77.346578)"
2015,Diciembre,Australia,36,2,2,4,"(4.452882,-75.766298)"
2015,Julio,Alemania,276,17,22,39,"(10.886611,-74.776708)"
2015,Julio,Zambia,894,0,1,1,"(4.697144,-74.140516)"
2012,Febrero,Islas Salomón,90,1,0,1,"(4.697144,-74.140516)"
2017,Agosto,Estonia,233,0,1,1,"(10.408582,-75.538003)"
2019,Agosto,Bahamas,44,6,7,13,"(10.445761,-75.516429)"
2019,Octubre,Georgia,268,5,9,14,"(4.697144,-74.140516)"
2019,Junio,Trinidad y Tobago,780,0,1,1,"(7.818934,-72.453226)"
2020,Diciembre,India,356,3,18,21,"(10.445761,-75.516429)"
2019,Noviembre,Italia,380,0,3,3,"(-4.197703,-69.941278)"
2014,Noviembre,Argentina,32,36,73,109,"(0.814836,-77.662532)"
2021,Noviembre,España,724,1,2,3,"(-4.197703,-69.941278)"
2018,Septiembre,México,484,1,0,1,"(11.247723,-74.213989)"
2014,Agosto,Bahamas,44,1,0,1,"(10.408582,-75.538003)"
2016,Junio,Alemania,276,1,1,2,"(3.893038,-77.067921)"
2016,Septiembre,Reino Unido de Gran Bretaña e Irlanda del Norte,826,796,1675,2471,"(4.697144,-74.140516)"
2022,Febrero,Turquía,792,0,7,7,"(3.541112,-76.384584)"
2014,Noviembre,Cuba,192,1,2,3,"(7.128456,-73.183637)"
2014,Marzo,Rumania,642,2,1,3,"(3.541112,-76.384584)"
2015,Octubre,Singapur,702,0,2,2,"(10.445761,-75.516429)"
2013,Octubre,Chipre,196,0,1,1,"(10.971302,-74.765397)"
2020,Enero,Bulgaria,100,2,0,2,"(0.814836,-77.662532)"
2016,Enero,Kazajistán,398,1,2,3,"(3.541112,-76.384584)"
2015,Mayo,Andorra,20,0,1,1,"(4.815061,-75.736532)"
2017,Mayo,México,484,8,13,21,"(4.815061,-75.736532)"
2018,Agosto,Dinamarca,208,1,1,2,"(-4.197703,-69.941278)"
2014,Enero,República de Irlanda,372,51,140,191,"(4.697144,-74.140516)"
2012,Septiembre,Aruba,533,3,2,5,"(6.171601,-75.427454)"
2023,Abril,Nueva Zelanda,554,1,1,2,"(0.814836,-77.662532)"
2019,Agosto,República de Irlanda,372,1,1,2,"(4.815061,-75.736532)"
2022,Marzo,India,356,0,45,45,"(3.893038,-77.067921)"
2015,Septiembre,Perú,604,11,15,26,"(10.408582,-75.538003)"
2013,Febrero,España,724,43,96,139,"(3.541112,-76.384584)"
2015,Diciembre,Granada,308,1,3,4,"(4.697144,-74.140516)"
2012,Febrero,Argentina,32,27,69,96,"(3.541112,-76.384584)"
2016,Marzo,El Salvador,222,896,1009,1905,"(4.697144,-74.140516)"
2017,Agosto,Jamaica,388,4,1,5,"(7.128456,-73.183637)"
2017,Octubre,República de Corea,410,0,1,1,"(11.360009,-72.129330)"
2021,Octubre,Tanzania,834,1,1,2,"(10.445761,-75.516429)"
2018,Enero,Federación de Rusia,643,18,9,27,"(6.171601,-75.427454)"
2021,Diciembre,Venezuela,862,1337,1476,2813,"(6.171601,-75.427454)"
2014,Septiembre,Sudáfrica,710,1,3,4,"(10.408582,-75.538003)"
2019,Diciembre,Chipre,196,11,11,22,"(4.697144,-74.140516)"
2012,Marzo,Nueva Zelanda,554,3,7,10,"(10.445761,-75.516429)"
2022,Abril,Tanzania,834,0,1,1,"(4.697144,-74.140516)"
2020,Noviembre,Uruguay,858,11,47,58,"(4.697144,-74.140516)"
2016,Diciembre,China,156,28,39,67,"(6.171601,-75.427454)"
2014,Julio,Aruba,533,0,1,1,"(3.541112,-76.384584)"
2012,Agosto,República Dominicana,214,5,10,15,"(0.814836,-77.662532)"
2022,Agosto,Canadá,124,11,18,29,"(4.815061,-75.736532)"
2018,Julio,Reino Unido de Gran Bretaña e Irlanda del Norte,826,1,2,3,"(4.452882,-75.766298)"
2015,Mayo,Francia,250,0,1,1,"(7.128456,-73.183637)"
2022,Septiembre,Sudáfrica,710,0,3,3,"(3.541112,-76.384584)"
2020,Septiembre,Canadá,124,3,11,14,"(10.445761,-75.516429)"
2019,Enero,Turquía,792,0,1,1,"(10.886611,-74.776708)"
2015,Mayo,España,724,0,2,2,"(0.25129,-76.875963)"
2018,Octubre,Perú,604,3,3,6,"(7.088729,-70.740253)"
2018,Enero,India,356,0,4,4,"(3.893038,-77.067921)"
2019,Septiembre,Ecuador,218,36,67,103,"(1.813928,-78.763924)"
2013,Mayo,Sudáfrica,710,25,69,94,"(4.697144,-74.140516)"
2014,Julio,Egipto,818,0,4,4,"(10.445761,-75.516429)"
2013,Enero,Kenia,404,2,4,6,"(4.697144,-74.140516)"
2015,Noviembre,Argentina,32,63,109,172,"(0.814836,-77.662532)"
2017,Junio,Bolivia,68,1,1,2,"(7.128456,-73.183637)"
2018,Enero,Filipinas,608,5,3,8,"(6.171601,-75.427454)"
2012,Octubre,España,724,4,5,9,"(7.927209,-72.507910)"
2012,Noviembre,Canadá,124,2,2,4,"(8.635765,-77.346578)"
2022,Abril,República Dominicana,214,1771,1688,3459,"(6.171601,-75.427454)"
2013,Noviembre,Reino Unido de Gran Bretaña e Irlanda del Norte,826,3,1,4,"(11.247723,-74.213989)"
2016,Marzo,Finlandia,246,2,8,10,"(10.886611,-74.776708)"
2023,Mayo,San  Vicente y las Granadinas,670,1,1,2,"(11.117806,-74.232622)"
2014,Julio,México,484,23,35,58,"(7.818934,-72.453226)"
2019,Septiembre,Israel,376,21,53,74,"(10.445761,-75.516429)"
2018,Noviembre,Chile,152,590,399,989,"(10.445761,-75.516429)"
2023,Marzo,Rumania,642,1,19,20,"(10.408582,-75.538003)"
2022,Enero,Austria,40,2,4,6,"(0.814836,-77.662532)"
2021,Mayo,Países Bajos,528,175,418,593,"(4.697144,-74.140516)"
2013,Septiembre,Paraguay,600,3,5,8,"(3.541112,-76.384584)"
2017,Abril,Estonia,233,0,3,3,"(6.171601,-75.427454)"
2013,Agosto,Dinamarca,208,2,3,5,"(10.445761,-75.516429)"
2018,Septiembre,Pakistán,586,0,2,2,"(6.171601,-75.427454)"
2021,Julio,Líbano,422,12,17,29,"(4.697144,-74.140516)"
2015,Diciembre,República de Corea,410,1,0,1,"(7.128456,-73.183637)"
2013,Septiembre,Cuba,192,1,0,1,"(6.185799,-67.483929)"
2015,Enero,Lituania,440,2,0,2,"(10.445761,-75.516429)"
2022,Marzo,Rumania,642,15,18,33,"(6.171601,-75.427454)"
2013,Marzo,Cuba,192,1,0,1,"(7.128456,-73.183637)"
2015,Abril,Canadá,124,1,4,5,"(7.128456,-73.183637)"
2022,Marzo,Pakistán,586,1,0,1,"(10.445761,-75.516429)"
2017,Diciembre,Nueva Zelanda,554,5,2,7,"(0.814836,-77.662532)"
2016,Septiembre,Israel,376,6,22,28,"(10.445761,-75.516429)"
2018,Abril,Chile,152,2,2,4,"(0.25129,-76.875963)"
2022,Febrero,Suiza,756,0,2,2,"(11.247723,-74.213989)"
2019,Marzo,Rumania,642,1,0,1,"(-4.223468,-69.945098)"
2015,Diciembre,República de Corea,410,312,463,775,"(4.697144,-74.140516)"
2023,Enero,Francia,250,0,2,2,"(12.5744111,-81.703935)"
2016,Octubre,Ucrania,804,0,3,3,"(11.247723,-74.213989)"
2018,Abril,Federación de Rusia,643,0,1,1,"(9.402978,-75.681599)"
2019,Mayo,Afganistán,4,0,2,2,"(4.697144,-74.140516)"
2012,Agosto,Lituania,440,2,1,3,"(10.445761,-75.516429)"
2016,Septiembre,Cuba,192,1,3,4,"(7.128456,-73.183637)"
2014,Febrero,Ucrania,804,5,11,16,"(3.541112,-76.384584)"
2021,Agosto,República Checa,203,0,3,3,"(10.445761,-75.516429)"
2013,Abril,Chile,152,41,32,73,"(12.586067,-81.702563)"
2016,Mayo,Finlandia,246,5,2,7,"(3.541112,-76.384584)"
2021,Enero,Bélgica,56,7,7,14,"(10.445761,-75.516429)"
2013,Marzo,Paraguay,600,5,5,10,"(6.171601,-75.427454)"
2016,Diciembre,Bolivia,68,28,22,50,"(12.586067,-81.702563)"
2018,Abril,Venezuela,862,1,6,7,"(-4.197703,-69.941278)"
2021,Agosto,Cuba,192,5,12,17,"(10.886611,-74.776708)"
2020,Marzo,Noruega,578,1,1,2,"(-4.223468,-69.945098)"
2012,Julio,Eslovaquia,703,0,1,1,"(-4.197703,-69.941278)"
2019,Diciembre,Finlandia,246,0,1,1,"(-4.223468,-69.945098)"
2018,Abril,Francia,250,0,1,1,"(4.452882,-75.766298)"
2018,Junio,Francia,250,2,0,2,"(8.36068,-72.409396)"
2022,Julio,Sudáfrica,710,1,8,9,"(3.541112,-76.384584)"
2020,Diciembre,Países Bajos,528,1,1,2,"(10.408582,-75.538003)"
2023,Junio,Georgia,268,0,1,1,"(11.247723,-74.213989)"
2018,Abril,Panamá,591,91,126,217,"(10.886611,-74.776708)"
2015,Agosto,Panamá,591,4,8,12,"(7.128456,-73.183637)"
2016,Mayo,Nicaragua,558,4,3,7,"(10.886611,-74.776708)"
2018,Mayo,Bélgica,56,21,38,59,"(6.171601,-75.427454)"
2018,Mayo,Tanzania,834,0,1,1,"(10.445761,-75.516429)"
2022,Mayo,Andorra,20,4,6,10,"(4.697144,-74.140516)"
2012,Octubre,Bosnia y Herzegovina,70,1,1,2,"(4.697144,-74.140516)"
2012,Septiembre,Ecuador,218,10,25,35,"(0.25129,-76.875963)"
2017,Febrero,Guatemala,320,2,7,9,"(4.815061,-75.736532)"
2018,Febrero,Japón,392,1,0,1,"(12.586067,-81.702563)"
2020,Febrero,Guinea,324,0,2,2,"(6.171601,-75.427454)"
2021,Noviembre,Brasil,76,2399,3024,5425,"(4.697144,-74.140516)"
2018,Marzo,Bulgaria,100,0,3,3,"(12.586067,-81.702563)"
2019,Septiembre,España,724,2,1,3,"(7.128456,-73.183637)"
2018,Julio,Cuba,192,1,0,1,"(10.408582,-75.538003)"
2017,Octubre,Ucrania,804,0,1,1,"(10.971302,-74.765397)"
2016,Enero,Dinamarca,208,0,1,1,"(11.247723,-74.213989)"
2017,Marzo,Egipto,818,0,1,1,"(11.360009,-72.129330)"
2023,Mayo,Uruguay,858,39,38,77,"(12.586067,-81.702563)"
2022,Octubre,Nicaragua,558,115,135,250,"(4.697144,-74.140516)"
2022,Junio,Pakistán,586,0,1,1,"(3.541112,-76.384584)"
2021,Noviembre,Estados Unidos de América,840,113,254,367,"(7.128456,-73.183637)"
2021,Abril,India,356,0,18,18,"(10.408582,-75.538003)"
2014,Julio,Australia,36,3,10,13,"(10.886611,-74.776708)"
2019,Febrero,Finlandia,246,0,1,1,"(8.635765,-77.346578)"
2014,Febrero,India,356,6,6,12,"(10.445761,-75.516429)"
2017,Septiembre,Uruguay,858,20,36,56,"(6.171601,-75.427454)"
2016,Abril,Ecuador,218,0,2,2,"(7.927209,-72.507910)"
2018,Octubre,Sudáfrica,710,0,1,1,"(12.5744111,-81.703935)"
2022,Enero,Egipto,818,0,1,1,"(10.445761,-75.516429)"
2018,Julio,Panamá,591,4,2,6,"(7.818934,-72.453226)"
2021,Septiembre,Italia,380,1,2,3,"(7.128456,-73.183637)"
2020,Diciembre,Bélgica,56,0,1,1,"(10.886611,-74.776708)"
2023,Marzo,Venezuela,862,194,234,428,"(3.541112,-76.384584)"
2023,Abril,Uruguay,858,48,75,123,"(6.171601,-75.427454)"
2016,Julio,Países Bajos,528,5,5,10,"(12.586067,-81.702563)"
2012,Abril,España,724,1,3,4,"(12.5744111,-81.703935)"
2019,Octubre,Perú,604,7,9,16,"(10.886611,-74.776708)"
2014,Noviembre,Nicaragua,558,0,1,1,"(10.408582,-75.538003)"
2013,Octubre,Israel,376,0,2,2,"(-4.197703,-69.941278)"
2015,Febrero,Angola,24,0,3,3,"(4.697144,-74.140516)"
2019,Octubre,Nicaragua,558,38,20,58,"(10.886611,-74.776708)"
2020,Septiembre,Santa Lucia,662,2,2,4,"(3.541112,-76.384584)"
2012,Octubre,Líbano,422,18,25,43,"(4.697144,-74.140516)"
2023,Mayo,Guatemala,320,4,17,21,"(10.886611,-74.776708)"
2015,Junio,Bahréin,48,1,1,2,"(4.697144,-74.140516)"
2018,Julio,Croacia,191,0,1,1,"(11.247723,-74.213989)"
2022,Febrero,Australia,36,0,1,1,"(4.452882,-75.766298)"
2015,Mayo,Portugal,620,0,1,1,"(12.5744111,-81.703935)"
2012,Diciembre,Nicaragua,558,1,1,2,"(7.128456,-73.183637)"
2014,Diciembre,Ucrania,804,0,1,1,"(11.247723,-74.213989)"
2013,Septiembre,Grecia,300,0,3,3,"(3.541112,-76.384584)"
2013,Febrero,Brasil,76,1,2,3,"(7.128456,-73.183637)"
2019,Marzo,Granada,308,2,3,5,"(4.697144,-74.140516)"
2015,Mayo,España,724,5,10,15,"(10.408582,-75.538003)"
2013,Octubre,Ecuador,218,477,545,1022,"(6.171601,-75.427454)"
2018,Diciembre,Francia,250,83,96,179,"(0.814836,-77.662532)"
2022,Noviembre,Canadá,124,7,8,15,"(10.408582,-75.538003)"
2013,Enero,Perú,604,176,167,343,"(10.445761,-75.516429)"
2015,Noviembre,Perú,604,51,49,100,"(10.408582,-75.538003)"
2012,Julio,Reino Unido de Gran Bretaña e Irlanda del Norte,826,6,3,9,"(11.360009,-72.129330)"
2018,Octubre,Chile,152,2,3,5,"(0.25129,-76.875963)"
2021,Junio,Venezuela,862,0,1,1,"(11.247723,-74.213989)"
2017,Marzo,Francia,250,2,10,12,"(0.25129,-76.875963)"
2013,Febrero,Austria,40,0,1,1,"(10.886611,-74.776708)"
2018,Julio,Myanmar,104,0,2,2,"(10.445761,-75.516429)"
2019,Mayo,México,484,358,505,863,"(10.445761,-75.516429)"
2015,Mayo,Granada,308,1,3,4,"(4.697144,-74.140516)"
2019,Enero,Italia,380,1,1,2,"(7.128456,-73.183637)"
2018,Junio,Venezuela,862,0,3,3,"(10.971302,-74.765397)"
2020,Octubre,Perú,604,0,1,1,"(0.814836,-77.662532)"
2015,Agosto,República Árabe Siria,760,1,2,3,"(4.697144,-74.140516)"
2021,Agosto,Grecia,300,1,7,8,"(6.171601,-75.427454)"
2017,Noviembre,México,484,0,3,3,"(8.635765,-77.346578)"
2013,Febrero,Suiza,756,16,58,74,"(6.171601,-75.427454)"
2012,Febrero,Venezuela,862,2,15,17,"(4.815061,-75.736532)"
2014,Diciembre,República de Irlanda,372,5,12,17,"(6.171601,-75.427454)"
2018,Febrero,Luxemburgo,442,0,1,1,"(7.818934,-72.453226)"
2017,Enero,Australia,36,0,1,1,"(11.360009,-72.129330)"
2016,Diciembre,Venezuela,862,777,1276,2053,"(0.814836,-77.662532)"
2022,Enero,Surinam,740,4,11,15,"(4.697144,-74.140516)"
2023,Febrero,República de Irlanda,372,24,62,86,"(6.171601,-75.427454)"
2017,Diciembre,Luxemburgo,442,0,1,1,"(0.814836,-77.662532)"
2016,Julio,Polonia,616,138,189,327,"(4.697144,-74.140516)"
2018,Enero,República Checa,203,12,8,20,"(10.445761,-75.516429)"
2017,Octubre,Guyana,328,8,16,24,"(4.697144,-74.140516)"
2016,Julio,Bolivia,68,43,35,78,"(10.445761,-75.516429)"
2013,Mayo,Estados Unidos de América,840,5,12,17,"(8.635765,-77.346578)"
2018,Noviembre,Sudáfrica,710,1,2,3,"(3.541112,-76.384584)"
2020,Diciembre,Guatemala,320,18,25,43,"(3.541112,-76.384584)"
2016,Diciembre,Estados Unidos de América,840,3488,4758,8246,"(10.445761,-75.516429)"
2013,Agosto,Países Bajos,528,3,5,8,"(12.586067,-81.702563)"
2016,Noviembre,Alemania,276,1,9,10,"(7.818934,-72.453226)"
2017,Marzo,Andorra,20,1,10,11,"(4.697144,-74.140516)"
2016,Julio,Bélgica,56,6,9,15,"(-4.197703,-69.941278)"
2017,Abril,República Dominicana,214,25,23,48,"(3.541112,-76.384584)"
2017,Mayo,Noruega,578,0,1,1,"(4.815061,-75.736532)"
2014,Agosto,Sudáfrica,710,0,1,1,"(3.541112,-76.384584)"
2013,Octubre,República de Belarús,112,1,0,1,"(3.541112,-76.384584)"
2013,Diciembre,India,356,0,2,2,"(0.814836,-77.662532)"
2015,Marzo,Argentina,32,1,6,7,"(7.927209,-72.507910)"
2023,Mayo,Italia,380,5,3,8,"(7.088729,-70.740253)"
2020,Diciembre,Australia,36,3,1,4,"(3.541112,-76.384584)"
2016,Marzo,Costa Rica,188,1,0,1,"(7.128456,-73.183637)"
2016,Noviembre,Azerbaiyán,31,0,1,1,"(0.814836,-77.662532)"
2017,Diciembre,Malasia,458,2,1,3,"(6.171601,-75.427454)"
2012,Junio,Ecuador,218,2,2,4,"(7.927209,-72.507910)"
2022,Febrero,Austria,40,1,1,2,"(-4.197703,-69.941278)"
2022,Agosto,Costa de Marfil,384,1,2,3,"(4.697144,-74.140516)"
2013,Mayo,Suiza,756,15,32,47,"(6.171601,-75.427454)"
2013,Octubre,Honduras,340,1,1,2,"(7.818934,-72.453226)"
2017,Enero,Hungría,348,1,1,2,"(10.886611,-74.776708)"
2018,Junio,Jordania,400,1,5,6,"(4.697144,-74.140516)"
2018,Junio,Croacia,191,1,3,4,"(10.445761,-75.516429)"
2020,Febrero,Eslovenia,705,1,0,1,"(8.635765,-77.346578)"
2013,Septiembre,Ecuador,218,0,1,1,"(4.452882,-75.766298)"
2023,Marzo,Letonia,428,0,1,1,"(3.893038,-77.067921)"
2021,Octubre,Venezuela,862,4559,4203,8762,"(7.818934,-72.453226)"
2017,Febrero,Filipinas,608,0,12,12,"(10.886611,-74.776708)"
2023,Febrero,Zambia,894,1,0,1,"(4.697144,-74.140516)"
2022,Septiembre,Kuwait,414,1,0,1,"(10.445761,-75.516429)"
2019,Agosto,España,724,2,1,3,"(4.452882,-75.766298)"
2017,Septiembre,Islandia,352,0,3,3,"(6.171601,-75.427454)"
2014,Agosto,Francia,250,6,20,26,"(7.818934,-72.453226)"
2013,Octubre,El Salvador,222,3,4,7,"(10.886611,-74.776708)"
2017,Marzo,Palestina,99999,3,2,5,"(4.697144,-74.140516)"
2022,Octubre,Sudáfrica,710,45,70,115,"(4.697144,-74.140516)"
2022,Abril,Egipto,818,4,17,21,"(4.697144,-74.140516)"
2016,Mayo,Eslovenia,705,1,0,1,"(10.408582,-75.538003)"
2018,Febrero,Bulgaria,100,6,4,10,"(10.445761,-75.516429)"
2016,Abril,Cuba,192,0,1,1,"(7.927209,-72.507910)"
2015,Agosto,México,484,776,1586,2362,"(6.171601,-75.427454)"
2015,Mayo,Bélgica,56,4,21,25,"(3.541112,-76.384584)"
2018,Mayo,Filipinas,608,2,0,2,"(0.814836,-77.662532)"
2019,Abril,Malawi,454,0,1,1,"(4.697144,-74.140516)"
2017,Diciembre,Nueva Zelanda,554,5,9,14,"(10.408582,-75.538003)"
2023,Marzo,Suiza,756,13,8,21,"(0.814836,-77.662532)"
2012,Julio,India,356,0,3,3,"(10.445761,-75.516429)"
2022,Noviembre,Rumania,642,110,116,226,"(4.697144,-74.140516)"
2022,Diciembre,Países Bajos,528,0,1,1,"(12.586067,-81.702563)"
2023,Febrero,Uganda,800,0,1,1,"(0.814836,-77.662532)"
2017,Marzo,República de Irlanda,372,4,3,7,"(10.408582,-75.538003)"
2019,Julio,Austria,40,1,0,1,"(12.586067,-81.702563)"
2021,Diciembre,Costa Rica,188,9,14,23,"(7.128456,-73.183637)"
2023,Marzo,Panamá,591,1,1,2,"(11.360009,-72.129330)"
2013,Diciembre,Ucrania,804,1,4,5,"(10.408582,-75.538003)"
2015,Mayo,Honduras,340,10,27,37,"(10.445761,-75.516429)"
2022,Mayo,Benín,204,0,1,1,"(4.697144,-74.140516)"
2013,Agosto,India,356,8,34,42,"(6.171601,-75.427454)"
2015,Marzo,Francia,250,57,134,191,"(6.171601,-75.427454)"
2016,Enero,Jordania,400,0,2,2,"(7.128456,-73.183637)"
2019,Octubre,Estados Unidos de América,840,13,48,61,"(0.814836,-77.662532)"
2015,Julio,Austria,40,224,273,497,"(4.697144,-74.140516)"
2012,Noviembre,Ghana,288,0,1,1,"(11.247723,-74.213989)"
2021,Junio,España,724,1,1,2,"(4.452882,-75.766298)"
2019,Enero,Chile,152,8,19,27,"(10.886611,-74.776708)"
2012,Abril,Japón,392,4,15,19,"(3.541112,-76.384584)"
2023,Enero,Grecia,300,0,1,1,"(7.818934,-72.453226)"
2017,Marzo,México,484,0,2,2,"(12.5744111,-81.703935)"
2018,Junio,Bermudas/Territorio Británico de Ultramar,60,0,1,1,"(4.697144,-74.140516)"
2017,Noviembre,Chile,152,44,57,101,"(0.814836,-77.662532)"
2013,Junio,Bolivia,68,1,1,2,"(-4.197703,-69.941278)"
2022,Abril,Rumania,642,60,89,149,"(4.697144,-74.140516)"
2013,Enero,Austria,40,2,1,3,"(8.635765,-77.346578)"
2022,Abril,Estados Unidos de América,840,5,17,22,"(-4.197703,-69.941278)"
2017,Noviembre,Vietnam,704,0,1,1,"(10.445761,-75.516429)"
2015,Marzo,Grecia,300,1,0,1,"(0.25129,-76.875963)"
2019,Julio,República Checa,203,0,1,1,"(0.25129,-76.875963)"
2013,Febrero,Países Bajos,528,3,1,4,"(10.886611,-74.776708)"
2018,Mayo,Polonia,616,1,1,2,"(0.25129,-76.875963)"
2018,Diciembre,Reino Unido de Gran Bretaña e Irlanda del Norte,826,4,6,10,"(-4.223468,-69.945098)"
2013,Marzo,Dinamarca,208,1,0,1,"(10.408582,-75.538003)"
2020,Octubre,Guatemala,320,11,18,29,"(6.171601,-75.427454)"
2018,Marzo,Mauritania,478,0,1,1,"(4.697144,-74.140516)"
2014,Septiembre,República de Irlanda,372,1,2,3,"(-4.197703,-69.941278)"
2013,Mayo,Brasil,76,10,21,31,"(0.814836,-77.662532)"
2019,Junio,Albania,8,0,1,1,"(1.813928,-78.763924)"
2014,Mayo,Francia,250,4,7,11,"(8.635765,-77.346578)"
2015,Junio,Filipinas,608,5,11,16,"(6.171601,-75.427454)"
2021,Octubre,Nicaragua,558,14,32,46,"(6.171601,-75.427454)"
2013,Diciembre,Jamaica,388,0,3,3,"(6.171601,-75.427454)"
2022,Abril,España,724,5,3,8,"(12.586067,-81.702563)"
2013,Diciembre,Arabia Saudita,682,1,20,21,"(4.697144,-74.140516)"
2020,Octubre,Bahamas,44,0,1,1,"(6.171601,-75.427454)"
2013,Junio,India,356,5,23,28,"(6.171601,-75.427454)"
2017,Mayo,Tailandia,764,1,0,1,"(0.814836,-77.662532)"
2013,Octubre,Malasia,458,1,5,6,"(10.445761,-75.516429)"
2020,Enero,San  Vicente y las Granadinas,670,0,1,1,"(10.445761,-75.516429)"
2013,Julio,Mongolia,496,1,14,15,"(3.541112,-76.384584)"
2016,Enero,Indonesia,360,7,10,17,"(4.697144,-74.140516)"
2015,Julio,Portugal,620,3,14,17,"(10.445761,-75.516429)"
2014,Febrero,Pakistán,586,1,0,1,"(10.445761,-75.516429)"
2021,Septiembre,Dinamarca,208,19,69,88,"(4.697144,-74.140516)"
2021,Agosto,Estados Unidos de América,840,5879,10817,16698,"(4.697144,-74.140516)"
2016,Septiembre,El Salvador,222,93,116,209,"(3.541112,-76.384584)"
2019,Noviembre,Eslovaquia,703,5,7,12,"(6.171601,-75.427454)"
2012,Octubre,Países Bajos,528,6,4,10,"(10.445761,-75.516429)"
2022,Diciembre,República de Armenia,51,1,0,1,"(6.171601,-75.427454)"
2012,Septiembre,El Salvador,222,0,1,1,"(8.635765,-77.346578)"
2015,Noviembre,Eritrea,232,0,1,1,"(4.697144,-74.140516)"
2019,Septiembre,Canadá,124,3,20,23,"(4.815061,-75.736532)"
2019,Abril,Rumania,642,0,8,8,"(10.971302,-74.765397)"
2019,Junio,Nicaragua,558,94,103,197,"(4.697144,-74.140516)"
2016,Julio,España,724,9,16,25,"(7.818934,-72.453226)"
2016,Febrero,Cuba,192,0,2,2,"(10.408582,-75.538003)"
2017,Diciembre,Nicaragua,558,8,6,14,"(4.815061,-75.736532)"
2021,Marzo,Jamaica,388,5,4,9,"(10.445761,-75.516429)"
2013,Diciembre,Canadá,124,561,615,1176,"(10.445761,-75.516429)"
2022,Septiembre,China,156,4,1,5,"(7.818934,-72.453226)"
2018,Julio,Bermudas/Territorio Británico de Ultramar,60,5,8,13,"(10.886611,-74.776708)"
2013,Junio,República de Irlanda,372,4,4,8,"(10.408582,-75.538003)"
2016,Octubre,Eslovaquia,703,2,0,2,"(-4.197703,-69.941278)"
2019,Junio,Eslovaquia,703,5,5,10,"(10.445761,-75.516429)"
2017,Junio,Chile,152,3,8,11,"(-4.223468,-69.945098)"
2022,Agosto,Emiratos Árabes,784,2,7,9,"(4.697144,-74.140516)"
2013,Noviembre,Hong Kong,344,0,1,1,"(4.697144,-74.140516)"
2012,Enero,República Democrática de Timor Oriental,626,0,1,1,"(4.697144,-74.140516)"
2018,Enero,San  Vicente y las Granadinas,670,0,1,1,"(3.541112,-76.384584)"
2014,Febrero,Uruguay,858,2,4,6,"(7.818934,-72.453226)"
2021,Diciembre,Sri Lanka,144,0,2,2,"(10.886611,-74.776708)"
2012,Julio,Polonia,616,1,1,2,"(3.541112,-76.384584)"
2021,Mayo,Guatemala,320,8,13,21,"(3.541112,-76.384584)"
2013,Diciembre,Japón,392,0,1,1,"(4.815061,-75.736532)"
2014,Abril,Costa Rica,188,492,799,1291,"(4.697144,-74.140516)"
2012,Noviembre,Portugal,620,1,0,1,"(10.886611,-74.776708)"
2022,Diciembre,Eslovenia,705,36,39,75,"(4.697144,-74.140516)"
2014,Octubre,San  Vicente y las Granadinas,670,1,0,1,"(10.445761,-75.516429)"
2014,Julio,Indonesia,360,0,1,1,"(0.814836,-77.662532)"
2012,Marzo,Georgia,268,9,16,25,"(4.697144,-74.140516)"
2023,Marzo,Alemania,276,15,15,30,"(8.635765,-77.346578)"
2014,Noviembre,Taiwán,158,1,1,2,"(11.360009,-72.129330)"
2017,Octubre,República de Tayikistán,762,1,0,1,"(4.697144,-74.140516)"
2018,Marzo,Cuba,192,0,2,2,"(0.814836,-77.662532)"
2022,Julio,República Árabe Siria,760,0,2,2,"(4.697144,-74.140516)"
2018,Mayo,Ghana,288,2,1,3,"(4.697144,-74.140516)"
2015,Diciembre,Estados Unidos de América,840,54,91,145,"(10.408582,-75.538003)"
2014,Octubre,Portugal,620,0,1,1,"(7.128456,-73.183637)"
2018,Diciembre,Italia,380,0,1,1,"(7.128456,-73.183637)"
2014,Septiembre,Costa Rica,188,89,204,293,"(6.171601,-75.427454)"
2020,Diciembre,China,156,43,123,166,"(4.697144,-74.140516)"
2019,Abril,Países Bajos,528,2,2,4,"(12.5744111,-81.703935)"
2012,Noviembre,Nicaragua,558,3,3,6,"(12.586067,-81.702563)"
2022,Junio,Italia,380,0,1,1,"(11.247723,-74.213989)"
2015,Mayo,República de Corea,410,0,1,1,"(8.635765,-77.346578)"
2023,Abril,República de Irlanda,372,0,1,1,"(-4.197703,-69.941278)"
2019,Octubre,Ecuador,218,3,4,7,"(4.815061,-75.736532)"
2016,Marzo,Bélgica,56,1,4,5,"(-4.197703,-69.941278)"
2016,Octubre,Argentina,32,3,4,7,"(4.815061,-75.736532)"
2013,Julio,Bolivia,68,0,1,1,"(12.586067,-81.702563)"
2016,Febrero,Costa de Marfil,384,0,1,1,"(10.408582,-75.538003)"
2018,Diciembre,España,724,9,10,19,"(12.586067,-81.702563)"
2017,Junio,Federación de Rusia,643,2,1,3,"(7.818934,-72.453226)"
2017,Mayo,México,484,4,12,16,"(7.128456,-73.183637)"
2016,Julio,Uruguay,858,2,0,2,"(-4.197703,-69.941278)"
2012,Enero,México,484,9,11,20,"(10.408582,-75.538003)"
2021,Septiembre,Estados Unidos de América,840,5,18,23,"(10.408582,-75.538003)"
2018,Septiembre,Honduras,340,66,95,161,"(6.171601,-75.427454)"
2013,Diciembre,Federación de Rusia,643,0,1,1,"(8.635765,-77.346578)"
2023,Enero,Palestina,0,0,1,1,"(3.541112,-76.384584)"
2014,Agosto,República Checa,203,0,1,1,"(8.635765,-77.346578)"
2013,Noviembre,Costa Rica,188,531,906,1437,"(4.697144,-74.140516)"
2016,Diciembre,Eslovaquia,703,1,0,1,"(10.886611,-74.776708)"
2016,Septiembre,San Cristóbal y Nevis,659,3,3,6,"(4.697144,-74.140516)"
2021,Octubre,Chile,152,40,100,140,"(6.171601,-75.427454)"
2023,Marzo,Cuba,192,0,1,1,"(0.814836,-77.662532)"
2015,Diciembre,Hungría,348,0,1,1,"(-4.197703,-69.941278)"
2016,Diciembre,Egipto,818,2,2,4,"(6.171601,-75.427454)"
2022,Julio,Países Bajos,528,38,26,64,"(10.408582,-75.538003)"
2018,Marzo,Croacia,191,1,2,3,"(6.171601,-75.427454)"
2022,Marzo,Haití,332,0,10,10,"(6.171601,-75.427454)"
2015,Marzo,Perú,604,0,4,4,"(4.815061,-75.736532)"
2018,Enero,Finlandia,246,9,3,12,"(3.541112,-76.384584)"
2021,Junio,Brunei Darussalam,96,1,0,1,"(4.697144,-74.140516)"
2012,Mayo,Portugal,620,1,0,1,"(12.586067,-81.702563)"
2013,Octubre,Haití,332,0,2,2,"(10.408582,-75.538003)"
2017,Marzo,Perú,604,0,1,1,"(4.452882,-75.766298)"
2021,Septiembre,Italia,380,0,4,4,"(0.814836,-77.662532)"
2012,Abril,Estados Unidos de América,840,20,21,41,"(12.586067,-81.702563)"
2018,Octubre,Nicaragua,558,0,1,1,"(10.408582,-75.538003)"
2019,Marzo,Albania,8,2,1,3,"(6.171601,-75.427454)"
2021,Noviembre,Singapur,702,1,1,2,"(10.445761,-75.516429)"
2018,Mayo,Madagascar,450,1,0,1,"(10.445761,-75.516429)"
2016,Junio,Paraguay,600,162,174,336,"(4.697144,-74.140516)"
2022,Abril,Anguila/Territorio Británico de Ultramar,660,0,1,1,"(3.541112,-76.384584)"
2023,Febrero,Argentina,32,2,7,9,"(10.408582,-75.538003)"
2015,Septiembre,Finlandia,246,23,62,85,"(4.697144,-74.140516)"
2019,Marzo,Nicaragua,558,51,33,84,"(10.445761,-75.516429)"
2012,Mayo,Uganda,800,3,1,4,"(4.697144,-74.140516)"
2014,Julio,Granada,308,0,1,1,"(3.541112,-76.384584)"
2018,Marzo,Francia,250,1,1,2,"(8.36068,-72.409396)"
2023,Febrero,Chile,152,0,1,1,"(7.088729,-70.740253)"
2022,Mayo,Polonia,616,1,0,1,"(-4.197703,-69.941278)"
2021,Diciembre,Líbano,422,2,0,2,"(10.445761,-75.516429)"
2013,Abril,Palau,585,0,1,1,"(4.697144,-74.140516)"
2022,Junio,Serbia,688,13,23,36,"(4.697144,-74.140516)"
2017,Enero,España,724,19,38,57,"(7.818934,-72.453226)"
2017,Diciembre,México,484,6,14,20,"(7.128456,-73.183637)"
2015,Enero,San  Vicente y las Granadinas,670,1,1,2,"(0.814836,-77.662532)"
2014,Septiembre,Nueva Zelanda,554,9,18,27,"(0.814836,-77.662532)"
2017,Agosto,Francia,250,1,1,2,"(11.360009,-72.129330)"
2020,Diciembre,Liberia,430,1,0,1,"(3.541112,-76.384584)"
2022,Octubre,República Dominicana,214,310,367,677,"(10.445761,-75.516429)"
2014,Marzo,Brasil,76,7,19,26,"(7.818934,-72.453226)"
2019,Enero,Bolivia,68,2,3,5,"(10.886611,-74.776708)"
2015,Mayo,Alemania,276,1,1,2,"(6.228046,-77.404104)"
2020,Diciembre,Federación de Rusia,643,0,2,2,"(10.886611,-74.776708)"
2022,Abril,Panamá,591,1,1,2,"(0.814836,-77.662532)"
2013,Febrero,España,724,12,44,56,"(7.818934,-72.453226)"
2018,Octubre,Portugal,620,22,42,64,"(6.171601,-75.427454)"
2017,Julio,Austria,40,5,6,11,"(10.886611,-74.776708)"
2016,Noviembre,Austria,40,4,4,8,"(-4.197703,-69.941278)"
2019,Julio,India,356,0,5,5,"(3.893038,-77.067921)"
2023,Enero,España,724,4,3,7,"(-4.223468,-69.945098)"
2018,Enero,Francia,250,1,1,2,"(3.866713,-67.927521)"
2022,Febrero,España,724,32,57,89,"(7.818934,-72.453226)"
2016,Julio,México,484,0,1,1,"(6.185799,-67.483929)"
2014,Agosto,Venezuela,862,6942,7074,14016,"(4.697144,-74.140516)"
2019,Noviembre,Cuba,192,0,1,1,"(10.971302,-74.765397)"
2023,Enero,Suecia,752,0,1,1,"(7.916725,-72.462544)"
2023,Marzo,Suecia,752,0,1,1,"(13.3387613,-81.372937)"
2017,Febrero,Argentina,32,1,1,2,"(4.452882,-75.766298)"
2014,Marzo,Perú,604,265,177,442,"(12.586067,-81.702563)"
2018,Julio,Myanmar,104,7,10,17,"(4.697144,-74.140516)"
2020,Marzo,Israel,376,6,29,35,"(10.445761,-75.516429)"
2019,Julio,Uruguay,858,1,0,1,"(8.36068,-72.409396)"
2016,Febrero,Cuba,192,10,12,22,"(10.445761,-75.516429)"
2017,Marzo,Ecuador,218,38,49,87,"(1.813928,-78.763924)"
2018,Enero,República Dominicana,214,105,111,216,"(10.445761,-75.516429)"
2016,Febrero,Brasil,76,544,443,987,"(12.586067,-81.702563)"
2013,Julio,Países Bajos,528,12,33,45,"(10.886611,-74.776708)"
2016,Junio,República Checa,203,1,0,1,"(7.128456,-73.183637)"
2018,Agosto,Singapur,702,0,1,1,"(3.541112,-76.384584)"
2018,Noviembre,Haití,332,1,0,1,"(0.814836,-77.662532)"
2023,Enero,Uruguay,858,3,8,11,"(10.886611,-74.776708)"
2016,Diciembre,Kuwait,414,3,2,5,"(4.697144,-74.140516)"
2016,Mayo,Japón,392,1,2,3,"(-4.197703,-69.941278)"
2013,Junio,Turquía,792,0,2,2,"(10.886611,-74.776708)"
2017,Septiembre,República de Corea,410,1,0,1,"(10.408582,-75.538003)"
2012,Noviembre,Estados Unidos de América,840,923,2378,3301,"(6.171601,-75.427454)"
2022,Junio,Bélgica,56,1,0,1,"(11.360009,-72.129330)"
2017,Octubre,Alemania,276,2,1,3,"(12.586067,-81.702563)"
2020,Noviembre,Uruguay,858,2,4,6,"(10.445761,-75.516429)"
2017,Octubre,Filipinas,608,8,8,16,"(6.171601,-75.427454)"
2020,Enero,Letonia,428,17,18,35,"(4.697144,-74.140516)"
2017,Enero,Perú,604,0,2,2,"(7.088729,-70.740253)"
2015,Marzo,India,356,0,13,13,"(10.886611,-74.776708)"
2017,Noviembre,Chile,152,20,35,55,"(7.818934,-72.453226)"
2016,Julio,Nueva Zelanda,554,1,12,13,"(8.635765,-77.346578)"
2019,Diciembre,Granada,308,1,2,3,"(4.697144,-74.140516)"
2017,Agosto,Chile,152,0,1,1,"(1.813928,-78.763924)"
2022,Diciembre,Canadá,124,7,15,22,"(7.128456,-73.183637)"
2018,Diciembre,Austria,40,21,26,47,"(10.445761,-75.516429)"
2019,Febrero,Perú,604,4,7,11,"(11.360009,-72.129330)"
2022,Octubre,Italia,380,1,1,2,"(4.452882,-75.766298)"
2017,Noviembre,Vietnam,704,1,0,1,"(6.171601,-75.427454)"
2021,Mayo,Países Bajos,528,6,15,21,"(10.886611,-74.776708)"
2022,Octubre,Andorra,20,2,5,7,"(4.697144,-74.140516)"
2016,Septiembre,Perú,604,0,1,1,"(-0.193180,-74.784874)"
2022,Mayo,Ecuador,218,16,24,40,"(1.813928,-78.763924)"
2022,Abril,Costa Rica,188,932,882,1814,"(6.171601,-75.427454)"
2013,Julio,Indonesia,360,0,3,3,"(0.814836,-77.662532)"
2013,Enero,Marruecos,504,0,1,1,"(3.541112,-76.384584)"
2017,Octubre,Hungría,348,1,0,1,"(12.586067,-81.702563)"
2019,Julio,Ecuador,218,3,4,7,"(11.360009,-72.129330)"
2015,Febrero,Alemania,276,0,6,6,"(4.815061,-75.736532)"
2018,Septiembre,Malasia,458,0,1,1,"(10.408582,-75.538003)"
2023,Abril,Venezuela,862,1,7,8,"(10.433609,-73.247863)"
2022,Agosto,Belice,84,4,8,12,"(6.171601,-75.427454)"
2012,Febrero,México,484,0,1,1,"(-4.197703,-69.941278)"
2014,Octubre,Cuba,192,1,2,3,"(4.815061,-75.736532)"
2017,Abril,Turquía,792,127,241,368,"(4.697144,-74.140516)"
2015,Junio,Argentina,32,2,3,5,"(4.815061,-75.736532)"
2018,Agosto,Alemania,276,6,1,7,"(4.815061,-75.736532)"
2014,Noviembre,Austria,40,159,316,475,"(4.697144,-74.140516)"
2012,Abril,Chile,152,38,89,127,"(6.171601,-75.427454)"
2013,Mayo,Perú,604,3144,3696,6840,"(4.697144,-74.140516)"
2022,Marzo,Ecuador,218,68,128,196,"(0.25129,-76.875963)"
2021,Mayo,Uruguay,858,1,12,13,"(3.541112,-76.384584)"
2019,Septiembre,México,484,0,7,7,"(8.36068,-72.409396)"
2014,Octubre,China,156,4,9,13,"(7.818934,-72.453226)"
2015,Diciembre,Trinidad y Tobago,780,2,2,4,"(7.927209,-72.507910)"
2014,Noviembre,Estados Unidos de América,840,5,1,6,"(-4.223468,-69.945098)"
2012,Abril,Letonia,428,1,0,1,"(0.814836,-77.662532)"
2014,Diciembre,Costa Rica,188,762,894,1656,"(4.697144,-74.140516)"
2017,Noviembre,Brasil,76,2,10,12,"(4.815061,-75.736532)"
2020,Enero,Nicaragua,558,0,1,1,"(4.452882,-75.766298)"
2012,Noviembre,República Dominicana,214,0,2,2,"(11.360009,-72.129330)"
2014,Enero,Nueva Zelanda,554,1,5,6,"(-4.197703,-69.941278)"
2018,Agosto,Ecuador,218,46,97,143,"(10.408582,-75.538003)"
2015,Septiembre,Brasil,76,179,114,293,"(12.586067,-81.702563)"
2019,Septiembre,Guatemala,320,0,1,1,"(4.452882,-75.766298)"
2020,Febrero,República de Moldavia,498,0,1,1,"(0.814836,-77.662532)"
2012,Septiembre,Croacia,191,0,1,1,"(6.171601,-75.427454)"
2015,Noviembre,Italia,380,2,8,10,"(10.408582,-75.538003)"
2012,Noviembre,Chipre,196,0,1,1,"(6.171601,-75.427454)"
2022,Enero,Trinidad y Tobago,780,9,11,20,"(6.171601,-75.427454)"
2023,Mayo,Venezuela,862,674,762,1436,"(6.171601,-75.427454)"
2022,Noviembre,Estonia,233,2,0,2,"(10.886611,-74.776708)"
2016,Junio,Filipinas,608,0,4,4,"(3.541112,-76.384584)"
2014,Octubre,Panamá,591,118,201,319,"(10.445761,-75.516429)"
2019,Julio,México,484,28,37,65,"(0.814836,-77.662532)"
2015,Diciembre,Portugal,620,0,2,2,"(4.815061,-75.736532)"
2012,Enero,Costa Rica,188,432,342,774,"(12.586067,-81.702563)"
2013,Septiembre,Arabia Saudita,682,0,9,9,"(4.697144,-74.140516)"
2017,Septiembre,Nigeria,566,0,1,1,"(11.360009,-72.129330)"
2015,Junio,Argentina,32,0,4,4,"(0.25129,-76.875963)"
2015,Febrero,México,484,2648,5443,8091,"(4.697144,-74.140516)"
2016,Julio,Lituania,440,0,3,3,"(10.445761,-75.516429)"
2013,Junio,Panamá,591,0,2,2,"(7.818934,-72.453226)"
2022,Diciembre,Mauricio,480,1,1,2,"(4.697144,-74.140516)"
2020,Enero,Desconocido,99999,89,145,234,"(4.697144,-74.140516)"
2022,Noviembre,Panamá,591,861,733,1594,"(10.445761,-75.516429)"
2017,Mayo,Venezuela,862,63,83,146,"(3.541112,-76.384584)"
2012,Diciembre,Suiza,756,0,1,1,"(4.815061,-75.736532)"
2016,Enero,Panamá,591,166,218,384,"(10.445761,-75.516429)"
2013,Febrero,Líbano,422,1,0,1,"(6.171601,-75.427454)"
2013,Enero,Francia,250,1,2,3,"(12.586067,-81.702563)"
2019,Septiembre,República Checa,203,1,2,3,"(10.445761,-75.516429)"
2022,Septiembre,Portugal,620,1,1,2,"(-4.197703,-69.941278)"
2014,Diciembre,Alemania,276,10,18,28,"(10.886611,-74.776708)"
2016,Febrero,Italia,380,153,150,303,"(12.586067,-81.702563)"
2013,Marzo,Grecia,300,0,1,1,"(11.247723,-74.213989)"
2017,Agosto,Marruecos,504,0,1,1,"(10.886611,-74.776708)"
2017,Noviembre,México,484,2,8,10,"(11.360009,-72.129330)"
2014,Agosto,Noruega,578,0,2,2,"(0.814836,-77.662532)"
2018,Diciembre,Myanmar,104,0,1,1,"(10.445761,-75.516429)"
2018,Junio,Mauritania,478,0,1,1,"(4.697144,-74.140516)"
2022,Septiembre,Costa Rica,188,5,19,24,"(10.886611,-74.776708)"
2017,Julio,Noruega,578,6,9,15,"(10.886611,-74.776708)"
2023,Mayo,Italia,380,1,0,1,"(11.247723,-74.213989)"
2021,Diciembre,Portugal,620,0,1,1,"(6.185799,-67.483929)"
2022,Octubre,México,484,4,1,5,"(-4.197703,-69.941278)"
2019,Marzo,Nicaragua,558,91,121,212,"(4.697144,-74.140516)"
2019,Enero,Países Bajos,528,0,1,1,"(8.36068,-72.409396)"
2015,Enero,República Checa,203,1,2,3,"(0.814836,-77.662532)"
2015,Agosto,Dominica,212,0,5,5,"(4.697144,-74.140516)"
2014,Febrero,Italia,380,0,1,1,"(7.927209,-72.507910)"
2015,Noviembre,Argentina,32,2,5,7,"(4.815061,-75.736532)"
2019,Diciembre,Rumania,642,1,8,9,"(10.408582,-75.538003)"
2012,Noviembre,Francia,250,18,26,44,"(10.408582,-75.538003)"
2017,Noviembre,Noruega,578,1,0,1,"(7.128456,-73.183637)"
2013,Abril,Japón,392,1,0,1,"(12.586067,-81.702563)"
2012,Mayo,Federación de Rusia,643,2,5,7,"(11.360009,-72.129330)"
2021,Julio,Dinamarca,208,0,1,1,"(10.886611,-74.776708)"
2019,Agosto,Paraguay,600,235,167,402,"(4.697144,-74.140516)"
2013,Febrero,Ecuador,218,2,7,9,"(11.360009,-72.129330)"
2012,Agosto,Turquía,792,1,6,7,"(6.171601,-75.427454)"
2016,Marzo,Granada,308,1,0,1,"(6.171601,-75.427454)"
2013,Agosto,Perú,604,311,684,995,"(6.171601,-75.427454)"
2013,Enero,República Checa,203,2,6,8,"(0.814836,-77.662532)"
2015,Mayo,Ecuador,218,4,2,6,"(4.815061,-75.736532)"
2022,Abril,México,484,1,0,1,"(0.25129,-76.875963)"
2017,Diciembre,Japón,392,21,23,44,"(10.445761,-75.516429)"
2022,Junio,Guyana,328,1,1,2,"(10.886611,-74.776708)"
2017,Septiembre,Grecia,300,3,2,5,"(6.171601,-75.427454)"
2015,Septiembre,Nueva Zelanda,554,46,66,112,"(4.697144,-74.140516)"
2018,Octubre,Costa Rica,188,0,1,1,"(8.635765,-77.346578)"
2016,Diciembre,Irán,364,0,1,1,"(0.814836,-77.662532)"
2019,Enero,Brasil,76,13,4,17,"(4.815061,-75.736532)"
2012,Junio,Países Bajos,528,1,0,1,"(8.635765,-77.346578)"
2013,Marzo,Cuba,192,0,2,2,"(7.927209,-72.507910)"
2018,Septiembre,Indonesia,360,9,18,27,"(4.697144,-74.140516)"
2023,Mayo,Cuba,192,23,54,77,"(6.171601,-75.427454)"
2019,Junio,Eslovenia,705,4,6,10,"(6.171601,-75.427454)"
2016,Diciembre,Sudáfrica,710,5,6,11,"(3.541112,-76.384584)"
2014,Febrero,México,484,0,1,1,"(4.452882,-75.766298)"
2017,Febrero,Reino Unido de Gran Bretaña e Irlanda del Norte,826,1170,2056,3226,"(4.697144,-74.140516)"
2013,Abril,Bahamas,44,0,2,2,"(10.445761,-75.516429)"
2023,Abril,Arabia Saudita,682,4,41,45,"(4.697144,-74.140516)"
2023,Febrero,Togo,768,0,1,1,"(6.171601,-75.427454)"
2015,Octubre,Uruguay,858,3,1,4,"(10.408582,-75.538003)"
2016,Noviembre,Eslovenia,705,0,1,1,"(0.814836,-77.662532)"
2012,Junio,República de Irlanda,372,2,0,2,"(0.25129,-76.875963)"
2018,Noviembre,Ecuador,218,4,3,7,"(4.815061,-75.736532)"
2021,Abril,Barbados,52,0,1,1,"(4.697144,-74.140516)"
2020,Enero,Francia,250,5,7,12,"(11.360009,-72.129330)"
2012,Enero,Austria,40,4,6,10,"(-4.197703,-69.941278)"
2013,Mayo,Rumania,642,0,1,1,"(11.360009,-72.129330)"
2015,Septiembre,Samoa Occidental,882,1,0,1,"(6.171601,-75.427454)"
2018,Diciembre,China,156,2,7,9,"(10.886611,-74.776708)"
2021,Agosto,México,484,0,2,2,"(4.452882,-75.766298)"
2013,Abril,Surinam,740,8,17,25,"(6.171601,-75.427454)"
2022,Octubre,Argentina,32,2,4,6,"(10.408582,-75.538003)"
2023,Febrero,Argelia,12,0,1,1,"(10.408582,-75.538003)"
2015,Septiembre,Chile,152,90,50,140,"(10.408582,-75.538003)"
2019,Diciembre,Pakistán,586,2,15,17,"(4.697144,-74.140516)"
2018,Marzo,Costa Rica,188,0,1,1,"(-4.197703,-69.941278)"
2016,Marzo,Perú,604,2,9,11,"(0.25129,-76.875963)"
2018,Marzo,Liberia,430,1,0,1,"(3.541112,-76.384584)"
2016,Marzo,Uruguay,858,0,1,1,"(4.452882,-75.766298)"
2017,Marzo,Estados Unidos de América,840,2,2,4,"(9.402978,-75.681599)"
2014,Febrero,Eslovenia,705,1,2,3,"(10.445761,-75.516429)"
2021,Octubre,Filipinas,608,33,39,72,"(4.697144,-74.140516)"
2016,Enero,Australia,36,34,41,75,"(10.408582,-75.538003)"
2023,Marzo,República Dominicana,214,1,2,3,"(0.25129,-76.875963)"
2022,Diciembre,Ecuador,218,0,5,5,"(3.893038,-77.067921)"
2021,Mayo,Cuba,192,0,4,4,"(10.886611,-74.776708)"
2019,Marzo,Francia,250,49,50,99,"(10.886611,-74.776708)"
2016,Marzo,Canadá,124,0,3,3,"(13.3387613,-81.372937)"
2022,Abril,Serbia,688,0,1,1,"(10.886611,-74.776708)"
2019,Agosto,Perú,604,980,1336,2316,"(6.171601,-75.427454)"
2022,Abril,Israel,376,1,1,2,"(7.927209,-72.507910)"
2014,Enero,República Dominicana,214,0,4,4,"(12.586067,-81.702563)"
2019,Diciembre,Francia,250,222,318,541,"(10.445761,-75.516429)"
2023,Abril,Etiopia,231,1,30,31,"(4.697144,-74.140516)"
2015,Diciembre,Nigeria,566,0,1,1,"(6.171601,-75.427454)"
2015,Agosto,India,356,7,22,29,"(10.445761,-75.516429)"
2014,Noviembre,Venezuela,862,1,1,2,"(4.452882,-75.766298)"
2023,Enero,Surinam,740,3,2,5,"(10.445761,-75.516429)"
2021,Septiembre,China,156,64,203,267,"(4.697144,-74.140516)"
2016,Agosto,Emiratos Árabes,784,1,2,3,"(10.445761,-75.516429)"
2017,Octubre,República Del Congo,178,0,1,1,"(4.697144,-74.140516)"
2019,Febrero,Lituania,440,5,9,14,"(10.445761,-75.516429)"
2016,Diciembre,El Salvador,222,628,711,1339,"(4.697144,-74.140516)"
2017,Enero,Namibia,516,0,2,2,"(3.541112,-76.384584)"
2019,Julio,República de Corea,410,0,1,1,"(-4.197703,-69.941278)"
2014,Mayo,Túnez,788,3,1,4,"(4.697144,-74.140516)"
2019,Diciembre,República Checa,203,1,2,3,"(10.886611,-74.776708)"
2021,Agosto,República de Belarús,112,0,1,1,"(10.408582,-75.538003)"
2015,Enero,Hungría,348,0,2,2,"(0.814836,-77.662532)"
2016,Febrero,Alemania,276,15,33,48,"(10.886611,-74.776708)"
2019,Junio,Bolivia,68,11,10,21,"(0.814836,-77.662532)"
2014,Septiembre,Países Bajos,528,0,1,1,"(12.165168,-71.983761)"
2017,Septiembre,República Dominicana,214,4,3,7,"(11.360009,-72.129330)"
2014,Febrero,Argentina,32,0,1,1,"(4.815061,-75.736532)"
2014,Mayo,República Dominicana,214,21,28,49,"(3.541112,-76.384584)"
2023,Marzo,Eslovaquia,703,1,1,2,"(10.886611,-74.776708)"
2022,Diciembre,Montenegro,499,1,1,2,"(10.445761,-75.516429)"
2016,Noviembre,Ecuador,218,2,7,9,"(11.360009,-72.129330)"
2020,Enero,Sri Lanka,144,2,1,3,"(4.697144,-74.140516)"
2021,Junio,Hong Kong,344,0,1,1,"(6.171601,-75.427454)"
2022,Marzo,Ghana,288,1,0,1,"(6.171601,-75.427454)"
2013,Agosto,Bélgica,56,0,1,1,"(7.818934,-72.453226)"
2023,Marzo,Canadá,124,3,2,5,"(11.360009,-72.129330)"
2014,Noviembre,Países Bajos,528,0,1,1,"(10.971302,-74.765397)"
2023,Junio,Canadá,124,43,60,103,"(10.886611,-74.776708)"
2019,Marzo,Panamá,591,2,1,3,"(11.360009,-72.129330)"
2022,Febrero,Desconocido,99999,0,1,1,"(7.818934,-72.453226)"
2020,Enero,Líbano,422,4,0,4,"(10.886611,-74.776708)"
2013,Julio,Panamá,591,0,1,1,"(4.452882,-75.766298)"
2016,Julio,Cuba,192,0,2,2,"(10.408582,-75.538003)"
2017,Agosto,Ucrania,804,0,3,3,"(10.886611,-74.776708)"
2015,Enero,México,484,3,0,3,"(0.25129,-76.875963)"
2014,Noviembre,Papúa Nueva Guinea,598,0,1,1,"(3.541112,-76.384584)"
2023,Enero,Panamá,591,84,58,142,"(11.117806,-74.232622)"
2021,Noviembre,Pakistán,586,0,2,2,"(6.171601,-75.427454)"
2012,Mayo,Nueva Zelanda,554,0,1,1,"(10.886611,-74.776708)"
2012,Mayo,México,484,12,35,47,"(7.818934,-72.453226)"
2012,Marzo,Bosnia y Herzegovina,70,0,2,2,"(4.697144,-74.140516)"
2015,Enero,Perú,604,15,15,30,"(10.408582,-75.538003)"
2018,Abril,Chile,152,17,30,47,"(7.818934,-72.453226)"
2015,Septiembre,Israel,376,4,17,21,"(3.541112,-76.384584)"
2014,Julio,Austria,40,4,7,11,"(10.408582,-75.538003)"
2019,Enero,Guatemala,320,1,1,2,"(12.586067,-81.702563)"
2016,Marzo,México,484,167,295,462,"(10.445761,-75.516429)"
2012,Mayo,Venezuela,862,3812,5305,9117,"(4.697144,-74.140516)"
2012,Noviembre,Surinam,740,21,18,39,"(6.171601,-75.427454)"
2014,Febrero,Argelia,12,0,1,1,"(0.814836,-77.662532)"
2013,Mayo,Austria,40,0,2,2,"(10.886611,-74.776708)"
2013,Junio,Irán,364,9,16,25,"(4.697144,-74.140516)"
2013,Abril,Canadá,124,17,22,39,"(0.814836,-77.662532)"
2018,Diciembre,Dinamarca,208,158,242,400,"(4.697144,-74.140516)"
2023,Marzo,China,156,3,0,3,"(4.452882,-75.766298)"
2016,Diciembre,Croacia,191,0,3,3,"(3.541112,-76.384584)"
2019,Enero,Bolivia,68,1146,1041,2192,"(4.697144,-74.140516)"
2019,Diciembre,República Democrática del Congo,180,0,1,1,"(6.171601,-75.427454)"
2016,Enero,Países Bajos,528,983,1551,2534,"(4.697144,-74.140516)"
2012,Mayo,Perú,604,0,3,3,"(11.360009,-72.129330)"
2019,Noviembre,República de Corea,410,2,2,4,"(7.818934,-72.453226)"
2018,Octubre,México,484,3,2,5,"(-4.197703,-69.941278)"
2022,Agosto,Ecuador,218,0,2,2,"(7.128456,-73.183637)"
2022,Julio,Argentina,32,3,2,5,"(7.927209,-72.507910)"
2014,Junio,Estados Unidos de América,840,265,310,575,"(4.815061,-75.736532)"
2015,Noviembre,Venezuela,862,185,206,391,"(7.927209,-72.507910)"
2017,Diciembre,Italia,380,1,2,3,"(7.128456,-73.183637)"
2014,Abril,Líbano,422,1,0,1,"(10.408582,-75.538003)"
2022,Octubre,Alemania,276,2,1,3,"(7.128456,-73.183637)"
2017,Julio,Polonia,616,13,13,26,"(0.814836,-77.662532)"
2012,Mayo,Nueva Zelanda,554,3,11,14,"(6.171601,-75.427454)"
2017,Junio,Francia,250,10,18,28,"(10.886611,-74.776708)"
2022,Octubre,Ucrania,804,0,1,1,"(4.452882,-75.766298)"
2012,Enero,Brasil,76,1,1,2,"(6.185799,-67.483929)"
2019,Abril,República Árabe de Yemen,887,0,1,1,"(4.697144,-74.140516)"
2022,Marzo,República de Irlanda,372,4,7,11,"(10.408582,-75.538003)"
2018,Julio,Serbia,688,12,19,31,"(4.697144,-74.140516)"
2012,Junio,Eslovenia,705,1,2,3,"(3.541112,-76.384584)"
2015,Marzo,Islas Caimán/Territorio Británico de Ultramar,136,2,0,2,"(10.886611,-74.776708)"
2018,Junio,Chile,152,0,2,2,"(4.452882,-75.766298)"
2017,Junio,Costa Rica,188,43,41,84,"(12.586067,-81.702563)"
2013,Enero,España,724,0,1,1,"(6.185799,-67.483929)"
2021,Marzo,Zimbabue,716,2,2,4,"(4.697144,-74.140516)"
2017,Marzo,Canadá,124,5,11,16,"(12.5744111,-81.703935)"
2014,Marzo,Portugal,620,4,4,8,"(0.814836,-77.662532)"
2013,Julio,Filipinas,608,1,27,28,"(10.445761,-75.516429)"
2018,Junio,Italia,380,8,30,38,"(10.886611,-74.776708)"
2023,Febrero,Perú,604,40,24,64,"(11.117806,-74.232622)"
2019,Marzo,Serbia,688,23,39,62,"(4.697144,-74.140516)"
2015,Junio,Turquía,792,1,0,1,"(-4.197703,-69.941278)"
2013,Abril,Islas Caimán/Territorio Británico de Ultramar,136,1,0,1,"(4.697144,-74.140516)"
2012,Diciembre,Chile,152,31,32,63,"(12.586067,-81.702563)"
2012,Junio,México,484,2,8,10,"(7.927209,-72.507910)"
2014,Noviembre,Honduras,340,13,23,36,"(3.541112,-76.384584)"
2018,Febrero,Brasil,76,1059,780,1839,"(10.445761,-75.516429)"
2015,Agosto,Canadá,124,3,6,9,"(-4.197703,-69.941278)"
2019,Noviembre,Trinidad y Tobago,780,4,3,7,"(10.886611,-74.776708)"
2013,Mayo,Canadá,124,0,3,3,"(8.635765,-77.346578)"
2017,Junio,Costa Rica,188,1200,1370,2570,"(4.697144,-74.140516)"
2022,Marzo,Lituania,440,0,2,2,"(3.893038,-77.067921)"
2012,Junio,República de Corea,410,169,698,867,"(4.697144,-74.140516)"
2012,Junio,Federación de Rusia,643,0,1,1,"(-4.197703,-69.941278)"
2016,Marzo,Dominica,212,1,1,2,"(10.445761,-75.516429)"
2023,Marzo,México,484,614,664,1278,"(10.445761,-75.516429)"
2015,Agosto,Venezuela,862,496,436,932,"(7.927209,-72.507910)"
2014,Junio,Jamaica,388,2,20,22,"(12.586067,-81.702563)"
2022,Diciembre,Reino Unido de Gran Bretaña e Irlanda del Norte,826,9,23,32,"(10.886611,-74.776708)"
2017,Enero,Noruega,578,0,4,4,"(-4.197703,-69.941278)"
2015,Diciembre,Turquía,792,0,1,1,"(7.128456,-73.183637)"
2016,Diciembre,España,724,0,1,1,"(7.088729,-70.740253)"
2023,Mayo,Bermudas/Territorio Británico de Ultramar,60,1,2,3,"(4.697144,-74.140516)"
2014,Octubre,Israel,376,1,1,2,"(11.247723,-74.213989)"
2012,Agosto,Bélgica,56,2,3,5,"(11.360009,-72.129330)"
2012,Mayo,Brasil,76,1,1,2,"(6.185799,-67.483929)"
2017,Agosto,Chile,152,36,102,138,"(6.171601,-75.427454)"
2019,Octubre,República de Corea,410,6,6,12,"(0.814836,-77.662532)"
2022,Enero,Francia,250,6,6,12,"(10.408582,-75.538003)"
2019,Septiembre,Australia,36,11,21,32,"(10.408582,-75.538003)"
2017,Diciembre,Reino Unido de Gran Bretaña e Irlanda del Norte,826,1366,2617,3983,"(4.697144,-74.140516)"
2019,Octubre,Letonia,428,0,3,3,"(10.445761,-75.516429)"
2020,Febrero,Argentina,32,290,606,896,"(6.171601,-75.427454)"
2014,Agosto,Malta,470,2,3,5,"(4.697144,-74.140516)"
2017,Enero,Liberia,430,1,0,1,"(4.697144,-74.140516)"
2019,Junio,Canadá,124,3,3,6,"(7.818934,-72.453226)"
2019,Abril,Camerún,120,0,3,3,"(4.697144,-74.140516)"
2020,Junio,España,724,27,49,76,"(4.697144,-74.140516)"
2022,Abril,Dinamarca,208,0,2,2,"(3.893038,-77.067921)"
2017,Enero,México,484,10,18,28,"(4.815061,-75.736532)"
2017,Diciembre,Alemania,276,6,18,24,"(4.815061,-75.736532)"
2018,Agosto,Refugiado,99999,5,6,11,"(4.697144,-74.140516)"
2019,Agosto,Jordania,400,0,1,1,"(10.445761,-75.516429)"
2018,Noviembre,Alemania,276,59,60,119,"(0.814836,-77.662532)"
2012,Octubre,Países Bajos,528,1,2,3,"(4.815061,-75.736532)"
2018,Agosto,Grecia,300,5,11,16,"(10.445761,-75.516429)"
2013,Enero,Polonia,616,0,1,1,"(-4.197703,-69.941278)"
2022,Abril,Francia,250,1841,2564,4406,"(4.697144,-74.140516)"
2014,Septiembre,Japón,392,1,1,2,"(10.408582,-75.538003)"
2021,Marzo,Chipre,196,1,4,5,"(6.171601,-75.427454)"
2015,Enero,Israel,376,93,509,602,"(4.697144,-74.140516)"
2020,Marzo,Bahamas,44,0,2,2,"(3.541112,-76.384584)"
2019,Junio,Croacia,191,1,0,1,"(0.814836,-77.662532)"
2022,Octubre,Guyana,328,3,3,6,"(6.171601,-75.427454)"
2015,Mayo,Dinamarca,208,3,4,7,"(10.886611,-74.776708)"
2020,Noviembre,Rumania,642,0,1,1,"(10.408582,-75.538003)"
2014,Junio,Bélgica,56,0,10,10,"(3.893038,-77.067921)"
2016,Noviembre,Francia,250,52,90,142,"(3.541112,-76.384584)"
2015,Septiembre,Estados Unidos de América,840,63,91,154,"(10.408582,-75.538003)"
2022,Junio,México,484,2,1,3,"(11.360009,-72.129330)"
2021,Septiembre,Países Bajos,528,18,41,59,"(3.541112,-76.384584)"
2013,Septiembre,Trinidad y Tobago,780,0,1,1,"(12.586067,-81.702563)"
2022,Septiembre,Suiza,756,40,124,164,"(6.171601,-75.427454)"
2012,Octubre,Polonia,616,2,1,3,"(10.445761,-75.516429)"
2017,Agosto,Bélgica,56,2,1,3,"(12.586067,-81.702563)"
2012,Mayo,Suiza,756,12,23,35,"(6.171601,-75.427454)"
2013,Marzo,Paraguay,600,0,1,1,"(0.814836,-77.662532)"
2018,Marzo,Singapur,702,27,26,53,"(4.697144,-74.140516)"
2012,Junio,Letonia,428,2,0,2,"(6.171601,-75.427454)"
2012,Agosto,República de Irlanda,372,11,17,28,"(0.814836,-77.662532)"
2015,Septiembre,República de Irlanda,372,2,10,12,"(10.408582,-75.538003)"
2018,Septiembre,Guatemala,320,3,2,5,"(12.586067,-81.702563)"
2018,Mayo,Brasil,76,4,6,10,"(3.866713,-67.927521)"
2013,Septiembre,Bangladesh,50,0,3,3,"(4.697144,-74.140516)"
2017,Febrero,Antigua y Barbuda,28,0,2,2,"(10.886611,-74.776708)"
2018,Noviembre,Costa Rica,188,10,10,20,"(12.586067,-81.702563)"
2021,Julio,Anguila/Territorio Británico de Ultramar,660,0,1,1,"(4.697144,-74.140516)"
2015,Enero,Islandia,352,2,1,3,"(0.814836,-77.662532)"
2021,Abril,Estados Unidos de América,840,146,215,361,"(4.815061,-75.736532)"
2019,Julio,España,724,11,9,20,"(-4.223468,-69.945098)"
2018,Abril,Japón,392,16,14,30,"(0.814836,-77.662532)"
2013,Enero,Bulgaria,100,0,1,1,"(10.408582,-75.538003)"
2013,Mayo,Isla de Man,833,13,34,47,"(6.171601,-75.427454)"
2016,Octubre,Japón,392,7,18,25,"(10.445761,-75.516429)"
2016,Diciembre,Italia,380,0,1,1,"(4.452882,-75.766298)"
2012,Noviembre,Países Bajos,528,1,1,2,"(7.128456,-73.183637)"
2019,Febrero,Georgia,268,1,2,3,"(10.445761,-75.516429)"
2016,Noviembre,Filipinas,608,28,67,95,"(4.697144,-74.140516)"
2020,Abril,República Checa,203,1,0,1,"(4.697144,-74.140516)"
2016,Julio,Mongolia,496,2,0,2,"(4.697144,-74.140516)"
2013,Octubre,Barbados,52,0,2,2,"(3.541112,-76.384584)"
2014,Diciembre,Azerbaiyán,31,0,1,1,"(3.893038,-77.067921)"
2018,Marzo,Lituania,440,0,1,1,"(-4.197703,-69.941278)"
2015,Abril,Reino Unido de Gran Bretaña e Irlanda del Norte,826,12,6,18,"(11.360009,-72.129330)"
2016,Abril,Estados Unidos de América,840,6243,11771,18014,"(4.697144,-74.140516)"
2017,Noviembre,Paraguay,600,7,12,19,"(3.541112,-76.384584)"
2012,Octubre,Tailandia,764,3,6,9,"(4.697144,-74.140516)"
2019,Agosto,Letonia,428,1,1,2,"(0.814836,-77.662532)"
2021,Enero,Canadá,124,336,569,906,"(4.697144,-74.140516)"
2021,Abril,Israel,376,2,7,9,"(3.541112,-76.384584)"
2018,Junio,Costa Rica,188,151,108,259,"(10.445761,-75.516429)"
2022,Junio,España,724,2,1,3,"(11.247723,-74.213989)"
2013,Julio,Singapur,702,0,1,1,"(7.818934,-72.453226)"
2020,Marzo,Bolivia,68,382,393,775,"(4.697144,-74.140516)"
2019,Julio,Alemania,276,141,112,253,"(0.814836,-77.662532)"
2022,Junio,El Salvador,222,0,1,1,"(4.452882,-75.766298)"
2020,Marzo,República Checa,203,1,1,2,"(8.635765,-77.346578)"
2022,Noviembre,Jamaica,388,6,7,13,"(10.886611,-74.776708)"
2012,Diciembre,Filipinas,608,0,7,7,"(11.247723,-74.213989)"
2018,Febrero,Nigeria,566,4,7,11,"(4.697144,-74.140516)"
2014,Noviembre,República de Armenia,51,0,1,1,"(7.818934,-72.453226)"
2016,Marzo,Grecia,300,28,68,96,"(4.697144,-74.140516)"
2015,Septiembre,Honduras,340,1,2,3,"(0.814836,-77.662532)"
2018,Marzo,República Dominicana,214,55,73,128,"(10.445761,-75.516429)"
2022,Enero,Alemania,276,0,1,1,"(12.586067,-81.702563)"
2021,Diciembre,República de Irlanda,372,61,134,195,"(4.697144,-74.140516)"
2018,Septiembre,Suiza,756,1,0,1,"(7.128456,-73.183637)"
2023,Junio,Nueva Zelanda,554,3,3,6,"(10.408582,-75.538003)"
2012,Mayo,España,724,1,6,7,"(7.927209,-72.507910)"
2022,Junio,Indonesia,360,1,1,2,"(6.171601,-75.427454)"
2017,Junio,Canadá,124,0,2,2,"(4.452882,-75.766298)"
2013,Junio,Guatemala,320,4,0,4,"(7.128456,-73.183637)"
2017,Junio,El Salvador,222,0,1,1,"(7.818934,-72.453226)"
2017,Enero,India,356,0,11,11,"(10.408582,-75.538003)"
2012,Agosto,Eslovenia,705,5,15,20,"(4.697144,-74.140516)"
2019,Mayo,Venezuela,862,0,1,1,"(13.3387613,-81.372937)"
2019,Junio,Bélgica,56,0,1,1,"(11.360009,-72.129330)"
2013,Febrero,Nueva Zelanda,554,0,1,1,"(1.813928,-78.763924)"
2017,Diciembre,Alemania,276,8,13,21,"(8.635765,-77.346578)"
2017,Marzo,República Dominicana,214,65,70,135,"(10.445761,-75.516429)"
2013,Abril,Argentina,32,0,1,1,"(11.247723,-74.213989)"
2021,Julio,Nicaragua,558,1,0,1,"(4.815061,-75.736532)"
2016,Marzo,India,356,0,3,3,"(0.814836,-77.662532)"
2019,Julio,Honduras,340,133,121,254,"(6.171601,-75.427454)"
2022,Agosto,Perú,604,2,2,4,"(8.36068,-72.409396)"
2016,Abril,República de Moldavia,498,1,2,3,"(4.697144,-74.140516)"
2023,Abril,Taiwán,158,1,0,1,"(8.364293,-72.405710)"
2015,Abril,Federación de Rusia,643,0,5,5,"(11.247723,-74.213989)"
2018,Abril,Belice,84,0,2,2,"(3.541112,-76.384584)"
2015,Marzo,Cuba,192,2,3,5,"(4.815061,-75.736532)"
2022,Enero,Canadá,124,0,1,1,"(7.088729,-70.740253)"
2021,Noviembre,Marruecos,504,1,1,2,"(6.171601,-75.427454)"
2012,Agosto,México,484,0,1,1,"(-4.197703,-69.941278)"
2020,Noviembre,Federación de Rusia,643,0,5,5,"(10.408582,-75.538003)"
2012,Julio,Turkmenistán,795,0,1,1,"(4.815061,-75.736532)"
2022,Agosto,Ecuador,218,0,8,8,"(3.893038,-77.067921)"
2017,Febrero,Japón,392,1,4,5,"(10.408582,-75.538003)"
2012,Enero,Eslovaquia,703,12,24,36,"(4.697144,-74.140516)"
2013,Julio,Reino Unido de Gran Bretaña e Irlanda del Norte,826,394,651,1045,"(4.697144,-74.140516)"
2016,Octubre,Liberia,430,1,0,1,"(4.697144,-74.140516)"
2015,Julio,Portugal,620,1,0,1,"(7.128456,-73.183637)"
2019,Agosto,San  Vicente y las Granadinas,670,0,1,1,"(4.697144,-74.140516)"
2014,Junio,Venezuela,862,43,86,129,"(10.886611,-74.776708)"
2021,Abril,Suecia,752,1,3,4,"(3.541112,-76.384584)"
2022,Abril,Australia,36,21,24,45,"(10.408582,-75.538003)"
2020,Septiembre,Guatemala,320,2,7,9,"(4.697144,-74.140516)"
2012,Julio,Polonia,616,1,1,2,"(7.818934,-72.453226)"
2022,Febrero,Bolivia,68,1,2,3,"(4.815061,-75.736532)"
2017,Noviembre,Francia,250,0,1,1,"(7.088729,-70.740253)"
2020,Diciembre,Honduras,340,22,24,46,"(6.171601,-75.427454)"
2021,Noviembre,Francia,250,1,0,1,"(7.818934,-72.453226)"
2018,Diciembre,Croacia,191,0,1,1,"(11.247723,-74.213989)"
2015,Junio,República Árabe Siria,760,0,1,1,"(0.814836,-77.662532)"
2015,Enero,Estonia,233,0,2,2,"(3.893038,-77.067921)"
2018,Enero,Federación de Rusia,643,2,3,5,"(7.818934,-72.453226)"
2015,Febrero,Federación de Rusia,643,13,7,20,"(6.171601,-75.427454)"
2013,Junio,Bélgica,56,154,275,429,"(4.697144,-74.140516)"
2019,Junio,Granada,308,0,1,1,"(3.541112,-76.384584)"
2015,Diciembre,Kuwait,414,0,1,1,"(3.541112,-76.384584)"
2022,Marzo,Nueva Zelanda,554,2,3,5,"(11.247723,-74.213989)"
2014,Mayo,México,484,93,170,263,"(10.445761,-75.516429)"
2017,Octubre,Trinidad y Tobago,780,19,55,74,"(4.697144,-74.140516)"
2016,Julio,Canadá,124,180,170,350,"(10.445761,-75.516429)"
2021,Noviembre,Ecuador,218,2,0,2,"(7.916725,-72.462544)"
2015,Febrero,Italia,380,2,0,2,"(7.927209,-72.507910)"
2022,Mayo,Suecia,752,1,2,3,"(7.916725,-72.462544)"
2015,Febrero,Dinamarca,208,4,13,17,"(10.445761,-75.516429)"
2012,Enero,Taiwán,158,0,2,2,"(10.886611,-74.776708)"
2014,Agosto,Guatemala,320,0,7,7,"(0.814836,-77.662532)"
2022,Diciembre,Andorra,20,2,12,14,"(4.697144,-74.140516)"
2013,Mayo,Haití,332,4,23,27,"(4.697144,-74.140516)"
2021,Agosto,Belice,84,0,1,1,"(6.171601,-75.427454)"
2023,Marzo,Ecuador,218,5,1,6,"(-4.223468,-69.945098)"
2015,Abril,Estados Unidos de América,840,14,38,52,"(7.128456,-73.183637)"
2019,Septiembre,Granada,308,0,1,1,"(10.445761,-75.516429)"
2013,Junio,Suecia,752,0,1,1,"(11.247723,-74.213989)"
2019,Enero,República de Irlanda,372,17,44,61,"(10.445761,-75.516429)"
2019,Julio,Austria,40,2,3,5,"(-4.223468,-69.945098)"
2016,Septiembre,Tailandia,764,1,0,1,"(10.408582,-75.538003)"
2017,Febrero,Trinidad y Tobago,780,2,8,10,"(3.541112,-76.384584)"
2013,Noviembre,Países Bajos,528,1,0,1,"(4.697144,-74.140516)"
2014,Diciembre,Japón,392,3,12,15,"(0.814836,-77.662532)"
2013,Marzo,Costa Rica,188,0,1,1,"(6.228046,-77.404104)"
2016,Mayo,España,724,0,1,1,"(1.813928,-78.763924)"
2017,Febrero,Tailandia,764,10,8,18,"(4.697144,-74.140516)"
2013,Febrero,Barbados,52,1,0,1,"(7.818934,-72.453226)"
2013,Febrero,Panamá,591,22,31,53,"(12.586067,-81.702563)"
2016,Diciembre,Sudáfrica,710,1,1,2,"(10.886611,-74.776708)"
2021,Octubre,Qatar,634,0,2,2,"(4.697144,-74.140516)"
2016,Octubre,Suecia,752,1,2,3,"(10.886611,-74.776708)"
2013,Mayo,Perú,604,44,31,75,"(12.586067,-81.702563)"
2022,Junio,Alemania,276,15,20,35,"(-4.197703,-69.941278)"
2012,Enero,Países Bajos,528,10,32,42,"(10.445761,-75.516429)"
2019,Junio,Federación de Rusia,643,0,5,5,"(3.893038,-77.067921)"
2019,Febrero,Ecuador,218,1,4,5,"(3.866713,-67.927521)"
2021,Agosto,Filipinas,608,2,5,7,"(6.171601,-75.427454)"
2019,Marzo,Bolivia,68,54,50,104,"(10.408582,-75.538003)"
2020,Marzo,Trinidad y Tobago,780,0,1,1,"(4.452882,-75.766298)"
2016,Septiembre,Bélgica,56,0,1,1,"(8.066966,-76.735404)"
2016,Diciembre,Desconocido,99999,2,2,4,"(10.445761,-75.516429)"
2023,Junio,Malasia,458,0,1,1,"(6.171601,-75.427454)"
2017,Diciembre,Chipre,196,3,9,12,"(4.697144,-74.140516)"
2015,Febrero,Iraq,368,0,1,1,"(4.452882,-75.766298)"
2018,Octubre,Reino Unido de Gran Bretaña e Irlanda del Norte,826,1,2,3,"(7.128456,-73.183637)"
2022,Abril,Australia,36,24,102,126,"(6.171601,-75.427454)"
2022,Diciembre,Barbados,52,9,6,15,"(4.697144,-74.140516)"
2019,Diciembre,Canadá,124,159,149,308,"(12.586067,-81.702563)"
2014,Enero,Ecuador,218,0,1,1,"(4.452882,-75.766298)"
2012,Noviembre,Federación de Rusia,643,37,50,87,"(4.697144,-74.140516)"
2018,Julio,Finlandia,246,43,43,86,"(4.697144,-74.140516)"
2012,Agosto,Canadá,124,6,23,29,"(10.886611,-74.776708)"
2019,Octubre,República Árabe Siria,760,1,2,3,"(4.697144,-74.140516)"
2012,Agosto,Nueva Zelanda,554,7,9,16,"(0.814836,-77.662532)"
2022,Octubre,Portugal,620,5,13,18,"(3.541112,-76.384584)"
2020,Marzo,Noruega,578,5,9,14,"(6.171601,-75.427454)"
2023,Mayo,Francia,250,1699,2418,4118,"(4.697144,-74.140516)"
2012,Abril,Alemania,276,1,11,12,"(11.360009,-72.129330)"
2022,Abril,Bolivia,68,7,3,10,"(12.586067,-81.702563)"
2019,Mayo,Ghana,288,3,2,5,"(3.541112,-76.384584)"
2021,Febrero,República de Irlanda,372,3,15,18,"(4.697144,-74.140516)"
2020,Marzo,República de Corea,410,3,1,4,"(-4.197703,-69.941278)"
2021,Diciembre,Costa Rica,188,1,0,1,"(7.818934,-72.453226)"
2015,Junio,Australia,36,14,11,25,"(10.408582,-75.538003)"
2014,Enero,Panamá,591,1,1,2,"(11.360009,-72.129330)"
2016,Octubre,Ecuador,218,10,7,17,"(12.586067,-81.702563)"
2019,Febrero,Santo Tomé y Príncipe,678,1,0,1,"(6.171601,-75.427454)"
2017,Diciembre,República de Belarús,112,7,6,13,"(4.697144,-74.140516)"
2019,Octubre,Estados Unidos de América,840,7,8,15,"(-4.223468,-69.945098)"
2023,Marzo,Filipinas,608,0,3,3,"(9.402978,-75.681599)"
2018,Junio,Italia,380,36,26,62,"(10.408582,-75.538003)"
2017,Diciembre,Ecuador,218,2997,3530,6527,"(4.697144,-74.140516)"
2012,Junio,Tanzania,834,1,5,6,"(4.697144,-74.140516)"
2022,Agosto,Brasil,76,15,14,29,"(7.927209,-72.507910)"
2016,Julio,Botsuana,72,1,0,1,"(4.697144,-74.140516)"
2017,Octubre,Reino Unido de Gran Bretaña e Irlanda del Norte,826,0,1,1,"(3.893038,-77.067921)"
2022,Diciembre,Myanmar,104,0,1,1,"(9.402978,-75.681599)"
2017,Junio,Georgia,268,0,2,2,"(10.445761,-75.516429)"
2019,Diciembre,Brasil,76,823,648,1471,"(10.445761,-75.516429)"
2019,Mayo,Italia,380,1,6,7,"(4.815061,-75.736532)"
2022,Abril,República de Belarús,112,4,13,17,"(4.697144,-74.140516)"
2018,Diciembre,República Dominicana,214,0,2,2,"(8.36068,-72.409396)"
2022,Julio,Estados Unidos de América,840,1,0,1,"(0.812436,-77.847006)"
2018,Enero,Panamá,591,0,1,1,"(8.36068,-72.409396)"
2021,Octubre,Canadá,124,1,4,5,"(10.408582,-75.538003)"
2022,Octubre,Brasil,76,12,450,462,"(10.408582,-75.538003)"
2021,Agosto,España,724,5,15,20,"(4.815061,-75.736532)"
2015,Diciembre,India,356,0,1,1,"(7.818934,-72.453226)"
2015,Enero,Serbia,688,1,10,11,"(10.445761,-75.516429)"
2015,Julio,Guatemala,320,2,8,10,"(7.818934,-72.453226)"
2015,Octubre,Venezuela,862,2566,2325,4891,"(6.171601,-75.427454)"
2012,Febrero,Países Bajos,528,1,1,2,"(12.586067,-81.702563)"
2018,Agosto,República de Corea,410,0,2,2,"(3.893038,-77.067921)"
2019,Junio,Estados Unidos de América,840,1041,1459,2500,"(10.886611,-74.776708)"
2016,Febrero,Alemania,276,136,202,338,"(6.171601,-75.427454)"
2019,Enero,Cuba,192,4,3,7,"(4.815061,-75.736532)"
2012,Octubre,Bahamas,44,3,1,4,"(4.697144,-74.140516)"
2021,Noviembre,Panamá,591,0,2,2,"(11.117806,-74.232622)"
2020,Febrero,Granada,308,1,0,1,"(10.886611,-74.776708)"
2017,Agosto,Finlandia,246,7,2,9,"(3.541112,-76.384584)"
2014,Abril,Paraguay,600,21,17,38,"(10.445761,-75.516429)"
2019,Julio,Costa Rica,188,3,10,13,"(4.815061,-75.736532)"
2015,Diciembre,España,724,0,2,2,"(12.5744111,-81.703935)"
2019,Julio,Georgia,268,0,1,1,"(10.445761,-75.516429)"
2018,Noviembre,México,484,108,199,307,"(3.541112,-76.384584)"
2014,Agosto,Estados Unidos de América,840,1895,2562,4457,"(10.445761,-75.516429)"
2020,Marzo,Jamaica,388,0,1,1,"(7.128456,-73.183637)"
2012,Julio,Uruguay,858,17,30,47,"(6.171601,-75.427454)"
2013,Agosto,Brasil,76,81,170,251,"(6.171601,-75.427454)"
2018,Febrero,República Checa,203,0,1,1,"(7.818934,-72.453226)"
2013,Septiembre,República Democrática del Congo,180,1,0,1,"(6.171601,-75.427454)"
2022,Febrero,Dinamarca,208,1,1,2,"(-4.197703,-69.941278)"
2015,Enero,Sudáfrica,710,1,1,2,"(6.171601,-75.427454)"
2018,Septiembre,Guatemala,320,99,177,276,"(10.445761,-75.516429)"
2021,Julio,Georgia,268,1,2,3,"(4.697144,-74.140516)"
2015,Octubre,Suecia,752,5,9,14,"(0.814836,-77.662532)"
2014,Enero,Países Bajos,528,1,5,6,"(7.128456,-73.183637)"
2019,Marzo,India,356,0,3,3,"(9.402978,-75.681599)"
2015,Abril,Perú,604,22,38,60,"(11.360009,-72.129330)"
2015,Septiembre,Panamá,591,1372,1461,2833,"(4.697144,-74.140516)"
2015,Marzo,Cuba,192,8,8,16,"(10.886611,-74.776708)"
2014,Mayo,Italia,380,0,1,1,"(7.088729,-70.740253)"
2023,Enero,Canadá,124,4,7,11,"(8.635765,-77.346578)"
2012,Enero,Panamá,591,106,149,255,"(10.445761,-75.516429)"
2019,Abril,Polonia,616,0,1,1,"(11.247723,-74.213989)"
2015,Agosto,Estados Unidos de América,840,56,78,134,"(0.814836,-77.662532)"
2022,Mayo,Alemania,276,1,0,1,"(4.452882,-75.766298)"
2018,Noviembre,Grecia,300,0,4,4,"(10.408582,-75.538003)"
2013,Enero,México,484,0,1,1,"(7.088729,-70.740253)"
2016,Septiembre,Bahamas,44,2,4,6,"(6.171601,-75.427454)"
2017,Noviembre,Refugiado,99999,0,1,1,"(4.697144,-74.140516)"
2014,Julio,Túnez,788,2,5,7,"(4.697144,-74.140516)"
2017,Marzo,Indonesia,360,0,2,2,"(3.893038,-77.067921)"
2013,Febrero,Serbia,688,1,0,1,"(6.171601,-75.427454)"
2015,Noviembre,Cuba,192,18,16,34,"(10.445761,-75.516429)"
2014,Mayo,Reino Unido de Gran Bretaña e Irlanda del Norte,826,0,1,1,"(12.5744111,-81.703935)"
2013,Febrero,Perú,604,801,786,1587,"(0.814836,-77.662532)"
2012,Mayo,Costa Rica,188,7,22,29,"(10.886611,-74.776708)"
2013,Diciembre,Hungría,348,1,0,1,"(7.818934,-72.453226)"
2014,Octubre,China,156,3,9,12,"(3.541112,-76.384584)"
2022,Agosto,Nigeria,566,40,14,54,"(4.697144,-74.140516)"
2021,Julio,Federación de Rusia,643,1,0,1,"(4.815061,-75.736532)"
2017,Marzo,Uruguay,858,1,0,1,"(-4.223468,-69.945098)"
2014,Mayo,Noruega,578,1,1,2,"(-4.197703,-69.941278)"
2015,Marzo,Finlandia,246,2,2,4,"(6.171601,-75.427454)"
2023,Mayo,Polonia,616,4,4,8,"(3.541112,-76.384584)"
2019,Abril,Kenia,404,1,2,3,"(10.445761,-75.516429)"
2016,Noviembre,Francia,250,19,23,42,"(-4.197703,-69.941278)"
2014,Marzo,Panamá,591,95,135,230,"(3.541112,-76.384584)"
2017,Marzo,El Salvador,222,15,21,36,"(10.445761,-75.516429)"
2016,Marzo,República de Irlanda,372,0,4,4,"(3.541112,-76.384584)"
2013,Septiembre,Filipinas,608,0,1,1,"(0.814836,-77.662532)"
2013,Septiembre,Rumania,642,2,0,2,"(3.541112,-76.384584)"
2015,Julio,Ucrania,804,35,34,69,"(4.697144,-74.140516)"
2016,Diciembre,Países Bajos,528,0,1,1,"(12.586067,-81.702563)"
2022,Junio,República de Irlanda,372,37,39,76,"(10.445761,-75.516429)"
2022,Mayo,Portugal,620,5,13,18,"(7.927209,-72.507910)"
2022,Enero,Suiza,756,1,0,1,"(7.916725,-72.462544)"
2021,Febrero,Reino Unido de Gran Bretaña e Irlanda del Norte,826,46,113,159,"(4.697144,-74.140516)"
2013,Diciembre,Uruguay,858,53,45,98,"(10.445761,-75.516429)"
2021,Diciembre,Ucrania,804,0,2,2,"(11.247723,-74.213989)"
2015,Febrero,Líbano,422,15,26,41,"(4.697144,-74.140516)"
2018,Noviembre,Paraguay,600,3,1,4,"(7.818934,-72.453226)"
2012,Mayo,Yugoslavia,99999,1,1,2,"(4.697144,-74.140516)"
2015,Agosto,Honduras,340,0,1,1,"(11.360009,-72.129330)"
2013,Junio,Brasil,76,64,137,201,"(6.171601,-75.427454)"
2019,Junio,Uruguay,858,1,0,1,"(4.815061,-75.736532)"
2018,Febrero,Filipinas,608,9,4,13,"(6.171601,-75.427454)"
2022,Diciembre,Honduras,340,1,1,2,"(12.586067,-81.702563)"
2019,Junio,Austria,40,6,12,18,"(10.445761,-75.516429)"
2015,Diciembre,Argentina,32,9,14,23,"(7.818934,-72.453226)"
2018,Julio,Reino Unido de Gran Bretaña e Irlanda del Norte,826,1,0,1,"(12.586067,-81.702563)"
2018,Mayo,Argentina,32,83,117,200,"(0.814836,-77.662532)"
2015,Febrero,Sudáfrica,710,3,6,9,"(6.171601,-75.427454)"
2013,Noviembre,Panamá,591,140,217,357,"(10.445761,-75.516429)"
2014,Enero,Reino Unido de Gran Bretaña e Irlanda del Norte,826,39,54,93,"(0.814836,-77.662532)"
2013,Agosto,Antigua y Barbuda,28,0,1,1,"(10.445761,-75.516429)"
2016,Septiembre,Guatemala,320,518,783,1301,"(4.697144,-74.140516)"
2018,Abril,Guatemala,320,0,7,7,"(7.818934,-72.453226)"
2017,Enero,Estonia,233,1,0,1,"(7.818934,-72.453226)"
2017,Octubre,Estados Unidos de América,840,0,1,1,"(-4.223468,-69.945098)"
2018,Mayo,Países Bajos,528,2,1,3,"(12.586067,-81.702563)"
2019,Abril,Ucrania,804,0,1,1,"(10.971302,-74.765397)"
2014,Abril,Bolivia,68,202,300,502,"(4.697144,-74.140516)"
2016,Junio,Argentina,32,8,11,19,"(-4.197703,-69.941278)"
2021,Julio,Venezuela,862,7,9,16,"(3.866713,-67.927521)"
2015,Noviembre,Japón,392,3,4,7,"(-4.197703,-69.941278)"
2016,Diciembre,República de Moldavia,498,3,0,3,"(4.697144,-74.140516)"
2021,Noviembre,India,356,0,11,11,"(10.886611,-74.776708)"
2022,Noviembre,Ecuador,218,11,26,37,"(10.886611,-74.776708)"
2023,Abril,Noruega,578,17,16,33,"(6.171601,-75.427454)"
2019,Mayo,Francia,250,0,1,1,"(3.893038,-77.067921)"
2015,Agosto,Argentina,32,3028,4586,7614,"(4.697144,-74.140516)"
2014,Septiembre,Haití,332,0,7,7,"(10.445761,-75.516429)"
2022,Marzo,Reino Unido de Gran Bretaña e Irlanda del Norte,826,1,0,1,"(4.452882,-75.766298)"
2022,Agosto,Venezuela,862,6,1,7,"(3.866713,-67.927521)"
2016,Noviembre,España,724,0,4,4,"(7.088729,-70.740253)"
2021,Marzo,Haití,332,0,1,1,"(10.445761,-75.516429)"
2020,Marzo,Grecia,300,2,8,10,"(6.171601,-75.427454)"
2012,Agosto,Grecia,300,2,0,2,"(10.886611,-74.776708)"
2012,Mayo,Ucrania,804,0,1,1,"(3.893038,-77.067921)"
2015,Junio,El Salvador,222,1,4,5,"(10.886611,-74.776708)"
2018,Octubre,Filipinas,608,4,2,6,"(3.541112,-76.384584)"
2020,Marzo,México,484,4,7,11,"(4.815061,-75.736532)"
2022,Mayo,República Democrática de Timor Oriental,626,1,0,1,"(4.697144,-74.140516)"
2012,Marzo,Chile,152,0,1,1,"(4.815061,-75.736532)"
2016,Junio,Granada,308,1,5,6,"(4.697144,-74.140516)"
2016,Agosto,Noruega,578,2,1,3,"(0.814836,-77.662532)"
2019,Julio,España,724,9,19,28,"(4.815061,-75.736532)"
2013,Julio,Argentina,32,117,84,201,"(10.408582,-75.538003)"
2019,Julio,Costa Rica,188,153,115,268,"(10.445761,-75.516429)"
2019,Enero,Rumania,642,1,1,2,"(11.247723,-74.213989)"
2017,Diciembre,Italia,380,3,3,6,"(11.247723,-74.213989)"
2016,Julio,Australia,36,38,59,97,"(10.445761,-75.516429)"
2016,Agosto,Taiwán,158,2,2,4,"(10.886611,-74.776708)"
2015,Febrero,Noruega,578,4,4,8,"(10.408582,-75.538003)"
2018,Abril,México,484,0,1,1,"(13.3387613,-81.372937)"
2022,Octubre,Georgia,268,0,8,8,"(3.893038,-77.067921)"
2018,Abril,Albania,8,2,1,3,"(4.697144,-74.140516)"
2018,Mayo,España,724,5,8,13,"(-4.223468,-69.945098)"
2022,Abril,Perú,604,1104,1268,2372,"(6.171601,-75.427454)"
2019,Julio,Bélgica,56,0,1,1,"(7.128456,-73.183637)"
2016,Marzo,Portugal,620,20,30,50,"(6.171601,-75.427454)"
2021,Julio,Francia,250,34,58,92,"(10.445761,-75.516429)"
2012,Octubre,Georgia,268,1,0,1,"(4.697144,-74.140516)"
2015,Septiembre,Uruguay,858,24,38,62,"(3.541112,-76.384584)"
2013,Agosto,Austria,40,6,12,18,"(6.171601,-75.427454)"
2018,Diciembre,Taiwán,158,70,54,124,"(4.697144,-74.140516)"
2019,Marzo,República Del Congo,178,0,1,1,"(4.697144,-74.140516)"
2013,Abril,Países Bajos,528,5,3,8,"(7.128456,-73.183637)"
2012,Julio,Angola,24,0,1,1,"(4.697144,-74.140516)"
2018,Enero,El Salvador,222,3,3,6,"(0.814836,-77.662532)"
2021,Julio,Argentina,32,1,0,1,"(4.452882,-75.766298)"
2012,Noviembre,Suecia,752,6,13,19,"(10.408582,-75.538003)"
2018,Diciembre,Ecuador,218,129,305,434,"(0.25129,-76.875963)"
2014,Octubre,Ecuador,218,399,509,908,"(6.171601,-75.427454)"
2022,Julio,Francia,250,5,2,7,"(11.247723,-74.213989)"
2014,Febrero,Islandia,352,1,0,1,"(3.541112,-76.384584)"
2017,Abril,Venezuela,862,702,726,1428,"(6.171601,-75.427454)"
2019,Septiembre,Nueva Zelanda,554,4,8,12,"(10.408582,-75.538003)"
2015,Agosto,Suecia,752,100,179,279,"(4.697144,-74.140516)"
2022,Abril,Venezuela,862,0,1,1,"(11.117806,-74.232622)"
2022,Marzo,Santa Lucia,662,3,2,5,"(3.541112,-76.384584)"
2019,Marzo,Cuba,192,0,9,9,"(0.814836,-77.662532)"
2015,Junio,República Árabe Siria,760,0,1,1,"(4.815061,-75.736532)"
2016,Julio,República Dominicana,214,1,1,2,"(4.452882,-75.766298)"
2012,Noviembre,Eslovenia,705,0,2,2,"(10.408582,-75.538003)"
2013,Mayo,Reino Unido de Gran Bretaña e Irlanda del Norte,826,0,1,1,"(7.927209,-72.507910)"
2018,Enero,Nicaragua,558,1,3,4,"(12.586067,-81.702563)"
2013,Septiembre,Venezuela,862,0,2,2,"(4.452882,-75.766298)"
2012,Abril,Chile,152,2,2,4,"(11.360009,-72.129330)"
2019,Enero,Lituania,440,5,4,9,"(10.445761,-75.516429)"
2018,Noviembre,Ecuador,218,0,1,1,"(6.185799,-67.483929)"
2012,Febrero,Nueva Zelanda,554,0,1,1,"(4.815061,-75.736532)"
2012,Abril,Honduras,340,2,0,2,"(7.818934,-72.453226)"
2012,Julio,Bolivia,68,1,8,9,"(11.360009,-72.129330)"
2018,Agosto,Costa Rica,188,11,22,33,"(10.886611,-74.776708)"
2016,Noviembre,Suiza,756,0,3,3,"(4.815061,-75.736532)"
2016,Julio,China,156,1,0,1,"(7.128456,-73.183637)"
2017,Junio,Perú,604,1,0,1,"(8.635765,-77.346578)"
2019,Agosto,Myanmar,104,0,1,1,"(10.408582,-75.538003)"
2014,Agosto,Honduras,340,9,28,37,"(3.541112,-76.384584)"
2023,Febrero,Bolivia,68,1,0,1,"(11.360009,-72.129330)"
2017,Abril,Italia,380,1,1,2,"(4.452882,-75.766298)"
2022,Febrero,Perú,604,4,7,11,"(4.452882,-75.766298)"
2016,Junio,Francia,250,70,201,271,"(6.171601,-75.427454)"
2022,Septiembre,Países Bajos,528,0,4,4,"(7.916725,-72.462544)"
2017,Junio,Taiwán,158,2,0,2,"(7.818934,-72.453226)"
2017,Noviembre,Etiopia,231,0,1,1,"(4.697144,-74.140516)"
2022,Febrero,Argentina,32,41,56,97,"(3.541112,-76.384584)"
2023,Mayo,India,356,0,2,2,"(4.815061,-75.736532)"
2014,Agosto,Guatemala,320,31,38,69,"(10.445761,-75.516429)"
2014,Enero,Trinidad y Tobago,780,1,0,1,"(7.927209,-72.507910)"
2015,Julio,Chile,152,0,1,1,"(0.25129,-76.875963)"
2017,Mayo,Venezuela,862,0,1,1,"(4.452882,-75.766298)"
2014,Noviembre,Perú,604,15,29,44,"(-4.197703,-69.941278)"
2012,Mayo,Nueva Zelanda,554,2,0,2,"(3.541112,-76.384584)"
2023,Enero,Japón,392,21,51,72,"(6.171601,-75.427454)"
2022,Agosto,Eslovaquia,703,8,10,18,"(6.171601,-75.427454)"
2017,Agosto,Nicaragua,558,4,3,7,"(12.586067,-81.702563)"
2017,Octubre,España,724,8,15,23,"(4.815061,-75.736532)"
2022,Diciembre,Bulgaria,100,1,3,4,"(3.541112,-76.384584)"
2012,Febrero,República de Corea,410,0,2,2,"(8.635765,-77.346578)"
2015,Febrero,República Dominicana,214,8,8,16,"(4.815061,-75.736532)"
2012,Junio,Canadá,124,2,2,4,"(11.360009,-72.129330)"
2014,Mayo,Sudáfrica,710,20,75,95,"(4.697144,-74.140516)"
2016,Diciembre,República de Irlanda,372,0,1,1,"(7.128456,-73.183637)"
2019,Julio,Paraguay,600,3,2,5,"(12.586067,-81.702563)"
2022,Septiembre,Honduras,340,8,4,12,"(4.815061,-75.736532)"
2019,Enero,Estados Unidos de América,840,0,1,1,"(0.812436,-77.847006)"
2018,Mayo,Santa Lucia,662,1,1,2,"(10.445761,-75.516429)"
2022,Marzo,Taiwán,158,0,1,1,"(7.818934,-72.453226)"
2012,Junio,Noruega,578,2,0,2,"(10.886611,-74.776708)"
2012,Marzo,Estonia,233,1,1,2,"(11.360009,-72.129330)"
2017,Diciembre,Letonia,428,6,9,15,"(4.697144,-74.140516)"
2017,Diciembre,Letonia,428,0,1,1,"(10.408582,-75.538003)"
2015,Diciembre,Uzbekistán,860,1,0,1,"(3.541112,-76.384584)"
2022,Noviembre,Kenia,404,1,0,1,"(10.445761,-75.516429)"
2017,Octubre,República Dominicana,214,6,4,10,"(10.408582,-75.538003)"
2022,Febrero,Nueva Zelanda,554,1,0,1,"(8.635765,-77.346578)"
2015,Abril,México,484,3,8,11,"(12.586067,-81.702563)"
2015,Febrero,Emiratos Árabes,784,3,2,5,"(4.697144,-74.140516)"
2017,Julio,Islas Vírgenes Británicas/Territorio Británico de Ultramar,92,0,1,1,"(10.445761,-75.516429)"
2016,Septiembre,Libia,434,0,1,1,"(4.697144,-74.140516)"
2012,Octubre,Costa Rica,188,7,14,21,"(10.886611,-74.776708)"
2012,Noviembre,México,484,3,0,3,"(0.25129,-76.875963)"
2020,Febrero,Hong Kong,344,2,0,2,"(10.445761,-75.516429)"
2016,Marzo,Nepal,524,0,1,1,"(10.445761,-75.516429)"
2019,Junio,Kenia,404,2,1,3,"(6.171601,-75.427454)"
2016,Junio,Polonia,616,0,2,2,"(3.893038,-77.067921)"
2018,Enero,Panamá,591,0,1,1,"(-4.197703,-69.941278)"
2016,Febrero,España,724,7,9,16,"(4.815061,-75.736532)"
2020,Junio,El Salvador,222,12,8,20,"(0.814836,-77.662532)"
2013,Marzo,Croacia,191,1,0,1,"(6.171601,-75.427454)"
2013,Abril,Estados Unidos de América,840,5,16,21,"(7.927209,-72.507910)"
2015,Noviembre,Israel,376,4,22,26,"(10.445761,-75.516429)"
2012,Junio,Finlandia,246,36,58,94,"(4.697144,-74.140516)"
2013,Octubre,Costa Rica,188,1,2,3,"(7.818934,-72.453226)"
2018,Febrero,Bolivia,68,1,0,1,"(-4.197703,-69.941278)"
2013,Junio,El Salvador,222,7,6,13,"(10.445761,-75.516429)"
2020,Diciembre,Ecuador,218,34,28,62,"(10.445761,-75.516429)"
2016,Febrero,Reino Unido de Gran Bretaña e Irlanda del Norte,826,2,5,7,"(12.586067,-81.702563)"
2022,Noviembre,Suiza,756,73,149,222,"(6.171601,-75.427454)"
2012,Junio,Federación de Rusia,643,3,0,3,"(6.171601,-75.427454)"
2012,Mayo,Cuba,192,0,1,1,"(7.818934,-72.453226)"
2015,Septiembre,Israel,376,10,35,45,"(10.445761,-75.516429)"
2015,Agosto,El Salvador,222,3,0,3,"(10.886611,-74.776708)"
2021,Septiembre,Filipinas,608,0,18,18,"(10.971302,-74.765397)"
2012,Febrero,Kenia,404,0,2,2,"(7.818934,-72.453226)"
2021,Abril,Austria,40,2,12,14,"(6.171601,-75.427454)"
2016,Agosto,Venezuela,862,8266,8571,16837,"(11.360009,-72.129330)"
2023,Enero,Pakistán,586,3,31,34,"(4.697144,-74.140516)"
2013,Abril,Argentina,32,1,5,6,"(4.815061,-75.736532)"
2017,Junio,Bangladesh,50,0,2,2,"(4.697144,-74.140516)"
2017,Junio,República Democrática Popular  Lao,418,1,1,2,"(4.697144,-74.140516)"
2012,Octubre,Andorra,20,2,7,9,"(4.697144,-74.140516)"
2019,Junio,Bahamas,44,1,4,5,"(10.886611,-74.776708)"
2017,Junio,Turquía,792,0,4,4,"(11.247723,-74.213989)"
2013,Junio,Australia,36,0,1,1,"(4.452882,-75.766298)"
2013,Marzo,Reino Unido de Gran Bretaña e Irlanda del Norte,826,1,2,3,"(12.586067,-81.702563)"
2014,Abril,Brasil,76,3,5,8,"(4.815061,-75.736532)"
2013,Marzo,Bélgica,56,12,10,22,"(0.814836,-77.662532)"
2023,Enero,Ucrania,804,14,15,29,"(10.445761,-75.516429)"
2017,Febrero,Afganistán,4,0,2,2,"(4.697144,-74.140516)"
2012,Septiembre,Venezuela,862,1360,1693,3053,"(11.360009,-72.129330)"
2012,Septiembre,Bolivia,68,16,49,65,"(6.171601,-75.427454)"
2019,Abril,Perú,604,0,2,2,"(4.452882,-75.766298)"
2019,Junio,Hungría,348,1,1,2,"(10.886611,-74.776708)"
2013,Marzo,Nicaragua,558,5,8,13,"(3.541112,-76.384584)"
2013,Enero,Croacia,191,1,2,3,"(3.541112,-76.384584)"
2020,Diciembre,Estados Unidos de América,840,0,1,1,"(11.360009,-72.129330)"
2019,Septiembre,México,484,0,1,1,"(3.893038,-77.067921)"
2017,Mayo,Australia,36,7,10,17,"(8.635765,-77.346578)"
2013,Agosto,Estados Unidos de América,840,6,10,16,"(8.635765,-77.346578)"
2019,Octubre,Japón,392,119,400,519,"(4.697144,-74.140516)"
2023,Marzo,Georgia,268,0,2,2,"(3.893038,-77.067921)"
2017,Diciembre,Japón,392,0,1,1,"(8.635765,-77.346578)"
2016,Septiembre,Nicaragua,558,82,85,167,"(4.697144,-74.140516)"
2022,Septiembre,Liechtenstein,438,0,3,3,"(6.171601,-75.427454)"
2013,Febrero,Países Bajos,528,2,7,9,"(11.360009,-72.129330)"
2018,Abril,Guatemala,320,3,4,7,"(4.815061,-75.736532)"
2014,Octubre,España,724,3,2,5,"(11.247723,-74.213989)"
2014,Febrero,Cuba,192,0,1,1,"(7.927209,-72.507910)"
2019,Abril,Ecuador,218,1,2,3,"(3.866713,-67.927521)"
2013,Mayo,Bosnia y Herzegovina,70,1,1,2,"(4.697144,-74.140516)"
2020,Enero,Nepal,524,0,1,1,"(0.814836,-77.662532)"
2019,Agosto,Túnez,788,1,0,1,"(0.814836,-77.662532)"
2013,Septiembre,Croacia,191,5,22,27,"(4.697144,-74.140516)"
2015,Julio,Guatemala,320,3,5,8,"(4.815061,-75.736532)"
2014,Diciembre,Países Bajos,528,0,9,9,"(8.635765,-77.346578)"
2012,Agosto,Ecuador,218,694,807,1501,"(6.171601,-75.427454)"
2015,Octubre,Tailandia,764,15,17,32,"(10.408582,-75.538003)"
2012,Junio,Sudáfrica,710,0,2,2,"(11.360009,-72.129330)"
2013,Julio,Honduras,340,151,231,382,"(4.697144,-74.140516)"
2013,Septiembre,Perú,604,1,0,1,"(7.088729,-70.740253)"
2015,Febrero,Lituania,440,1,0,1,"(8.635765,-77.346578)"
2019,Febrero,Kuwait,414,1,1,2,"(10.445761,-75.516429)"
2020,Febrero,Perú,604,0,1,1,"(7.088729,-70.740253)"
2019,Julio,Costa Rica,188,40,60,100,"(3.541112,-76.384584)"
2019,Marzo,República Checa,203,8,15,23,"(6.171601,-75.427454)"
2018,Abril,Alemania,276,21,24,45,"(-4.223468,-69.945098)"
2018,Marzo,Dinamarca,208,8,20,28,"(6.171601,-75.427454)"
2015,Abril,Lituania,440,0,2,2,"(11.247723,-74.213989)"
2020,Noviembre,China,156,0,1,1,"(10.445761,-75.516429)"
2015,Septiembre,El Salvador,222,5,13,18,"(10.445761,-75.516429)"
2023,Enero,Georgia,268,0,1,1,"(3.893038,-77.067921)"
2017,Julio,Países Bajos,528,28,42,70,"(10.408582,-75.538003)"
2017,Agosto,República Checa,203,0,2,2,"(-4.197703,-69.941278)"
2023,Febrero,Brasil,76,0,6,6,"(7.818934,-72.453226)"
2016,Enero,Lituania,440,1,2,3,"(3.541112,-76.384584)"
2015,Octubre,China,156,5,10,15,"(3.541112,-76.384584)"
2016,Abril,Finlandia,246,2,6,8,"(3.541112,-76.384584)"
2015,Abril,India,356,3,18,21,"(10.445761,-75.516429)"
2013,Marzo,México,484,17,15,32,"(10.408582,-75.538003)"
2013,Octubre,Nicaragua,558,0,5,5,"(10.408582,-75.538003)"
2015,Febrero,Chile,152,90,124,214,"(3.541112,-76.384584)"
2017,Octubre,Perú,604,3,5,8,"(7.088729,-70.740253)"
2022,Agosto,Costa Rica,188,12,28,40,"(10.886611,-74.776708)"
2016,Mayo,Taiwán,158,10,26,36,"(6.171601,-75.427454)"
2014,Julio,Lituania,440,0,2,2,"(10.408582,-75.538003)"
2017,Febrero,Finlandia,246,4,4,8,"(0.814836,-77.662532)"
2015,Enero,República de Irlanda,372,0,1,1,"(10.886611,-74.776708)"
2014,Noviembre,Polonia,616,2,2,4,"(10.886611,-74.776708)"
2021,Noviembre,Polonia,616,9,19,28,"(6.171601,-75.427454)"
2017,Septiembre,Sudáfrica,710,3,0,3,"(13.3387613,-81.372937)"
2017,Diciembre,Indonesia,360,0,5,5,"(10.971302,-74.765397)"
2018,Febrero,Uruguay,858,2,1,3,"(4.815061,-75.736532)"
2021,Enero,Grecia,300,0,2,2,"(10.445761,-75.516429)"
2012,Octubre,Filipinas,608,0,2,2,"(7.927209,-72.507910)"
2018,Octubre,Italia,380,2,2,4,"(8.635765,-77.346578)"
2022,Julio,Cuba,192,1,1,2,"(4.815061,-75.736532)"
2016,Noviembre,Barbados,52,1,0,1,"(10.886611,-74.776708)"
2013,Abril,Túnez,788,0,1,1,"(6.171601,-75.427454)"
2016,Noviembre,Argentina,32,6,12,18,"(-4.197703,-69.941278)"
2012,Febrero,Italia,380,3,18,21,"(11.360009,-72.129330)"
2015,Septiembre,Paraguay,600,3,4,7,"(7.128456,-73.183637)"
2017,Agosto,Polonia,616,2,1,3,"(-4.197703,-69.941278)"
2018,Marzo,India,356,114,402,517,"(4.697144,-74.140516)"
2017,Febrero,Benín,204,0,1,1,"(4.697144,-74.140516)"
2014,Mayo,Antigua y Barbuda,28,0,1,1,"(6.171601,-75.427454)"
2014,Octubre,Uganda,800,2,1,3,"(3.541112,-76.384584)"
2017,Septiembre,Togo,768,0,1,1,"(10.445761,-75.516429)"
2012,Marzo,El Salvador,222,7,6,13,"(10.445761,-75.516429)"
2015,Abril,Croacia,191,0,1,1,"(11.360009,-72.129330)"
2012,Septiembre,Dominica,212,4,7,11,"(4.697144,-74.140516)"
2012,Diciembre,Bélgica,56,0,9,9,"(10.886611,-74.776708)"
2017,Febrero,Trinidad y Tobago,780,23,43,66,"(4.697144,-74.140516)"
2013,Diciembre,México,484,1,4,5,"(8.635765,-77.346578)"
2018,Julio,Brasil,76,4,8,12,"(7.818934,-72.453226)"
2019,Diciembre,Guatemala,320,53,105,158,"(6.171601,-75.427454)"
2018,Marzo,República de Belarús,112,1,3,4,"(6.171601,-75.427454)"
2022,Septiembre,Nicaragua,558,96,95,191,"(4.697144,-74.140516)"
2015,Abril,Alemania,276,6,15,21,"(10.886611,-74.776708)"
2018,Diciembre,Países Bajos,528,1,0,1,"(13.3387613,-81.372937)"
2019,Febrero,Croacia,191,1,7,8,"(10.445761,-75.516429)"
2015,Julio,Rumania,642,0,1,1,"(9.402978,-75.681599)"
2015,Febrero,Federación de Rusia,643,1,0,1,"(12.586067,-81.702563)"
2012,Septiembre,Panamá,591,181,303,484,"(6.171601,-75.427454)"
2021,Enero,Argelia,12,0,2,2,"(4.697144,-74.140516)"
2023,Junio,Chile,152,89,243,332,"(6.171601,-75.427454)"
2022,Junio,China,156,0,2,2,"(11.247723,-74.213989)"
2018,Julio,Italia,380,73,93,166,"(3.541112,-76.384584)"
2018,Enero,Nepal,524,1,0,1,"(10.445761,-75.516429)"
2015,Julio,Argentina,32,97,109,206,"(3.541112,-76.384584)"
2012,Febrero,Rumania,642,1,0,1,"(6.171601,-75.427454)"
2013,Noviembre,Chile,152,5,5,10,"(11.360009,-72.129330)"
2018,Noviembre,Ucrania,804,0,2,2,"(9.402978,-75.681599)"
2023,Febrero,Reino Unido de Gran Bretaña e Irlanda del Norte,826,1,0,1,"(7.818934,-72.453226)"
2019,Noviembre,Uruguay,858,2,1,3,"(4.815061,-75.736532)"
2018,Diciembre,Honduras,340,1,1,2,"(4.452882,-75.766298)"
2018,Diciembre,Granada,308,1,1,2,"(3.541112,-76.384584)"
2014,Septiembre,Eslovaquia,703,16,17,33,"(4.697144,-74.140516)"
2019,Octubre,Suiza,756,439,694,1133,"(4.697144,-74.140516)"
2020,Marzo,Emiratos Árabes,784,0,3,3,"(6.171601,-75.427454)"
2015,Abril,Portugal,620,1,3,4,"(10.408582,-75.538003)"
2013,Septiembre,Kenia,404,0,1,1,"(3.541112,-76.384584)"
2020,Marzo,Dinamarca,208,0,1,1,"(12.586067,-81.702563)"
2021,Marzo,Países Bajos,528,9,19,28,"(3.541112,-76.384584)"
2023,Abril,Etiopia,231,0,2,2,"(10.408582,-75.538003)"
2012,Abril,Emiratos Árabes,784,0,7,7,"(4.697144,-74.140516)"
2012,Junio,Reino Unido de Gran Bretaña e Irlanda del Norte,826,0,1,1,"(0.814836,-77.662532)"
2023,Enero,Estados Unidos de América,840,23,84,107,"(0.814836,-77.662532)"
2017,Mayo,Canadá,124,3,6,9,"(7.818934,-72.453226)"
2015,Octubre,Ecuador,218,1,4,5,"(-4.197703,-69.941278)"
2015,Diciembre,Pakistán,586,0,1,1,"(6.171601,-75.427454)"
2018,Febrero,Cuba,192,6,15,21,"(10.445761,-75.516429)"
2017,Octubre,Alemania,276,10,9,19,"(8.635765,-77.346578)"
2023,Enero,República de Corea,410,4,0,4,"(3.541112,-76.384584)"
2023,Marzo,Surinam,740,7,22,29,"(6.171601,-75.427454)"
2020,Noviembre,Serbia,688,2,7,9,"(4.697144,-74.140516)"
2014,Junio,Perú,604,4,15,19,"(10.886611,-74.776708)"
2022,Enero,Países Bajos,528,23,34,57,"(10.886611,-74.776708)"
2014,Julio,Bolivia,68,432,525,957,"(4.697144,-74.140516)"
2014,Octubre,Lituania,440,0,1,1,"(11.247723,-74.213989)"
2013,Octubre,Luxemburgo,442,0,1,1,"(6.171601,-75.427454)"
2012,Febrero,Perú,604,0,1,1,"(11.528919,-72.919681)"
2016,Mayo,Dinamarca,208,1,0,1,"(12.5744111,-81.703935)"
2016,Agosto,Italia,380,5,9,14,"(8.635765,-77.346578)"
2018,Febrero,Polonia,616,194,232,426,"(4.697144,-74.140516)"
2013,Enero,China,156,4,0,4,"(10.886611,-74.776708)"
2020,Diciembre,Marruecos,504,0,1,1,"(3.541112,-76.384584)"
2013,Julio,Costa Rica,188,10,26,36,"(10.886611,-74.776708)"
2021,Abril,Federación de Rusia,643,0,12,12,"(10.408582,-75.538003)"
2019,Diciembre,República Dominicana,214,879,995,1874,"(4.697144,-74.140516)"
2014,Octubre,Canadá,124,1,6,7,"(7.818934,-72.453226)"
2021,Septiembre,Suiza,756,0,3,3,"(0.814836,-77.662532)"
2019,Agosto,República Checa,203,4,0,4,"(10.445761,-75.516429)"
2023,Mayo,Nepal,524,2,2,4,"(10.445761,-75.516429)"
2016,Septiembre,Ecuador,218,51,179,230,"(0.25129,-76.875963)"
2013,Diciembre,China,156,3,6,9,"(3.541112,-76.384584)"
2013,Agosto,Dominica,212,0,2,2,"(4.697144,-74.140516)"
2021,Abril,Italia,380,0,3,3,"(4.815061,-75.736532)"
2013,Noviembre,Uruguay,858,100,68,168,"(10.445761,-75.516429)"
2023,Mayo,Chile,152,90,219,309,"(6.171601,-75.427454)"
2018,Octubre,San Cristóbal y Nevis,659,1,0,1,"(6.171601,-75.427454)"
2019,Junio,Italia,380,1,12,13,"(4.815061,-75.736532)"
2015,Enero,Alemania,276,1,0,1,"(7.128456,-73.183637)"
2022,Enero,Chile,152,2,4,6,"(4.815061,-75.736532)"
2015,Octubre,República Dominicana,214,405,488,893,"(4.697144,-74.140516)"
2021,Marzo,Camerún,120,1,0,1,"(4.697144,-74.140516)"
2013,Enero,Lituania,440,4,1,5,"(4.697144,-74.140516)"
2016,Abril,Polonia,616,6,8,14,"(6.171601,-75.427454)"
2022,Agosto,Irán,364,0,1,1,"(10.886611,-74.776708)"
2015,Enero,Líbano,422,1,3,4,"(10.445761,-75.516429)"
2013,Noviembre,Estados Unidos de América,840,3,6,9,"(13.3387613,-81.372937)"
2013,Abril,Uruguay,858,42,31,73,"(12.586067,-81.702563)"
2013,Junio,Países Bajos,528,0,2,2,"(-4.197703,-69.941278)"
2017,Septiembre,Kuwait,414,1,0,1,"(10.445761,-75.516429)"
2018,Noviembre,Japón,392,0,1,1,"(-4.197703,-69.941278)"
2023,Enero,Albania,8,13,37,50,"(4.697144,-74.140516)"
2021,Marzo,Jamaica,388,14,11,25,"(4.697144,-74.140516)"
2012,Mayo,Guatemala,320,1,6,7,"(10.408582,-75.538003)"
2023,Mayo,China,156,3,1,4,"(7.818934,-72.453226)"
2016,Julio,Nicaragua,558,62,96,158,"(4.697144,-74.140516)"
2014,Julio,Reino Unido de Gran Bretaña e Irlanda del Norte,826,3,8,11,"(12.586067,-81.702563)"
2014,Diciembre,Canadá,124,253,421,674,"(6.171601,-75.427454)"
2013,Enero,Federación de Rusia,643,1,4,5,"(0.814836,-77.662532)"
2015,Junio,Reino Unido de Gran Bretaña e Irlanda del Norte,826,0,2,2,"(7.128456,-73.183637)"
2022,Mayo,Chile,152,3,3,6,"(8.36068,-72.409396)"
2018,Abril,Paraguay,600,5,7,12,"(10.886611,-74.776708)"
2022,Abril,Perú,604,0,1,1,"(6.185799,-67.483929)"
2016,Febrero,Países Bajos,528,1,2,3,"(7.818934,-72.453226)"
2014,Mayo,Argentina,32,193,133,326,"(10.408582,-75.538003)"
2015,Octubre,Croacia,191,2,0,2,"(0.814836,-77.662532)"
2014,Diciembre,Turquía,792,2,1,3,"(-4.197703,-69.941278)"
2014,Octubre,Taiwán,158,1,1,2,"(10.886611,-74.776708)"
2012,Septiembre,Reino Unido de Gran Bretaña e Irlanda del Norte,826,12,13,25,"(10.408582,-75.538003)"
2014,Junio,República Dominicana,214,27,24,51,"(10.445761,-75.516429)"
2019,Mayo,Belice,84,8,11,19,"(6.171601,-75.427454)"
2015,Agosto,Belice,84,4,21,25,"(4.697144,-74.140516)"
2019,Noviembre,Reino Unido de Gran Bretaña e Irlanda del Norte,826,0,1,1,"(7.088729,-70.740253)"
2021,Marzo,República de Corea,410,1,0,1,"(10.445761,-75.516429)"
2022,Diciembre,Islas Turcas y Caicos/Territorio Británico de Ultramar,796,1,0,1,"(6.171601,-75.427454)"
2018,Octubre,Nueva Zelanda,554,4,6,10,"(0.814836,-77.662532)"
2012,Diciembre,Argentina,32,0,3,3,"(7.128456,-73.183637)"
2016,Junio,Nepal,524,0,1,1,"(4.697144,-74.140516)"
2016,Septiembre,Alemania,276,2,1,3,"(4.452882,-75.766298)"
2019,Febrero,Bélgica,56,2,2,4,"(11.247723,-74.213989)"
2014,Septiembre,Kazajistán,398,7,5,12,"(4.697144,-74.140516)"
2017,Septiembre,Bolivia,68,8,12,20,"(0.814836,-77.662532)"
2015,Julio,Panamá,591,0,3,3,"(7.102626,-77.762647)"
2012,Agosto,República de Moldavia,498,2,0,2,"(4.697144,-74.140516)"
2021,Noviembre,Irán,364,0,1,1,"(6.171601,-75.427454)"
2021,Noviembre,República Dominicana,214,1533,1696,3229,"(4.697144,-74.140516)"
2023,Marzo,Brasil,76,3,5,8,"(7.818934,-72.453226)"
2019,Septiembre,Canadá,124,5,6,11,"(0.814836,-77.662532)"
2015,Diciembre,España,724,9,11,20,"(12.586067,-81.702563)"
2017,Enero,Indonesia,360,1,0,1,"(6.171601,-75.427454)"
2017,Julio,Tanzania,834,0,2,2,"(4.697144,-74.140516)"
2023,Enero,Filipinas,608,0,19,19,"(10.886611,-74.776708)"
2021,Mayo,Perú,604,7,7,14,"(4.815061,-75.736532)"
2014,Septiembre,Perú,604,0,2,2,"(4.452882,-75.766298)"
2016,Septiembre,Marruecos,504,0,2,2,"(3.541112,-76.384584)"
2022,Agosto,Ecuador,218,6407,6060,12467,"(4.697144,-74.140516)"
2014,Marzo,China,156,166,530,696,"(4.697144,-74.140516)"
2015,Mayo,Países Bajos,528,1,0,1,"(8.635765,-77.346578)"
2014,Julio,Croacia,191,1,2,3,"(3.541112,-76.384584)"
2012,Enero,Santa Lucia,662,1,0,1,"(10.445761,-75.516429)"
2015,Octubre,Finlandia,246,4,6,10,"(3.541112,-76.384584)"
2022,Julio,Madagascar,450,0,1,1,"(3.541112,-76.384584)"
2014,Enero,Reino Unido de Gran Bretaña e Irlanda del Norte,826,5,13,18,"(10.886611,-74.776708)"
2013,Octubre,Países Bajos,528,1,0,1,"(12.586067,-81.702563)"
2014,Abril,Montenegro,499,0,1,1,"(11.247723,-74.213989)"
2015,Abril,Marruecos,504,6,11,17,"(4.697144,-74.140516)"
2017,Octubre,Egipto,818,0,2,2,"(6.171601,-75.427454)"
2021,Septiembre,Chile,152,1,4,5,"(4.815061,-75.736532)"
2016,Junio,Polonia,616,2,9,11,"(10.445761,-75.516429)"
2013,Octubre,Botsuana,72,0,3,3,"(4.697144,-74.140516)"
2017,Mayo,Francia,250,2,4,6,"(12.5744111,-81.703935)"
2013,Enero,Ghana,288,0,1,1,"(11.360009,-72.129330)"
2016,Marzo,Suiza,756,30,34,64,"(10.445761,-75.516429)"
2018,Julio,Vietnam,704,2,0,2,"(0.814836,-77.662532)"
2019,Octubre,Australia,36,4,9,13,"(10.886611,-74.776708)"
2022,Junio,Líbano,422,7,20,27,"(4.697144,-74.140516)"
2022,Octubre,Ecuador,218,0,28,28,"(10.408582,-75.538003)"
2019,Junio,Israel,376,2,8,10,"(12.586067,-81.702563)"
2022,Septiembre,Filipinas,608,0,15,15,"(10.971302,-74.765397)"
2019,Enero,Kenia,404,5,4,9,"(4.697144,-74.140516)"
2018,Enero,Bolivia,68,5,12,17,"(7.818934,-72.453226)"
2012,Mayo,Japón,392,6,23,29,"(3.541112,-76.384584)"
2018,Abril,Israel,376,3,9,12,"(-4.223468,-69.945098)"
2016,Agosto,Emiratos Árabes,784,0,4,4,"(6.171601,-75.427454)"
2014,Noviembre,Estonia,233,3,10,13,"(4.697144,-74.140516)"
2022,Abril,Estados Unidos de América,840,958,1546,2504,"(10.886611,-74.776708)"
2012,Enero,Bolivia,68,0,2,2,"(4.815061,-75.736532)"
2017,Abril,Antigua y Barbuda,28,3,2,5,"(4.697144,-74.140516)"
2018,Octubre,Portugal,620,14,21,35,"(10.445761,-75.516429)"
2012,Septiembre,Bélgica,56,5,6,11,"(10.445761,-75.516429)"
2012,Septiembre,Reino Unido de Gran Bretaña e Irlanda del Norte,826,2,6,8,"(10.886611,-74.776708)"
2013,Mayo,República de Corea,410,3,12,15,"(7.818934,-72.453226)"
2012,Julio,Irán,364,0,1,1,"(6.171601,-75.427454)"
2012,Diciembre,República Dominicana,214,0,7,7,"(11.360009,-72.129330)"
2017,Julio,Cuba,192,1,0,1,"(7.818934,-72.453226)"
2013,Julio,Malasia,458,0,4,4,"(6.171601,-75.427454)"
2023,Enero,República de Irlanda,372,1,2,3,"(10.886611,-74.776708)"
2015,Julio,Sudán,736,2,9,11,"(4.697144,-74.140516)"
2013,Junio,Islandia,352,1,0,1,"(7.818934,-72.453226)"
2015,Septiembre,Venezuela,862,0,2,2,"(8.635765,-77.346578)"
2015,Noviembre,Ecuador,218,24,103,127,"(1.813928,-78.763924)"
2017,Mayo,Rumania,642,2,3,5,"(3.541112,-76.384584)"
2022,Noviembre,Canadá,124,276,652,928,"(6.171601,-75.427454)"
2013,Noviembre,Hungría,348,0,1,1,"(-4.197703,-69.941278)"
2020,Diciembre,Honduras,340,0,1,1,"(3.893038,-77.067921)"
2013,Diciembre,Lituania,440,0,1,1,"(10.971302,-74.765397)"
2014,Mayo,Islas Caimán/Territorio Británico de Ultramar,136,0,1,1,"(12.586067,-81.702563)"
2017,Abril,Venezuela,862,244,246,490,"(8.36068,-72.409396)"
2012,Septiembre,Uruguay,858,1,0,1,"(4.452882,-75.766298)"
2015,Octubre,Portugal,620,1,2,3,"(7.818934,-72.453226)"
2020,Noviembre,Eslovaquia,703,1,2,3,"(6.171601,-75.427454)"
2019,Diciembre,España,724,3608,6045,9653,"(4.697144,-74.140516)"
2015,Diciembre,Austria,40,17,26,43,"(10.445761,-75.516429)"
2022,Agosto,Albania,8,4,28,32,"(4.697144,-74.140516)"
2021,Junio,España,724,1185,1978,3164,"(4.697144,-74.140516)"
2017,Marzo,Eslovenia,705,0,6,6,"(6.171601,-75.427454)"
2015,Septiembre,Hong Kong,344,3,0,3,"(4.697144,-74.140516)"
2018,Julio,China,156,6,10,16,"(0.814836,-77.662532)"
2016,Febrero,Chile,152,127,168,295,"(0.814836,-77.662532)"
2019,Septiembre,Antigua y Barbuda,28,0,1,1,"(10.445761,-75.516429)"
2021,Octubre,El Salvador,222,20,30,50,"(3.541112,-76.384584)"
2013,Febrero,Australia,36,7,15,22,"(10.886611,-74.776708)"
2015,Marzo,Papúa Nueva Guinea,598,0,3,3,"(4.697144,-74.140516)"
2022,Diciembre,Malasia,458,1,0,1,"(6.171601,-75.427454)"
2018,Agosto,Canadá,124,4,13,17,"(0.814836,-77.662532)"
2023,Junio,Lituania,440,1,0,1,"(3.541112,-76.384584)"
2017,Noviembre,Bélgica,56,2,1,3,"(10.408582,-75.538003)"
2012,Abril,Argelia,12,1,3,4,"(4.697144,-74.140516)"
2019,Agosto,Vietnam,704,1,0,1,"(10.445761,-75.516429)"
2016,Abril,Estados Unidos de América,840,11,19,30,"(12.5744111,-81.703935)"
2016,Agosto,Granada,308,0,1,1,"(10.445761,-75.516429)"
2017,Diciembre,Brasil,76,1,1,2,"(0.25129,-76.875963)"
2014,Febrero,Rumania,642,0,1,1,"(-4.197703,-69.941278)"
2013,Enero,Estados Unidos de América,840,72,112,184,"(4.815061,-75.736532)"
2022,Noviembre,Irán,364,0,1,1,"(6.171601,-75.427454)"
2020,Febrero,Alemania,276,23,32,55,"(8.635765,-77.346578)"
2015,Marzo,Italia,380,7,27,34,"(7.818934,-72.453226)"
2021,Agosto,Federación de Rusia,643,0,1,1,"(11.247723,-74.213989)"
2018,Septiembre,Venezuela,862,3,3,6,"(4.452882,-75.766298)"
2018,Agosto,Paraguay,600,0,1,1,"(8.36068,-72.409396)"
2017,Julio,Estados Unidos de América,840,43,42,85,"(10.408582,-75.538003)"
2015,Febrero,Panamá,591,2,9,11,"(0.814836,-77.662532)"
2019,Enero,Australia,36,4,12,16,"(10.886611,-74.776708)"
2015,Agosto,Rumania,642,41,65,106,"(4.697144,-74.140516)"
2014,Diciembre,Alemania,276,94,139,233,"(6.171601,-75.427454)"
2014,Junio,Japón,392,0,1,1,"(-4.197703,-69.941278)"
2012,Marzo,Francia,250,825,1680,2505,"(4.697144,-74.140516)"
2016,Abril,Botsuana,72,0,4,4,"(4.697144,-74.140516)"
2012,Septiembre,Mongolia,496,1,0,1,"(4.697144,-74.140516)"
2015,Diciembre,Hong Kong,344,1,0,1,"(10.445761,-75.516429)"
2019,Junio,Costa Rica,188,27,42,69,"(3.541112,-76.384584)"
2012,Abril,Estonia,233,1,0,1,"(3.541112,-76.384584)"
2022,Febrero,Polonia,616,2,12,14,"(3.541112,-76.384584)"
2020,Marzo,Costa Rica,188,0,2,2,"(7.128456,-73.183637)"
2023,Junio,Haití,332,2,10,12,"(6.171601,-75.427454)"
2018,Junio,Kirguistán,417,0,2,2,"(6.171601,-75.427454)"
2012,Agosto,República de Belarús,112,0,1,1,"(4.697144,-74.140516)"
2015,Diciembre,Filipinas,608,0,22,22,"(10.971302,-74.765397)"
2016,Junio,Dinamarca,208,0,3,3,"(10.886611,-74.776708)"
2015,Enero,Polonia,616,3,8,11,"(10.445761,-75.516429)"
2019,Diciembre,Eslovaquia,703,1,0,1,"(11.247723,-74.213989)"
2019,Agosto,Desconocido,99999,67,129,196,"(4.697144,-74.140516)"
2019,Enero,República de Irlanda,372,2,10,12,"(10.886611,-74.776708)"
2022,Diciembre,Reino Unido de Gran Bretaña e Irlanda del Norte,826,36,24,60,"(8.635765,-77.346578)"
2018,Abril,Alemania,276,0,4,4,"(3.893038,-77.067921)"
2017,Junio,Tailandia,764,0,2,2,"(6.171601,-75.427454)"
2021,Agosto,China,156,1,0,1,"(7.818934,-72.453226)"
2014,Abril,Polonia,616,6,6,12,"(0.814836,-77.662532)"
2022,Diciembre,Uruguay,858,3,4,7,"(4.452882,-75.766298)"
2018,Enero,Estados Unidos de América,840,0,2,2,"(1.813928,-78.763924)"
2016,Enero,Bangladesh,50,0,1,1,"(3.541112,-76.384584)"
2019,Octubre,Croacia,191,17,49,66,"(4.697144,-74.140516)"
2019,Abril,Estados Unidos de América,840,1,2,3,"(8.36068,-72.409396)"
2015,Diciembre,Chile,152,5,10,15,"(10.886611,-74.776708)"
2014,Septiembre,Nepal,524,0,1,1,"(4.697144,-74.140516)"
2017,Enero,Costa Rica,188,0,1,1,"(8.635765,-77.346578)"
2022,Noviembre,Tailandia,764,1,0,1,"(10.445761,-75.516429)"
2021,Febrero,Letonia,428,2,1,3,"(4.697144,-74.140516)"
2013,Abril,México,484,43,164,207,"(3.541112,-76.384584)"
2014,Febrero,Nicaragua,558,0,1,1,"(10.886611,-74.776708)"
2022,Enero,República de Irlanda,372,0,1,1,"(10.886611,-74.776708)"
2016,Octubre,Nicaragua,558,2,4,6,"(4.815061,-75.736532)"
2015,Diciembre,Indonesia,360,22,30,52,"(4.697144,-74.140516)"
2016,Febrero,Brasil,76,0,4,4,"(7.128456,-73.183637)"
2016,Septiembre,Ecuador,218,2,2,4,"(0.812436,-77.847006)"
2018,Junio,Canadá,124,15,12,27,"(0.814836,-77.662532)"
2019,Octubre,República de Belarús,112,5,9,14,"(4.697144,-74.140516)"
2022,Julio,Vietnam,704,0,1,1,"(12.586067,-81.702563)"
2020,Diciembre,Portugal,620,4,1,5,"(10.445761,-75.516429)"
2013,Agosto,Suecia,752,1,1,2,"(-4.197703,-69.941278)"
2012,Febrero,Singapur,702,1,14,15,"(4.697144,-74.140516)"
2019,Octubre,Estados Unidos de América,840,2346,6924,9270,"(6.171601,-75.427454)"
2012,Noviembre,Uruguay,858,1,0,1,"(4.815061,-75.736532)"
2019,Abril,Brasil,76,330,260,590,"(12.586067,-81.702563)"
2019,Diciembre,Paraguay,600,1,0,1,"(7.818934,-72.453226)"
2015,Noviembre,Ecuador,218,13,26,39,"(10.886611,-74.776708)"
2019,Abril,España,724,0,1,1,"(12.5744111,-81.703935)"
2019,Agosto,Macedonia,807,0,4,4,"(6.171601,-75.427454)"
2022,Febrero,Nicaragua,558,8,5,13,"(10.445761,-75.516429)"
2022,Febrero,Nicaragua,558,0,1,1,"(1.813928,-78.763924)"
2020,Diciembre,Filipinas,608,0,12,12,"(10.971302,-74.765397)"
2022,Febrero,Cuba,192,6,8,14,"(10.886611,-74.776708)"
2023,Febrero,Filipinas,608,10,109,119,"(10.445761,-75.516429)"
2018,Agosto,Nicaragua,558,1,5,6,"(10.886611,-74.776708)"
2020,Octubre,Países Bajos,528,176,234,410,"(4.697144,-74.140516)"
2017,Enero,Portugal,620,1,0,1,"(12.586067,-81.702563)"
2018,Marzo,República Checa,203,1,1,2,"(0.25129,-76.875963)"
2022,Junio,Perú,604,0,2,2,"(7.128456,-73.183637)"
2013,Agosto,Italia,380,6,6,12,"(8.635765,-77.346578)"
2015,Octubre,Suiza,756,0,2,2,"(12.586067,-81.702563)"
2018,Noviembre,Dominica,212,0,1,1,"(3.541112,-76.384584)"
2012,Enero,Paraguay,600,0,2,2,"(7.818934,-72.453226)"
2015,Mayo,República de Kosovo,901,0,1,1,"(6.171601,-75.427454)"
2016,Junio,Túnez,788,3,3,6,"(4.697144,-74.140516)"
2013,Abril,República Dominicana,214,0,3,3,"(10.408582,-75.538003)"
2016,Marzo,Noruega,578,135,195,330,"(4.697144,-74.140516)"
2012,Marzo,Perú,604,157,382,539,"(0.814836,-77.662532)"
2022,Diciembre,Países Bajos,528,1,7,8,"(11.360009,-72.129330)"
2014,Noviembre,Canadá,124,31,24,55,"(0.814836,-77.662532)"
2019,Diciembre,Panamá,591,1,15,16,"(10.408582,-75.538003)"
2018,Diciembre,Francia,250,3,3,6,"(11.117806,-74.232622)"
2022,Mayo,Albania,8,0,1,1,"(3.541112,-76.384584)"
2013,Noviembre,Países Bajos,528,0,1,1,"(0.814836,-77.662532)"
2015,Abril,Francia,250,0,1,1,"(12.5744111,-81.703935)"
2020,Septiembre,Uruguay,858,0,2,2,"(6.171601,-75.427454)"
2015,Julio,Trinidad y Tobago,780,0,8,8,"(10.408582,-75.538003)"
2023,Marzo,India,356,0,48,48,"(10.971302,-74.765397)"
2019,Septiembre,Brasil,76,232,166,398,"(12.586067,-81.702563)"
2016,Marzo,República Checa,203,4,4,8,"(0.814836,-77.662532)"
2014,Julio,Brasil,76,2,0,2,"(7.128456,-73.183637)"
2012,Diciembre,Argentina,32,61,95,156,"(3.541112,-76.384584)"
2018,Noviembre,Qatar,634,1,0,1,"(0.814836,-77.662532)"
2016,Julio,Surinam,740,7,15,22,"(4.697144,-74.140516)"
2013,Diciembre,Georgia,268,1,0,1,"(0.814836,-77.662532)"
2016,Noviembre,Nicaragua,558,59,17,76,"(10.445761,-75.516429)"
2017,Julio,Finlandia,246,4,12,16,"(6.171601,-75.427454)"
2014,Octubre,España,724,0,1,1,"(1.813928,-78.763924)"
2015,Agosto,Perú,604,2,3,5,"(7.088729,-70.740253)"
2021,Julio,Liberia,430,0,1,1,"(4.697144,-74.140516)"
2017,Noviembre,Japón,392,0,1,1,"(12.586067,-81.702563)"
2013,Diciembre,Estados Unidos de América,840,1434,2241,3675,"(3.541112,-76.384584)"
2019,Julio,Suecia,752,0,1,1,"(7.088729,-70.740253)"
2015,Junio,España,724,0,2,2,"(7.088729,-70.740253)"
2018,Mayo,Dinamarca,208,2,6,8,"(-4.223468,-69.945098)"
2023,Enero,San Cristóbal y Nevis,659,2,2,4,"(10.445761,-75.516429)"
2016,Febrero,China,156,1,1,2,"(-4.197703,-69.941278)"
2012,Octubre,Suiza,756,7,11,18,"(10.445761,-75.516429)"
2014,Diciembre,Líbano,422,1,1,2,"(3.541112,-76.384584)"
2018,Agosto,Egipto,818,0,1,1,"(6.171601,-75.427454)"
2015,Octubre,Surinam,740,7,15,22,"(4.697144,-74.140516)"
2017,Abril,México,484,62,67,129,"(10.886611,-74.776708)"
2020,Noviembre,Burkina Faso,854,0,1,1,"(4.697144,-74.140516)"
2016,Enero,Paraguay,600,1,0,1,"(8.635765,-77.346578)"
2020,Febrero,Federación de Rusia,643,24,18,42,"(6.171601,-75.427454)"
2014,Mayo,República Checa,203,1,0,1,"(10.408582,-75.538003)"
2017,Diciembre,Estados Unidos de América,840,90,98,188,"(12.586067,-81.702563)"
2021,Marzo,Filipinas,608,0,29,29,"(3.893038,-77.067921)"
2019,Noviembre,Cuba,192,31,40,71,"(6.171601,-75.427454)"
2017,Junio,Venezuela,862,655,933,1588,"(0.814836,-77.662532)"
2022,Marzo,Albania,8,0,1,1,"(10.445761,-75.516429)"
2021,Diciembre,México,484,11,23,34,"(7.128456,-73.183637)"
2020,Octubre,Brasil,76,2,4,6,"(-4.197703,-69.941278)"
2022,Febrero,Brasil,76,9,3,12,"(4.815061,-75.736532)"
2015,Octubre,Austria,40,7,22,29,"(6.171601,-75.427454)"
2015,Septiembre,Serbia,688,1,1,2,"(6.171601,-75.427454)"
2023,Mayo,República de Belarús,112,0,1,1,"(10.445761,-75.516429)"
2023,Febrero,Austria,40,0,1,1,"(7.128456,-73.183637)"
2015,Julio,España,724,1,4,5,"(8.635765,-77.346578)"
2019,Febrero,Venezuela,862,23,17,40,"(3.866713,-67.927521)"
2016,Diciembre,Sudáfrica,710,0,1,1,"(-4.197703,-69.941278)"
2018,Febrero,Suiza,756,44,38,82,"(0.814836,-77.662532)"
2018,Octubre,Jamaica,388,0,1,1,"(10.408582,-75.538003)"
2016,Diciembre,Finlandia,246,8,15,23,"(10.445761,-75.516429)"
2015,Agosto,República de Belarús,112,7,4,11,"(4.697144,-74.140516)"
2017,Julio,Argentina,32,220,186,406,"(12.586067,-81.702563)"
2014,Junio,Perú,604,0,1,1,"(6.185799,-67.483929)"
2014,Diciembre,Suecia,752,309,447,756,"(4.697144,-74.140516)"
2021,Noviembre,Eslovenia,705,3,25,28,"(4.697144,-74.140516)"
2023,Enero,Brasil,76,1,0,1,"(7.088729,-70.740253)"
2015,Agosto,Argentina,32,1,0,1,"(1.813928,-78.763924)"
2013,Diciembre,Honduras,340,17,21,38,"(3.541112,-76.384584)"
2013,Diciembre,Chile,152,88,145,233,"(3.541112,-76.384584)"
2012,Febrero,Perú,604,8,22,30,"(10.886611,-74.776708)"
2016,Noviembre,Filipinas,608,0,14,14,"(10.971302,-74.765397)"
2018,Julio,México,484,39,62,101,"(10.408582,-75.538003)"
2022,Diciembre,Honduras,340,0,3,3,"(8.635765,-77.346578)"
2021,Septiembre,España,724,38,59,97,"(10.445761,-75.516429)"
2015,Agosto,Perú,604,74,113,187,"(7.818934,-72.453226)"
2019,Noviembre,Nueva Zelanda,554,8,14,22,"(10.445761,-75.516429)"
2016,Mayo,Suiza,756,5,2,7,"(12.586067,-81.702563)"
2019,Diciembre,Nigeria,566,0,1,1,"(6.171601,-75.427454)"
2014,Julio,Guyana,328,3,10,13,"(4.697144,-74.140516)"
2013,Julio,Taiwán,158,3,2,5,"(4.697144,-74.140516)"
2023,Febrero,Canadá,124,6,8,14,"(4.452882,-75.766298)"
2015,Diciembre,Países Bajos,528,62,146,208,"(3.541112,-76.384584)"
2016,Noviembre,Alemania,276,1,2,3,"(13.3387613,-81.372937)"
2012,Mayo,Honduras,340,1,0,1,"(7.927209,-72.507910)"
2017,Enero,Costa Rica,188,55,118,173,"(3.541112,-76.384584)"
2021,Junio,Andorra,20,0,3,3,"(4.697144,-74.140516)"
2022,Junio,República de Armenia,51,2,0,2,"(4.697144,-74.140516)"
2013,Febrero,Ecuador,218,0,1,1,"(-4.197703,-69.941278)"
2016,Enero,Bélgica,56,1,2,3,"(11.247723,-74.213989)"
2019,Octubre,Bolivia,68,1,2,3,"(7.818934,-72.453226)"
2018,Julio,Rwanda,646,0,1,1,"(3.541112,-76.384584)"
2023,Mayo,Brasil,76,2,3,5,"(7.128456,-73.183637)"
2018,Noviembre,Malawi,454,1,1,2,"(4.697144,-74.140516)"
2016,Febrero,Venezuela,862,0,8,8,"(12.586067,-81.702563)"
2017,Abril,Suecia,752,3,3,6,"(3.541112,-76.384584)"
2016,Agosto,República Dominicana,214,11,21,32,"(0.814836,-77.662532)"
2017,Abril,Montenegro,499,0,1,1,"(3.541112,-76.384584)"
2018,Enero,Luxemburgo,442,1,0,1,"(0.814836,-77.662532)"
2022,Abril,Nueva Zelanda,554,0,2,2,"(8.635765,-77.346578)"
2019,Marzo,Lituania,440,2,1,3,"(0.814836,-77.662532)"
2013,Abril,Venezuela,862,5,24,29,"(10.433609,-73.247863)"
2012,Octubre,España,724,0,3,3,"(4.815061,-75.736532)"
2018,Abril,Países Bajos,528,2,3,5,"(0.25129,-76.875963)"
2017,Noviembre,Tailandia,764,0,2,2,"(6.171601,-75.427454)"
2018,Junio,España,724,3,1,4,"(8.36068,-72.409396)"
2023,Junio,Portugal,620,2,8,10,"(11.360009,-72.129330)"
2016,Abril,Australia,36,37,53,90,"(10.445761,-75.516429)"
2018,Enero,España,724,1,0,1,"(6.185799,-67.483929)"
2012,Mayo,Venezuela,862,56,92,148,"(10.886611,-74.776708)"
2014,Agosto,Zambia,894,1,1,2,"(4.697144,-74.140516)"
2017,Junio,Lituania,440,0,1,1,"(10.445761,-75.516429)"
2013,Septiembre,República Checa,203,1,3,4,"(6.171601,-75.427454)"
2018,Diciembre,Croacia,191,7,12,19,"(10.445761,-75.516429)"
2023,Marzo,Polonia,616,0,5,5,"(10.971302,-74.765397)"
2023,Mayo,Bélgica,56,1,0,1,"(8.364293,-72.405710)"
2022,Marzo,Nicaragua,558,19,22,41,"(6.171601,-75.427454)"
2013,Febrero,República Dominicana,214,289,390,679,"(4.697144,-74.140516)"
2015,Julio,Bélgica,56,35,48,83,"(6.171601,-75.427454)"
2020,Febrero,Indonesia,360,0,5,5,"(0.814836,-77.662532)"
2014,Septiembre,Honduras,340,0,1,1,"(8.635765,-77.346578)"
2018,Octubre,Afganistán,4,0,1,1,"(4.697144,-74.140516)"
2012,Marzo,Costa Rica,188,1,0,1,"(12.5744111,-81.703935)"
2015,Agosto,Dinamarca,208,1,4,5,"(0.814836,-77.662532)"
2020,Octubre,Argentina,32,4,17,21,"(10.445761,-75.516429)"
2015,Enero,Kenia,404,1,0,1,"(6.171601,-75.427454)"
2020,Enero,China,156,4,17,21,"(3.541112,-76.384584)"
2014,Enero,Croacia,191,1,0,1,"(0.814836,-77.662532)"
2020,Diciembre,Argentina,32,23,57,80,"(6.171601,-75.427454)"
2016,Febrero,Noruega,578,0,13,13,"(10.408582,-75.538003)"
2015,Enero,Hungría,348,1,8,9,"(6.171601,-75.427454)"
2021,Septiembre,Italia,380,33,52,85,"(11.360009,-72.129330)"
2021,Marzo,Malasia,458,1,4,5,"(4.697144,-74.140516)"
2017,Noviembre,Estados Unidos de América,840,4,2,6,"(8.635765,-77.346578)"
2022,Febrero,México,484,4,17,21,"(4.815061,-75.736532)"
2014,Marzo,Noruega,578,61,116,177,"(4.697144,-74.140516)"
2015,Octubre,República Dominicana,214,0,1,1,"(8.635765,-77.346578)"
2019,Julio,Nueva Zelanda,554,13,19,32,"(10.445761,-75.516429)"
2016,Abril,Suecia,752,34,29,63,"(0.814836,-77.662532)"
2018,Julio,Grecia,300,0,2,2,"(7.818934,-72.453226)"
2015,Abril,Federación de Rusia,643,12,9,21,"(0.814836,-77.662532)"
2015,Octubre,Filipinas,608,0,4,4,"(1.813928,-78.763924)"
2022,Marzo,Bangladesh,50,1,0,1,"(6.171601,-75.427454)"
2013,Mayo,Reino Unido de Gran Bretaña e Irlanda del Norte,826,0,3,3,"(10.886611,-74.776708)"
2019,Marzo,Federación de Rusia,643,29,36,65,"(10.445761,-75.516429)"
2018,Marzo,Belice,84,8,14,22,"(4.697144,-74.140516)"
2021,Septiembre,Eslovaquia,703,1,6,7,"(10.445761,-75.516429)"
2018,Febrero,Honduras,340,0,1,1,"(4.452882,-75.766298)"
2019,Febrero,Portugal,620,4,10,14,"(7.818934,-72.453226)"
2013,Marzo,Jordania,400,1,0,1,"(12.586067,-81.702563)"
2019,Agosto,Francia,250,0,4,4,"(11.360009,-72.129330)"
2015,Septiembre,Ucrania,804,0,4,4,"(10.445761,-75.516429)"
2014,Julio,Luxemburgo,442,0,1,1,"(3.541112,-76.384584)"
2016,Diciembre,República de Corea,410,0,1,1,"(7.128456,-73.183637)"
2017,Marzo,Brasil,76,6,12,18,"(7.818934,-72.453226)"
2017,Julio,Estados Unidos de América,840,290,377,667,"(4.815061,-75.736532)"
2019,Octubre,Guyana,328,1,1,2,"(10.445761,-75.516429)"
2013,Junio,Trinidad y Tobago,780,3,8,11,"(6.171601,-75.427454)"
2012,Noviembre,Finlandia,246,4,0,4,"(0.814836,-77.662532)"
2021,Octubre,Marruecos,504,1,1,2,"(6.171601,-75.427454)"
2018,Diciembre,Honduras,340,0,1,1,"(1.813928,-78.763924)"
2012,Diciembre,Brasil,76,18,24,42,"(11.360009,-72.129330)"
2017,Enero,Estados Unidos de América,840,0,1,1,"(7.102626,-77.762647)"
2014,Septiembre,El Salvador,222,23,53,76,"(6.171601,-75.427454)"
2021,Septiembre,Haití,332,1,5,6,"(6.171601,-75.427454)"
2016,Octubre,Belice,84,6,16,22,"(4.697144,-74.140516)"
2019,Julio,Argentina,32,21,43,64,"(10.886611,-74.776708)"
2020,Noviembre,Marruecos,504,1,1,2,"(6.171601,-75.427454)"
2017,Abril,República de Corea,410,202,452,654,"(4.697144,-74.140516)"
2022,Agosto,Albania,8,0,3,3,"(10.445761,-75.516429)"
2017,Abril,Trinidad y Tobago,780,7,13,20,"(10.445761,-75.516429)"
2021,Mayo,El Salvador,222,136,176,312,"(4.697144,-74.140516)"
2013,Julio,Hungría,348,1,0,1,"(10.408582,-75.538003)"
2013,Noviembre,Uruguay,858,6,9,15,"(0.814836,-77.662532)"
2015,Julio,Australia,36,37,54,91,"(3.541112,-76.384584)"
2013,Junio,México,484,19,56,75,"(10.886611,-74.776708)"
2019,Marzo,Hungría,348,0,1,1,"(3.541112,-76.384584)"
2012,Abril,Austria,40,0,1,1,"(11.247723,-74.213989)"
2019,Noviembre,España,724,20,33,53,"(0.814836,-77.662532)"
2016,Marzo,China,156,2,6,8,"(0.814836,-77.662532)"
2014,Enero,Filipinas,608,0,3,3,"(10.971302,-74.765397)"
2014,Septiembre,Países Bajos,528,1,4,5,"(7.818934,-72.453226)"
2022,Agosto,Estados Unidos de América,840,2,3,5,"(7.088729,-70.740253)"
2021,Enero,Pakistán,586,0,1,1,"(10.445761,-75.516429)"
2021,Marzo,República Checa,203,0,7,7,"(10.445761,-75.516429)"
2014,Noviembre,Islandia,352,0,1,1,"(8.635765,-77.346578)"
2015,Julio,Montenegro,499,0,1,1,"(10.445761,-75.516429)"
2023,Marzo,China,156,37,41,78,"(10.445761,-75.516429)"
2016,Abril,Trinidad y Tobago,780,0,4,4,"(6.171601,-75.427454)"
2017,Agosto,Hong Kong,344,2,1,3,"(0.814836,-77.662532)"
2021,Octubre,Nicaragua,558,44,48,92,"(4.697144,-74.140516)"
2016,Abril,Ghana,288,0,1,1,"(3.541112,-76.384584)"
2012,Noviembre,Estados Unidos de América,840,579,1048,1627,"(3.541112,-76.384584)"
2022,Diciembre,Islandia,352,2,3,5,"(3.541112,-76.384584)"
2015,Agosto,Ecuador,218,2,3,5,"(7.088729,-70.740253)"
2012,Octubre,Dominica,212,1,0,1,"(3.541112,-76.384584)"
2022,Marzo,Guatemala,320,264,276,540,"(10.445761,-75.516429)"
2016,Febrero,Austria,40,6,2,8,"(10.408582,-75.538003)"
2022,Junio,Etiopia,231,3,24,27,"(4.697144,-74.140516)"
2015,Agosto,República Dominicana,214,0,3,3,"(1.813928,-78.763924)"
2019,Julio,Kenia,404,10,6,16,"(4.697144,-74.140516)"
2016,Febrero,Dinamarca,208,172,253,425,"(4.697144,-74.140516)"
2021,Agosto,Italia,380,3,8,11,"(7.088729,-70.740253)"
2016,Septiembre,Reino Unido de Gran Bretaña e Irlanda del Norte,826,17,22,39,"(10.408582,-75.538003)"
2014,Noviembre,Indonesia,360,0,1,1,"(7.818934,-72.453226)"
2017,Noviembre,Israel,376,2,10,12,"(3.541112,-76.384584)"
2015,Enero,Federación de Rusia,643,2,1,3,"(12.586067,-81.702563)"
2017,Septiembre,Chile,152,307,269,576,"(10.445761,-75.516429)"
2019,Diciembre,Francia,250,7,12,19,"(12.586067,-81.702563)"
2019,Agosto,Alemania,276,230,328,558,"(6.171601,-75.427454)"
2013,Enero,India,356,0,5,5,"(0.814836,-77.662532)"
2018,Abril,India,356,0,9,9,"(10.408582,-75.538003)"
2012,Marzo,Uruguay,858,0,5,5,"(10.886611,-74.776708)"
2023,Enero,Chile,152,623,696,1319,"(6.171601,-75.427454)"
2021,Noviembre,Paraguay,600,16,78,94,"(10.886611,-74.776708)"
2013,Septiembre,Suiza,756,1,4,5,"(8.635765,-77.346578)"
2017,Diciembre,Portugal,620,216,427,643,"(4.697144,-74.140516)"
2016,Noviembre,México,484,4,4,8,"(11.360009,-72.129330)"
2021,Agosto,Trinidad y Tobago,780,2,5,7,"(10.445761,-75.516429)"
2013,Diciembre,Portugal,620,2,3,5,"(10.408582,-75.538003)"
2017,Marzo,China,156,2,1,3,"(7.128456,-73.183637)"
2015,Abril,República de Armenia,51,4,2,6,"(4.697144,-74.140516)"
2018,Junio,Mauricio,480,0,1,1,"(6.171601,-75.427454)"
2015,Abril,Uganda,800,2,0,2,"(3.541112,-76.384584)"
2013,Julio,El Salvador,222,482,778,1260,"(4.697144,-74.140516)"
2018,Septiembre,España,724,2,7,9,"(11.360009,-72.129330)"
2017,Agosto,Ucrania,804,0,2,2,"(3.893038,-77.067921)"
2015,Julio,Ecuador,218,12,11,23,"(11.360009,-72.129330)"
2015,Diciembre,Nicaragua,558,7,13,20,"(10.445761,-75.516429)"
2019,Abril,Suiza,756,23,17,40,"(0.814836,-77.662532)"
2019,Octubre,Croacia,191,0,2,2,"(3.541112,-76.384584)"
2016,Marzo,Guatemala,320,522,768,1290,"(4.697144,-74.140516)"
2021,Enero,Filipinas,608,3,28,31,"(10.445761,-75.516429)"
2022,Enero,Brasil,76,8,18,26,"(10.886611,-74.776708)"
2023,Marzo,San  Vicente y las Granadinas,670,1,0,1,"(10.445761,-75.516429)"
2022,Julio,Noruega,578,151,178,329,"(4.697144,-74.140516)"
2012,Diciembre,Túnez,788,0,2,2,"(4.697144,-74.140516)"
2016,Febrero,Nueva Zelanda,554,4,5,9,"(8.635765,-77.346578)"
2013,Julio,Cuba,192,1,0,1,"(10.408582,-75.538003)"
2022,Julio,Ucrania,804,0,6,6,"(10.886611,-74.776708)"
2015,Septiembre,Georgia,268,1,2,3,"(6.171601,-75.427454)"
2018,Diciembre,Argentina,32,2956,4242,7198,"(4.697144,-74.140516)"
2016,Diciembre,República de Corea,410,278,414,692,"(4.697144,-74.140516)"
2022,Mayo,Venezuela,862,178,149,327,"(7.088729,-70.740253)"
2015,Junio,Australia,36,13,12,25,"(3.541112,-76.384584)"
2013,Mayo,Argentina,32,162,127,289,"(12.586067,-81.702563)"
2018,Julio,Austria,40,2,5,7,"(8.635765,-77.346578)"
2012,Junio,Jamaica,388,2,7,9,"(12.586067,-81.702563)"
2021,Enero,India,356,4,13,17,"(6.171601,-75.427454)"
2022,Junio,Noruega,578,1,2,3,"(12.586067,-81.702563)"
2018,Agosto,Ucrania,804,28,38,66,"(4.697144,-74.140516)"
2016,Agosto,China,156,0,1,1,"(4.452882,-75.766298)"
2018,Agosto,Francia,250,0,5,5,"(4.452882,-75.766298)"
2018,Marzo,República de Corea,410,0,4,4,"(11.247723,-74.213989)"
2018,Junio,Suecia,752,0,1,1,"(8.36068,-72.409396)"
2018,Noviembre,España,724,7,7,14,"(12.586067,-81.702563)"
2022,Febrero,Qatar,634,0,1,1,"(4.815061,-75.736532)"
2015,Agosto,Venezuela,862,1,1,2,"(-4.197703,-69.941278)"
2013,Noviembre,Perú,604,210,436,646,"(6.171601,-75.427454)"
2013,Enero,República Dominicana,214,15,84,99,"(10.886611,-74.776708)"
2015,Junio,Estados Unidos de América,840,9491,14616,24107,"(4.697144,-74.140516)"
2013,Noviembre,Venezuela,862,4,3,7,"(12.586067,-81.702563)"
2022,Abril,Dinamarca,208,0,1,1,"(7.128456,-73.183637)"
2019,Diciembre,Noruega,578,28,32,60,"(6.171601,-75.427454)"
2012,Octubre,Isla de Man,833,35,95,130,"(4.697144,-74.140516)"
2012,Julio,República Checa,203,0,3,3,"(4.697144,-74.140516)"
2021,Abril,India,356,0,1,1,"(11.247723,-74.213989)"
2022,Octubre,Federación de Rusia,643,0,4,4,"(10.886611,-74.776708)"
2013,Abril,Bahamas,44,0,1,1,"(6.171601,-75.427454)"
2014,Diciembre,México,484,3360,5272,8632,"(4.697144,-74.140516)"
2016,Octubre,Trinidad y Tobago,780,0,7,7,"(6.171601,-75.427454)"
2019,Enero,Myanmar,104,0,3,3,"(10.971302,-74.765397)"
2021,Marzo,Federación de Rusia,643,0,3,3,"(10.408582,-75.538003)"
2016,Marzo,Islas Fiji,242,0,1,1,"(4.697144,-74.140516)"
2023,Mayo,República de Irlanda,372,1,1,2,"(-4.223468,-69.945098)"
2020,Enero,Austria,40,251,371,622,"(4.697144,-74.140516)"
2012,Octubre,España,724,2,7,9,"(10.408582,-75.538003)"
2023,Enero,Paraguay,600,1,2,3,"(7.818934,-72.453226)"
2012,Octubre,Zimbabue,716,1,0,1,"(4.697144,-74.140516)"
2018,Enero,Reino Unido de Gran Bretaña e Irlanda del Norte,826,6,6,12,"(-4.223468,-69.945098)"
2013,Diciembre,Cuba,192,7,11,18,"(10.886611,-74.776708)"
2018,Septiembre,Mongolia,496,4,5,9,"(4.697144,-74.140516)"
2013,Septiembre,Togo,768,0,4,4,"(4.697144,-74.140516)"
2020,Enero,Suecia,752,3,5,8,"(11.247723,-74.213989)"
2013,Julio,República de Irlanda,372,1,1,2,"(8.635765,-77.346578)"
2013,Noviembre,Uruguay,858,0,1,1,"(7.927209,-72.507910)"
2019,Enero,Honduras,340,4,0,4,"(7.128456,-73.183637)"
2018,Octubre,Zimbabue,716,0,1,1,"(10.445761,-75.516429)"
2016,Noviembre,Australia,36,18,15,33,"(8.635765,-77.346578)"
2015,Mayo,Japón,392,9,30,39,"(6.171601,-75.427454)"
2020,Marzo,Venezuela,862,6,19,25,"(4.815061,-75.736532)"
2023,Febrero,Bélgica,56,3,8,11,"(3.541112,-76.384584)"
2017,Enero,Turquía,792,1,1,2,"(4.815061,-75.736532)"
2021,Noviembre,México,484,3420,5618,9038,"(4.697144,-74.140516)"
2023,Mayo,Bosnia y Herzegovina,70,4,12,16,"(4.697144,-74.140516)"
2019,Septiembre,Noruega,578,5,12,17,"(6.171601,-75.427454)"
2019,Junio,Kazajistán,398,1,1,2,"(6.171601,-75.427454)"
2016,Octubre,Costa Rica,188,94,72,166,"(12.586067,-81.702563)"
2013,Octubre,España,724,0,1,1,"(6.185799,-67.483929)"
2015,Junio,Dinamarca,208,0,1,1,"(-4.197703,-69.941278)"
2017,Septiembre,Sudáfrica,710,2,6,8,"(10.445761,-75.516429)"
2017,Noviembre,Chile,152,140,148,288,"(3.541112,-76.384584)"
2019,Mayo,España,724,1,2,3,"(7.128456,-73.183637)"
2022,Mayo,Panamá,591,551,516,1067,"(10.445761,-75.516429)"
2015,Diciembre,Arabia Saudita,682,2,24,26,"(4.697144,-74.140516)"
2014,Enero,Panamá,591,5,2,7,"(0.814836,-77.662532)"
2018,Agosto,Suiza,756,10,15,25,"(10.408582,-75.538003)"
2022,Noviembre,Kenia,404,1,0,1,"(10.886611,-74.776708)"
2022,Mayo,Suiza,756,1,3,4,"(11.247723,-74.213989)"
2023,Mayo,Desconocido,99999,5,5,10,"(10.445761,-75.516429)"
2022,Abril,Bolivia,68,3,9,12,"(10.886611,-74.776708)"
2020,Diciembre,República Dominicana,214,15,20,35,"(10.886611,-74.776708)"
2015,Septiembre,China,156,28,56,84,"(6.171601,-75.427454)"
2013,Mayo,Israel,376,6,15,21,"(3.541112,-76.384584)"
2013,Mayo,República de Irlanda,372,0,1,1,"(3.541112,-76.384584)"
2022,Junio,México,484,5850,7465,13315,"(4.697144,-74.140516)"
2015,Septiembre,República Checa,203,1,1,2,"(10.408582,-75.538003)"
2017,Abril,Brasil,76,0,2,2,"(8.36068,-72.409396)"
2015,Abril,Austria,40,2,8,10,"(3.541112,-76.384584)"
2019,Julio,Jamaica,388,9,8,17,"(6.171601,-75.427454)"
2014,Noviembre,Desconocido,99999,0,3,3,"(3.541112,-76.384584)"
2016,Marzo,México,484,0,1,1,"(6.228046,-77.404104)"
2012,Abril,Israel,376,3,9,12,"(3.541112,-76.384584)"
2016,Junio,Camerún,120,0,1,1,"(0.814836,-77.662532)"
2022,Noviembre,Venezuela,862,2134,2079,4213,"(11.360009,-72.129330)"
2019,Diciembre,Alemania,276,2,7,9,"(7.818934,-72.453226)"
2023,Mayo,Turquía,792,0,1,1,"(11.360009,-72.129330)"
2023,Junio,Venezuela,862,454,376,830,"(8.36068,-72.409396)"
2014,Septiembre,Chile,152,2,0,2,"(0.25129,-76.875963)"
2014,Octubre,Ecuador,218,2,8,10,"(7.927209,-72.507910)"
2013,Diciembre,Chipre,196,0,8,8,"(4.697144,-74.140516)"
2018,Mayo,Nigeria,566,0,3,3,"(6.171601,-75.427454)"
2019,Febrero,Serbia,688,1,5,6,"(6.171601,-75.427454)"
2013,Mayo,Estados Unidos de América,840,3,5,8,"(11.247723,-74.213989)"
2022,Marzo,El Salvador,222,0,1,1,"(0.814836,-77.662532)"
2012,Mayo,Indonesia,360,1,0,1,"(6.171601,-75.427454)"
2015,Julio,Chile,152,82,69,151,"(12.586067,-81.702563)"
2019,Abril,Guinea,324,0,1,1,"(4.697144,-74.140516)"
2014,Diciembre,Federación de Rusia,643,1,1,2,"(-4.197703,-69.941278)"
2015,Diciembre,Francia,250,14,21,35,"(10.408582,-75.538003)"
2019,Abril,Francia,250,1,2,3,"(12.5744111,-81.703935)"
2018,Julio,Montenegro,499,0,2,2,"(6.171601,-75.427454)"
2014,Junio,Croacia,191,6,42,48,"(4.697144,-74.140516)"
2013,Septiembre,Chile,152,9,23,32,"(10.886611,-74.776708)"
2019,Junio,Argentina,32,6,7,13,"(4.815061,-75.736532)"
2021,Abril,Estados Unidos de América,840,66,138,204,"(7.128456,-73.183637)"
2012,Enero,Venezuela,862,3,1,4,"(7.128456,-73.183637)"
2023,Marzo,Pakistán,586,0,2,2,"(3.893038,-77.067921)"
2013,Septiembre,Francia,250,0,1,1,"(4.452882,-75.766298)"
2013,Junio,México,484,7,17,24,"(10.408582,-75.538003)"
2015,Octubre,Chile,152,41,105,146,"(6.171601,-75.427454)"
2021,Mayo,Israel,376,1,0,1,"(3.541112,-76.384584)"
2017,Septiembre,Guatemala,320,1,3,4,"(8.36068,-72.409396)"
2022,Marzo,República de Irlanda,372,1,0,1,"(12.586067,-81.702563)"
2018,Marzo,Desconocido,99999,10,10,20,"(6.171601,-75.427454)"
2019,Diciembre,México,484,17,19,36,"(4.815061,-75.736532)"
2017,Octubre,Desconocido,99999,1,0,1,"(10.886611,-74.776708)"
2021,Febrero,Chipre,196,3,3,6,"(4.697144,-74.140516)"
2017,Octubre,Paraguay,600,20,104,124,"(10.886611,-74.776708)"
2023,Febrero,Chile,152,9,15,24,"(7.916725,-72.462544)"
2012,Enero,Angola,24,1,1,2,"(4.697144,-74.140516)"
2013,Agosto,Francia,250,1414,2334,3748,"(4.697144,-74.140516)"
2023,Enero,Nueva Zelanda,554,0,1,1,"(8.635765,-77.346578)"
2022,Noviembre,Rumania,642,2,3,5,"(10.886611,-74.776708)"
2019,Julio,Grecia,300,1,3,4,"(3.541112,-76.384584)"
2015,Enero,Reino Unido de Gran Bretaña e Irlanda del Norte,826,0,1,1,"(9.402978,-75.681599)"
2013,Marzo,Venezuela,862,66,117,183,"(7.088729,-70.740253)"
2018,Julio,Brasil,76,6209,6895,13104,"(4.697144,-74.140516)"
2020,Octubre,Ecuador,218,0,52,52,"(1.813928,-78.763924)"
2023,Febrero,Bélgica,56,4,4,8,"(11.247723,-74.213989)"
2022,Diciembre,Rumania,642,0,1,1,"(7.927209,-72.507910)"
2014,Abril,Bosnia y Herzegovina,70,2,1,3,"(4.697144,-74.140516)"
2023,Abril,Túnez,788,3,8,11,"(4.697144,-74.140516)"
2012,Junio,Reino Unido de Gran Bretaña e Irlanda del Norte,826,0,1,1,"(7.818934,-72.453226)"
2017,Junio,Portugal,620,0,2,2,"(8.635765,-77.346578)"
2016,Noviembre,Estonia,233,0,1,1,"(10.971302,-74.765397)"
2018,Noviembre,Togo,768,0,1,1,"(4.697144,-74.140516)"
2016,Junio,República de Belarús,112,3,3,6,"(4.697144,-74.140516)"
2020,Noviembre,Bulgaria,100,1,3,4,"(4.697144,-74.140516)"
2014,Abril,República de Armenia,51,1,1,2,"(6.171601,-75.427454)"
2012,Octubre,Alemania,276,0,2,2,"(11.528919,-72.919681)"
2013,Diciembre,Grecia,300,0,1,1,"(8.635765,-77.346578)"
2023,Marzo,España,724,213,330,543,"(10.445761,-75.516429)"
2017,Diciembre,Ucrania,804,1,13,14,"(10.408582,-75.538003)"
2018,Julio,Santa Lucia,662,2,10,12,"(4.697144,-74.140516)"
2021,Julio,Israel,376,3,6,9,"(3.541112,-76.384584)"
2022,Julio,Alemania,276,131,131,262,"(3.541112,-76.384584)"
2018,Diciembre,Nueva Zelanda,554,3,8,11,"(10.408582,-75.538003)"
2014,Mayo,Israel,376,9,33,42,"(10.445761,-75.516429)"
2015,Mayo,Guatemala,320,1,1,2,"(0.814836,-77.662532)"
2015,Noviembre,Bélgica,56,197,439,636,"(4.697144,-74.140516)"
2017,Febrero,Lituania,440,0,2,2,"(3.893038,-77.067921)"
2016,Agosto,República Checa,203,1,1,2,"(10.445761,-75.516429)"
2020,Julio,Japón,392,2,0,2,"(4.697144,-74.140516)"
2016,Julio,Bermudas/Territorio Británico de Ultramar,60,0,1,1,"(6.171601,-75.427454)"
2016,Enero,Japón,392,1,0,1,"(10.408582,-75.538003)"
2019,Octubre,Azerbaiyán,31,1,6,7,"(4.697144,-74.140516)"
2021,Noviembre,Belice,84,4,18,22,"(4.697144,-74.140516)"
2015,Agosto,Alemania,276,4,1,5,"(12.586067,-81.702563)"
2017,Octubre,Perú,604,117,99,216,"(10.408582,-75.538003)"
2022,Marzo,Finlandia,246,8,6,14,"(10.445761,-75.516429)"
2013,Noviembre,Grecia,300,0,2,2,"(10.408582,-75.538003)"
2015,Agosto,Cuba,192,36,57,93,"(6.171601,-75.427454)"
2020,Noviembre,Rumania,642,0,1,1,"(10.886611,-74.776708)"
2014,Febrero,Marruecos,504,1,0,1,"(10.445761,-75.516429)"
2016,Julio,República Dominicana,214,1,1,2,"(7.818934,-72.453226)"
2015,Febrero,El Salvador,222,2,2,4,"(7.927209,-72.507910)"
2021,Junio,Luxemburgo,442,0,1,1,"(6.171601,-75.427454)"
2017,Marzo,Chipre,196,6,5,11,"(4.697144,-74.140516)"
2022,Julio,República Dominicana,214,61,79,140,"(3.541112,-76.384584)"
2021,Marzo,Panamá,591,494,613,1107,"(6.171601,-75.427454)"
2015,Noviembre,Perú,604,0,1,1,"(1.813928,-78.763924)"
2017,Octubre,Perú,604,0,1,1,"(10.971302,-74.765397)"
2017,Julio,Pakistán,586,10,17,27,"(4.697144,-74.140516)"
2015,Agosto,Singapur,702,0,1,1,"(3.541112,-76.384584)"
2018,Mayo,Israel,376,4,6,10,"(-4.223468,-69.945098)"
2017,Febrero,Uruguay,858,242,326,568,"(4.697144,-74.140516)"
2012,Junio,Italia,380,17,66,83,"(10.445761,-75.516429)"
2013,Enero,Zimbabue,716,0,2,2,"(4.697144,-74.140516)"
2022,Agosto,Ecuador,218,206,223,429,"(0.25129,-76.875963)"
2023,Marzo,Perú,604,18,17,35,"(4.815061,-75.736532)"
2014,Enero,China,156,4,6,10,"(10.445761,-75.516429)"
2014,Octubre,Bélgica,56,5,18,23,"(3.541112,-76.384584)"
2023,Junio,San Cristóbal y Nevis,659,3,5,8,"(4.697144,-74.140516)"
2023,Mayo,Canadá,124,0,3,3,"(7.128456,-73.183637)"
2022,Noviembre,Italia,380,2,3,5,"(-4.197703,-69.941278)"
2022,Septiembre,España,724,2,4,6,"(-4.197703,-69.941278)"
2017,Octubre,Dinamarca,208,0,2,2,"(10.408582,-75.538003)"
2017,Julio,Chipre,196,0,2,2,"(3.541112,-76.384584)"
2021,Noviembre,Indonesia,360,0,16,16,"(10.408582,-75.538003)"
2015,Diciembre,Marruecos,504,1,0,1,"(10.886611,-74.776708)"
2018,Mayo,Francia,250,59,84,143,"(3.541112,-76.384584)"
2013,Abril,Jamaica,388,1,1,2,"(3.541112,-76.384584)"
2014,Diciembre,Nepal,524,0,2,2,"(10.445761,-75.516429)"
2016,Diciembre,Estados Unidos de América,840,4,1,5,"(11.360009,-72.129330)"
2019,Noviembre,República de Irlanda,372,17,55,72,"(6.171601,-75.427454)"
2017,Mayo,Estados Unidos de América,840,0,1,1,"(8.36068,-72.409396)"
2017,Diciembre,Chipre,196,0,1,1,"(6.171601,-75.427454)"
2012,Julio,Israel,376,36,83,119,"(0.814836,-77.662532)"
2018,Noviembre,Azerbaiyán,31,0,2,2,"(10.445761,-75.516429)"
2013,Enero,India,356,0,1,1,"(4.815061,-75.736532)"
2022,Junio,Federación de Rusia,643,164,143,307,"(4.697144,-74.140516)"
2022,Julio,Reino Unido de Gran Bretaña e Irlanda del Norte,826,1,0,1,"(12.5744111,-81.703935)"
2015,Abril,Estados Unidos de América,840,11,26,37,"(7.818934,-72.453226)"
2019,Enero,Bahamas,44,0,4,4,"(10.445761,-75.516429)"
2021,Septiembre,Nueva Zelanda,554,1,1,2,"(3.541112,-76.384584)"
2014,Julio,Nueva Zelanda,554,2,16,18,"(6.171601,-75.427454)"
2019,Agosto,Hungría,348,3,5,8,"(10.408582,-75.538003)"
2019,Noviembre,Malta,470,0,1,1,"(6.171601,-75.427454)"
2021,Octubre,Turquía,792,0,1,1,"(7.128456,-73.183637)"
2015,Noviembre,Honduras,340,264,350,614,"(4.697144,-74.140516)"
2020,Febrero,Mauricio,480,2,4,6,"(4.697144,-74.140516)"
2020,Enero,Austria,40,0,3,3,"(4.815061,-75.736532)"
2016,Noviembre,Trinidad y Tobago,780,1,2,3,"(7.128456,-73.183637)"
2019,Julio,Kirguistán,417,1,0,1,"(6.171601,-75.427454)"
2016,Diciembre,Perú,604,1,1,2,"(-0.193180,-74.784874)"
2014,Abril,Dinamarca,208,1,2,3,"(10.886611,-74.776708)"
2016,Septiembre,Argentina,32,77,133,210,"(3.541112,-76.384584)"
2016,Octubre,Israel,376,4,21,25,"(3.541112,-76.384584)"
2015,Febrero,Filipinas,608,0,23,23,"(3.893038,-77.067921)"
2019,Octubre,Argentina,32,3416,4835,8251,"(4.697144,-74.140516)"
2016,Mayo,Nueva Zelanda,554,0,2,2,"(10.886611,-74.776708)"
2012,Noviembre,San  Vicente y las Granadinas,670,0,2,2,"(4.697144,-74.140516)"
2019,Enero,Cuba,192,0,2,2,"(7.128456,-73.183637)"
2019,Noviembre,Bulgaria,100,48,36,84,"(4.697144,-74.140516)"
2012,Febrero,Países Bajos,528,19,35,54,"(3.541112,-76.384584)"
2022,Abril,México,484,2,2,4,"(11.360009,-72.129330)"
2012,Enero,México,484,14,16,30,"(0.814836,-77.662532)"
2015,Junio,Dinamarca,208,0,5,5,"(11.247723,-74.213989)"
2018,Noviembre,Federación de Rusia,643,19,54,73,"(10.445761,-75.516429)"
2020,Marzo,Reino Unido de Gran Bretaña e Irlanda del Norte,826,1,0,1,"(4.452882,-75.766298)"
2018,Abril,Perú,604,122,212,334,"(7.818934,-72.453226)"
2020,Diciembre,Bolivia,68,28,21,49,"(10.445761,-75.516429)"
2018,Noviembre,Polonia,616,3,0,3,"(3.541112,-76.384584)"
2014,Marzo,Canadá,124,3,14,17,"(10.886611,-74.776708)"
2015,Junio,Uruguay,858,37,26,63,"(12.586067,-81.702563)"
2017,Octubre,Argentina,32,2,6,8,"(4.815061,-75.736532)"
2021,Diciembre,Qatar,634,1,5,6,"(4.697144,-74.140516)"
2013,Junio,Camerún,120,0,1,1,"(3.541112,-76.384584)"
2022,Septiembre,Liechtenstein,438,0,1,1,"(0.814836,-77.662532)"
2022,Agosto,Francia,250,11,29,40,"(-4.197703,-69.941278)"
2016,Enero,Portugal,620,1,3,4,"(7.818934,-72.453226)"
2013,Enero,Nigeria,566,1,0,1,"(3.541112,-76.384584)"
2023,Junio,Somalia,706,0,1,1,"(4.697144,-74.140516)"
2015,Agosto,República Dominicana,214,2,3,5,"(11.360009,-72.129330)"
2012,Septiembre,Bolivia,68,2,2,4,"(12.586067,-81.702563)"
2017,Abril,Nueva Zelanda,554,1,0,1,"(7.818934,-72.453226)"
2012,Junio,Pakistán,586,0,1,1,"(7.818934,-72.453226)"
2020,Diciembre,Albania,8,0,1,1,"(6.171601,-75.427454)"
2017,Julio,Egipto,818,0,6,6,"(10.445761,-75.516429)"
2018,Marzo,Refugiado,99999,0,1,1,"(12.586067,-81.702563)"
2014,Septiembre,Italia,380,0,1,1,"(12.5744111,-81.703935)"
2016,Marzo,Bélgica,56,1,1,2,"(12.586067,-81.702563)"
2018,Febrero,Brasil,76,3,5,8,"(3.866713,-67.927521)"
2022,Agosto,Eslovaquia,703,0,1,1,"(3.893038,-77.067921)"
2015,Mayo,Reino Unido de Gran Bretaña e Irlanda del Norte,826,0,2,2,"(0.25129,-76.875963)"
2014,Noviembre,Polonia,616,0,8,8,"(6.171601,-75.427454)"
2016,Abril,Islas Caimán/Territorio Británico de Ultramar,136,0,1,1,"(10.445761,-75.516429)"
2021,Junio,Perú,604,0,1,1,"(11.360009,-72.129330)"
2015,Febrero,Argentina,32,1,2,3,"(8.635765,-77.346578)"
2013,Noviembre,República de Corea,410,3,1,4,"(-4.197703,-69.941278)"
2014,Febrero,Noruega,578,0,3,3,"(12.5744111,-81.703935)"
2022,Mayo,Suiza,756,0,1,1,"(12.586067,-81.702563)"
2013,Junio,Malasia,458,1,0,1,"(8.635765,-77.346578)"
2018,Abril,Canadá,124,17,52,69,"(10.886611,-74.776708)"
2018,Agosto,República Dominicana,214,2,7,9,"(11.360009,-72.129330)"
2018,Agosto,Marruecos,504,1,3,4,"(6.171601,-75.427454)"
2016,Julio,Brasil,76,78,78,156,"(-4.197703,-69.941278)"
2019,Febrero,Malta,470,0,1,1,"(6.171601,-75.427454)"
2017,Septiembre,Chile,152,26,35,61,"(10.886611,-74.776708)"
2015,Agosto,Bélgica,56,14,17,31,"(3.541112,-76.384584)"
2021,Octubre,Suiza,756,210,342,552,"(4.697144,-74.140516)"
2015,Noviembre,Santa Lucia,662,4,4,8,"(4.697144,-74.140516)"
2023,Abril,Federación de Rusia,643,1,5,6,"(10.886611,-74.776708)"
2015,Junio,Turquía,792,0,3,3,"(0.814836,-77.662532)"
2014,Febrero,Venezuela,862,1,0,1,"(8.635765,-77.346578)"
2012,Diciembre,Islandia,352,1,3,4,"(10.445761,-75.516429)"
2021,Marzo,Países Bajos,528,196,394,590,"(4.697144,-74.140516)"
2012,Junio,Turquía,792,0,3,3,"(10.971302,-74.765397)"
2013,Mayo,Venezuela,862,2,11,13,"(4.815061,-75.736532)"
2019,Julio,Taiwán,158,20,21,41,"(6.171601,-75.427454)"
2021,Febrero,Angola,24,1,0,1,"(6.171601,-75.427454)"
2016,Junio,Hungría,348,0,1,1,"(8.635765,-77.346578)"
2019,Octubre,Portugal,620,17,17,34,"(7.818934,-72.453226)"
2012,Abril,Granada,308,0,1,1,"(6.171601,-75.427454)"
2016,Diciembre,Irán,364,0,1,1,"(-4.197703,-69.941278)"
2022,Julio,Montenegro,499,0,3,3,"(10.408582,-75.538003)"
2016,Marzo,Jordania,400,0,1,1,"(0.814836,-77.662532)"
2013,Mayo,República de Corea,410,1,0,1,"(-4.197703,-69.941278)"
2019,Noviembre,Croacia,191,0,6,6,"(10.971302,-74.765397)"
2022,Febrero,India,356,0,7,7,"(11.247723,-74.213989)"
2019,Mayo,Chile,152,1,3,4,"(-4.223468,-69.945098)"
2023,Mayo,España,724,1,0,1,"(3.893038,-77.067921)"
2023,Febrero,Lituania,440,76,82,158,"(4.697144,-74.140516)"
2018,Octubre,Canadá,124,217,291,508,"(10.445761,-75.516429)"
2015,Julio,Noruega,578,1,1,2,"(11.360009,-72.129330)"
2017,Mayo,Lituania,440,16,11,27,"(4.697144,-74.140516)"
2021,Diciembre,República Dominicana,214,30,61,92,"(10.445761,-75.516429)"
2017,Abril,Ecuador,218,0,3,3,"(4.815061,-75.736532)"
2018,Abril,Suecia,752,1,0,1,"(13.3387613,-81.372937)"
2017,Febrero,Federación de Rusia,643,1,2,3,"(10.886611,-74.776708)"
2018,Febrero,Federación de Rusia,643,142,196,338,"(4.697144,-74.140516)"
2023,Abril,Perú,604,9,11,20,"(4.815061,-75.736532)"
2013,Marzo,Japón,392,0,2,2,"(10.886611,-74.776708)"
2012,Enero,Guatemala,320,8,15,23,"(10.445761,-75.516429)"
2013,Mayo,Perú,604,14,28,42,"(-4.197703,-69.941278)"
2014,Mayo,España,724,1,31,32,"(10.886611,-74.776708)"
2015,Marzo,Haití,332,0,1,1,"(7.818934,-72.453226)"
2018,Julio,Venezuela,862,5395,5388,10784,"(4.697144,-74.140516)"
2012,Octubre,Polonia,616,4,1,5,"(3.541112,-76.384584)"
2012,Marzo,Japón,392,235,479,714,"(4.697144,-74.140516)"
2020,Enero,Irán,364,1,0,1,"(10.445761,-75.516429)"
2020,Febrero,Desconocido,99999,1,1,2,"(6.171601,-75.427454)"
2012,Octubre,Reino Unido de Gran Bretaña e Irlanda del Norte,826,24,33,57,"(10.408582,-75.538003)"
2023,Enero,Canadá,124,5,8,13,"(7.128456,-73.183637)"
2014,Septiembre,Tailandia,764,4,10,14,"(4.697144,-74.140516)"
2012,Diciembre,Bulgaria,100,0,3,3,"(6.171601,-75.427454)"
2016,Diciembre,Nicaragua,558,10,12,22,"(3.541112,-76.384584)"
2022,Marzo,Serbia,688,0,1,1,"(3.541112,-76.384584)"
2023,Febrero,Polonia,616,2,16,18,"(3.541112,-76.384584)"
2012,Enero,República Dominicana,214,0,1,1,"(4.452882,-75.766298)"
2021,Octubre,Taiwán,158,0,3,3,"(3.541112,-76.384584)"
2018,Noviembre,Somalia,706,0,1,1,"(4.697144,-74.140516)"
2015,Marzo,India,356,0,10,10,"(0.814836,-77.662532)"
2015,Abril,Noruega,578,3,5,8,"(6.171601,-75.427454)"
2019,Junio,Costa Rica,188,98,147,245,"(6.171601,-75.427454)"
2019,Julio,República de Irlanda,372,2,0,2,"(4.815061,-75.736532)"
2014,Junio,Austria,40,0,2,2,"(11.360009,-72.129330)"
2021,Agosto,Estados Unidos de América,840,5,13,18,"(7.818934,-72.453226)"
2020,Febrero,Italia,380,5,8,13,"(-4.223468,-69.945098)"
2016,Febrero,Letonia,428,0,1,1,"(-4.197703,-69.941278)"
2017,Septiembre,Brasil,76,6,11,17,"(7.818934,-72.453226)"
2017,Agosto,Lituania,440,1,0,1,"(0.25129,-76.875963)"
2017,Diciembre,Bahamas,44,1,4,5,"(6.171601,-75.427454)"
2023,Junio,Uruguay,858,1,3,4,"(0.814836,-77.662532)"
2022,Diciembre,Venezuela,862,17,18,35,"(4.815061,-75.736532)"
2018,Julio,República de Kosovo,901,1,1,2,"(4.697144,-74.140516)"
2012,Junio,Islas Vírgenes Británicas/Territorio Británico de Ultramar,92,0,1,1,"(4.697144,-74.140516)"
2013,Octubre,Canadá,124,34,104,138,"(6.171601,-75.427454)"
2013,Febrero,Perú,604,28,47,75,"(7.818934,-72.453226)"
2014,Septiembre,Israel,376,1,2,3,"(8.635765,-77.346578)"
2022,Diciembre,Georgia,268,0,1,1,"(11.117806,-74.232622)"
2022,Marzo,Ghana,288,1,7,8,"(4.697144,-74.140516)"
2013,Mayo,Chile,152,74,131,205,"(6.171601,-75.427454)"
2022,Marzo,India,356,0,14,14,"(9.402978,-75.681599)"
2023,Abril,Polonia,616,188,195,383,"(4.697144,-74.140516)"
2015,Agosto,Turquía,792,0,4,4,"(0.814836,-77.662532)"
2022,Abril,Desconocido,99999,1,0,1,"(3.541112,-76.384584)"
2022,Junio,China,156,1,0,1,"(12.586067,-81.702563)"
2012,Febrero,Madagascar,450,1,0,1,"(4.697144,-74.140516)"
2019,Agosto,Jordania,400,1,2,3,"(4.697144,-74.140516)"
2013,Diciembre,Paraguay,600,1,0,1,"(7.088729,-70.740253)"
2019,Febrero,Alemania,276,1,9,10,"(7.818934,-72.453226)"
2021,Febrero,Kazajistán,398,2,0,2,"(10.445761,-75.516429)"
2014,Mayo,Panamá,591,0,2,2,"(1.813928,-78.763924)"
2022,Noviembre,Malta,470,5,10,15,"(4.697144,-74.140516)"
2022,Noviembre,España,724,3,2,5,"(-4.223468,-69.945098)"
2017,Abril,Malawi,454,0,1,1,"(4.697144,-74.140516)"
2014,Abril,Ecuador,218,377,400,777,"(6.171601,-75.427454)"
2022,Octubre,Serbia,688,0,1,1,"(0.814836,-77.662532)"
2019,Agosto,Costa Rica,188,166,138,304,"(12.586067,-81.702563)"
2021,Febrero,Croacia,191,0,2,2,"(10.971302,-74.765397)"
2017,Abril,Perú,604,201,215,416,"(3.541112,-76.384584)"
2019,Mayo,Francia,250,5,7,12,"(11.247723,-74.213989)"
2015,Febrero,Suecia,752,2,1,3,"(11.247723,-74.213989)"
2012,Enero,Venezuela,862,5306,6178,11484,"(4.697144,-74.140516)"
2021,Octubre,Japón,392,1,1,2,"(0.814836,-77.662532)"
2022,Junio,Nueva Zelanda,554,4,7,11,"(10.445761,-75.516429)"
2017,Agosto,Trinidad y Tobago,780,7,9,16,"(10.445761,-75.516429)"
2020,Noviembre,Nicaragua,558,0,1,1,"(4.815061,-75.736532)"
2017,Septiembre,Países Bajos,528,4,8,12,"(11.528919,-72.919681)"
2018,Noviembre,Países Bajos,528,7,6,13,"(7.128456,-73.183637)"
2021,Junio,Surinam,740,2,4,6,"(4.697144,-74.140516)"
2016,Febrero,España,724,0,1,1,"(11.360009,-72.129330)"
2022,Marzo,Rumania,642,1,0,1,"(-4.197703,-69.941278)"
2018,Mayo,República Dominicana,214,74,128,202,"(6.171601,-75.427454)"
2015,Septiembre,Nigeria,566,2,11,13,"(4.697144,-74.140516)"
2014,Marzo,Chipre,196,0,1,1,"(3.541112,-76.384584)"
2015,Junio,Indonesia,360,1,1,2,"(10.445761,-75.516429)"
2016,Diciembre,Trinidad y Tobago,780,0,2,2,"(10.886611,-74.776708)"
2016,Julio,Líbano,422,1,1,2,"(6.171601,-75.427454)"
2023,Abril,Guatemala,320,0,1,1,"(12.586067,-81.702563)"
2013,Febrero,Países Bajos,528,0,18,18,"(7.818934,-72.453226)"
2019,Junio,Suiza,756,3,1,4,"(0.25129,-76.875963)"
2014,Julio,Costa de Marfil,384,1,0,1,"(10.886611,-74.776708)"
2017,Julio,Costa Rica,188,167,114,281,"(10.445761,-75.516429)"
2017,Mayo,Barbados,52,0,1,1,"(3.541112,-76.384584)"
2020,Enero,Kazajistán,398,13,5,18,"(4.697144,-74.140516)"
2013,Julio,Alemania,276,87,74,161,"(0.814836,-77.662532)"
2019,Marzo,Croacia,191,3,5,8,"(6.171601,-75.427454)"
2019,Marzo,Israel,376,1,5,6,"(-4.223468,-69.945098)"
2017,Agosto,Belice,84,10,16,26,"(4.697144,-74.140516)"
2012,Octubre,Arabia Saudita,682,0,1,1,"(6.171601,-75.427454)"
2017,Noviembre,Paraguay,600,2,0,2,"(4.815061,-75.736532)"
2017,Diciembre,Reino Unido de Gran Bretaña e Irlanda del Norte,826,11,9,20,"(-4.197703,-69.941278)"
2015,Septiembre,Venezuela,862,31,39,70,"(3.866713,-67.927521)"
2012,Enero,Rumania,642,0,2,2,"(0.814836,-77.662532)"
2021,Septiembre,Chipre,196,0,1,1,"(10.445761,-75.516429)"
2015,Agosto,República de Armenia,51,1,1,2,"(4.697144,-74.140516)"
2022,Junio,Grecia,300,0,2,2,"(10.408582,-75.538003)"
2021,Septiembre,España,724,37,63,100,"(3.541112,-76.384584)"
2013,Marzo,India,356,2,22,24,"(6.171601,-75.427454)"
2022,Octubre,Trinidad y Tobago,780,1,1,2,"(4.452882,-75.766298)"
2019,Julio,Países Bajos,528,8,17,25,"(4.815061,-75.736532)"
2018,Septiembre,Ecuador,218,0,1,1,"(-4.197703,-69.941278)"
2019,Mayo,Bermudas/Territorio Británico de Ultramar,60,0,1,1,"(10.445761,-75.516429)"
2022,Julio,Francia,250,292,405,697,"(6.171601,-75.427454)"
2013,Agosto,Estados Unidos de América,840,91,136,227,"(4.452882,-75.766298)"
2018,Diciembre,Perú,604,13,16,29,"(10.886611,-74.776708)"
2015,Noviembre,Noruega,578,115,186,301,"(4.697144,-74.140516)"
2013,Octubre,Indonesia,360,0,3,3,"(3.541112,-76.384584)"
2018,Julio,Brasil,76,12,39,51,"(0.814836,-77.662532)"
2013,Octubre,Suiza,756,266,502,768,"(4.697144,-74.140516)"
2022,Marzo,Italia,380,10,14,24,"(8.36068,-72.409396)"
2013,Marzo,Taiwán,158,3,4,7,"(3.541112,-76.384584)"
2018,Julio,Paraguay,600,3,0,3,"(10.408582,-75.538003)"
2013,Febrero,República de Irlanda,372,1,1,2,"(10.408582,-75.538003)"
2017,Julio,Kenia,404,0,1,1,"(6.171601,-75.427454)"
2012,Febrero,Austria,40,123,235,358,"(4.697144,-74.140516)"
2017,Agosto,Venezuela,862,102,178,280,"(10.886611,-74.776708)"
2021,Febrero,República Checa,203,0,2,2,"(10.445761,-75.516429)"
2023,Enero,Finlandia,246,0,1,1,"(10.886611,-74.776708)"
2016,Agosto,Italia,380,1144,2284,3428,"(4.697144,-74.140516)"
2019,Noviembre,Panamá,591,0,2,2,"(1.813928,-78.763924)"
2012,Diciembre,Francia,250,1,2,3,"(12.586067,-81.702563)"
2021,Agosto,Eslovenia,705,17,16,33,"(4.697144,-74.140516)"
2019,Junio,Taiwán,158,4,3,7,"(10.445761,-75.516429)"
2014,Noviembre,México,484,0,2,2,"(7.088729,-70.740253)"
2014,Diciembre,Austria,40,1,0,1,"(7.818934,-72.453226)"
2017,Enero,Francia,250,28,32,60,"(-4.197703,-69.941278)"
2014,Enero,Croacia,191,8,36,44,"(4.697144,-74.140516)"
2019,Noviembre,República de Belarús,112,1,2,4,"(0.814836,-77.662532)"
2023,Marzo,Turquía,792,0,1,1,"(9.402978,-75.681599)"
2017,Junio,Francia,250,1379,2314,3693,"(4.697144,-74.140516)"
2022,Octubre,Países Bajos,528,6,3,9,"(11.247723,-74.213989)"
2019,Noviembre,Estados Unidos de América,840,36,63,99,"(7.128456,-73.183637)"
2019,Diciembre,Panamá,591,18,26,44,"(7.128456,-73.183637)"
2018,Julio,Paraguay,600,36,27,63,"(6.171601,-75.427454)"
2018,Febrero,República Árabe de Yemen,887,0,1,1,"(4.697144,-74.140516)"
2020,Septiembre,Palestina,99999,0,1,1,"(4.697144,-74.140516)"
2018,Diciembre,Senegal,686,0,1,1,"(6.171601,-75.427454)"
2022,Abril,Federación de Rusia,643,189,230,419,"(4.697144,-74.140516)"
2023,Junio,Turquía,792,3,19,22,"(10.445761,-75.516429)"
2016,Agosto,Noruega,578,0,1,1,"(7.128456,-73.183637)"
2018,Marzo,Reino Unido de Gran Bretaña e Irlanda del Norte,826,32,31,63,"(10.408582,-75.538003)"
2022,Noviembre,Paraguay,600,7,3,10,"(12.586067,-81.702563)"
2019,Marzo,Italia,380,0,8,8,"(4.815061,-75.736532)"
2014,Julio,Canadá,124,170,247,417,"(6.171601,-75.427454)"
2017,Octubre,República de Belarús,112,0,1,1,"(10.445761,-75.516429)"
2017,Enero,Dominica,212,1,2,3,"(3.541112,-76.384584)"
2019,Mayo,Kazajistán,398,5,8,13,"(4.697144,-74.140516)"
2022,Febrero,Belice,84,0,2,2,"(10.445761,-75.516429)"
2019,Octubre,Filipinas,608,0,1,1,"(12.586067,-81.702563)"
2015,Abril,Brasil,76,0,2,2,"(13.3387613,-81.372937)"
2018,Mayo,Líbano,422,1,3,4,"(6.171601,-75.427454)"
2017,Octubre,Suiza,756,3,8,11,"(4.815061,-75.736532)"
2012,Julio,Nepal,524,0,1,1,"(4.697144,-74.140516)"
2012,Noviembre,Alemania,276,25,34,59,"(10.408582,-75.538003)"
2016,Agosto,República Dominicana,214,0,1,1,"(4.452882,-75.766298)"
2020,Enero,Reino Unido de Gran Bretaña e Irlanda del Norte,826,2,6,8,"(-4.223468,-69.945098)"
2020,Enero,Chile,152,79,103,182,"(0.814836,-77.662532)"
2018,Diciembre,República Dominicana,214,2,0,2,"(-4.197703,-69.941278)"
2019,Septiembre,Bahamas,44,0,4,4,"(6.171601,-75.427454)"
2014,Marzo,Filipinas,608,0,1,1,"(1.813928,-78.763924)"
2014,Marzo,Sudáfrica,710,2,0,2,"(10.408582,-75.538003)"
2013,Julio,Ucrania,804,3,8,11,"(10.445761,-75.516429)"
2023,Mayo,Países Bajos,528,0,1,1,"(7.927209,-72.507910)"
2017,Enero,México,484,0,2,2,"(8.635765,-77.346578)"
2019,Septiembre,Suecia,752,1,1,2,"(10.886611,-74.776708)"
2021,Noviembre,Gambia,270,0,1,1,"(4.697144,-74.140516)"
2015,Enero,Suecia,752,17,26,43,"(6.171601,-75.427454)"
2015,Abril,Israel,376,1,0,1,"(7.818934,-72.453226)"
2016,Enero,México,484,115,202,317,"(10.445761,-75.516429)"
2015,Abril,Santa Lucia,662,0,2,2,"(7.818934,-72.453226)"
2019,Febrero,Suiza,756,716,921,1637,"(4.697144,-74.140516)"
2023,Mayo,Serbia,688,0,3,3,"(4.815061,-75.736532)"
2015,Febrero,Indonesia,360,0,3,3,"(10.408582,-75.538003)"
2020,Febrero,Ucrania,804,0,3,3,"(11.247723,-74.213989)"
2016,Septiembre,Guyana,328,10,12,22,"(4.697144,-74.140516)"
2019,Octubre,Brasil,76,0,1,1,"(7.128456,-73.183637)"
2016,Septiembre,Ecuador,218,1844,2696,4540,"(0.814836,-77.662532)"
2012,Diciembre,Suiza,756,419,780,1199,"(4.697144,-74.140516)"
2012,Diciembre,Sudáfrica,710,0,2,2,"(3.541112,-76.384584)"
2018,Enero,China,156,2,0,2,"(4.815061,-75.736532)"
2012,Marzo,Países Bajos,528,1,2,3,"(11.247723,-74.213989)"
2021,Diciembre,Panamá,591,68,150,218,"(4.815061,-75.736532)"
2014,Enero,Costa Rica,188,465,610,1075,"(4.697144,-74.140516)"
2020,Enero,Cuba,192,1,4,5,"(4.815061,-75.736532)"
2020,Febrero,Dominica,212,1,4,5,"(6.171601,-75.427454)"
2017,Julio,Portugal,620,3,5,8,"(10.408582,-75.538003)"
2013,Diciembre,Suecia,752,1,0,1,"(8.635765,-77.346578)"
2017,Noviembre,Uruguay,858,390,578,968,"(4.697144,-74.140516)"
2021,Octubre,Turquía,792,0,1,1,"(3.893038,-77.067921)"
2017,Marzo,Honduras,340,5,18,23,"(4.815061,-75.736532)"
2018,Septiembre,Polonia,616,9,6,15,"(0.814836,-77.662532)"
2012,Marzo,Argentina,32,32,31,63,"(10.408582,-75.538003)"
2012,Mayo,Noruega,578,1,0,1,"(8.635765,-77.346578)"
2017,Febrero,Estados Unidos de América,840,0,1,1,"(8.36068,-72.409396)"
2017,Marzo,Rumania,642,0,4,4,"(3.893038,-77.067921)"
2017,Marzo,Polonia,616,0,3,3,"(11.247723,-74.213989)"
2023,Febrero,Venezuela,862,12,18,30,"(-4.197703,-69.941278)"
2013,Junio,Trinidad y Tobago,780,0,1,1,"(11.360009,-72.129330)"
2017,Noviembre,Suecia,752,14,15,29,"(0.814836,-77.662532)"
2014,Abril,República de Irlanda,372,2,1,3,"(-4.197703,-69.941278)"
2020,Febrero,Ucrania,804,41,27,68,"(4.697144,-74.140516)"
2014,Agosto,Portugal,620,293,575,868,"(4.697144,-74.140516)"
2022,Agosto,Hungría,348,0,1,1,"(7.128456,-73.183637)"
2014,Mayo,Japón,392,0,9,9,"(10.408582,-75.538003)"
2023,Enero,Estados Unidos de América,840,17,23,40,"(-4.197703,-69.941278)"
2021,Diciembre,México,484,0,5,5,"(10.408582,-75.538003)"
2013,Noviembre,Italia,380,0,1,1,"(11.247723,-74.213989)"
2019,Agosto,Marruecos,504,1,2,3,"(10.445761,-75.516429)"
2020,Enero,Guyana,328,3,0,3,"(3.541112,-76.384584)"
2022,Marzo,Nicaragua,558,10,16,26,"(3.541112,-76.384584)"
2014,Noviembre,España,724,0,1,1,"(10.971302,-74.765397)"
2020,Febrero,Perú,604,256,363,619,"(0.814836,-77.662532)"
2023,Mayo,Francia,250,0,2,2,"(4.452882,-75.766298)"
2023,Enero,Nicaragua,558,1,1,2,"(4.815061,-75.736532)"
2012,Abril,Panamá,591,1,3,4,"(8.635765,-77.346578)"
2016,Octubre,Ecuador,218,6,4,10,"(0.812436,-77.847006)"
2017,Junio,República de Irlanda,372,9,14,23,"(0.814836,-77.662532)"
2012,Junio,Singapur,702,0,1,1,"(10.886611,-74.776708)"
2013,Abril,Bolivia,68,1,0,1,"(1.813928,-78.763924)"
2014,Julio,Paraguay,600,4,5,9,"(0.814836,-77.662532)"
2018,Agosto,Países Bajos,528,0,1,1,"(11.247723,-74.213989)"
2022,Julio,Honduras,340,0,4,4,"(7.128456,-73.183637)"
2014,Marzo,Italia,380,385,1611,1996,"(4.697144,-74.140516)"
2013,Noviembre,Perú,604,9,17,26,"(4.815061,-75.736532)"
2023,Enero,Venezuela,862,4787,4464,9251,"(7.818934,-72.453226)"
2014,Noviembre,Rumania,642,0,1,1,"(7.818934,-72.453226)"
2014,Agosto,Portugal,620,0,1,1,"(4.815061,-75.736532)"
2012,Agosto,Nueva Zelanda,554,4,3,7,"(8.635765,-77.346578)"
2021,Diciembre,Nueva Zelanda,554,1,1,2,"(3.541112,-76.384584)"
2016,Junio,España,724,1,5,6,"(8.635765,-77.346578)"
2017,Marzo,Japón,392,21,42,63,"(6.171601,-75.427454)"
2018,Marzo,Bermudas/Territorio Británico de Ultramar,60,2,1,3,"(10.445761,-75.516429)"
2023,Junio,Letonia,428,0,3,3,"(10.445761,-75.516429)"
2014,Agosto,Cuba,192,2,0,2,"(10.408582,-75.538003)"
2017,Septiembre,Perú,604,79,152,231,"(7.818934,-72.453226)"
2013,Diciembre,Suecia,752,300,460,760,"(4.697144,-74.140516)"
2013,Noviembre,Myanmar,104,0,1,1,"(10.408582,-75.538003)"
2015,Agosto,Taiwán,158,3,6,9,"(6.171601,-75.427454)"
2014,Junio,Eslovenia,705,1,0,1,"(6.171601,-75.427454)"
2015,Abril,El Salvador,222,27,32,59,"(10.445761,-75.516429)"
2023,Marzo,Países Bajos,528,1,1,2,"(4.452882,-75.766298)"
2014,Marzo,Eslovenia,705,0,1,1,"(3.541112,-76.384584)"
2022,Octubre,Israel,376,1,0,1,"(11.117806,-74.232622)"
2016,Noviembre,Japón,392,2,2,4,"(12.586067,-81.702563)"
2014,Marzo,Israel,376,9,11,20,"(-4.197703,-69.941278)"
2012,Abril,Japón,392,11,20,31,"(0.814836,-77.662532)"
2019,Febrero,China,156,1,1,2,"(-4.197703,-69.941278)"
2017,Noviembre,Australia,36,0,1,1,"(0.25129,-76.875963)"
2020,Diciembre,San  Vicente y las Granadinas,670,0,1,1,"(4.697144,-74.140516)"
2017,Julio,Estonia,233,6,9,15,"(10.445761,-75.516429)"
2019,Agosto,Nicaragua,558,31,31,62,"(10.445761,-75.516429)"
2017,Febrero,Islas Vírgenes Británicas/Territorio Británico de Ultramar,92,2,0,2,"(6.171601,-75.427454)"
2023,Abril,Serbia,688,1,7,8,"(10.445761,-75.516429)"
2012,Noviembre,Hungría,348,1,0,1,"(10.445761,-75.516429)"
2014,Noviembre,México,484,20,53,73,"(10.886611,-74.776708)"
2012,Julio,Estados Unidos de América,840,1796,2985,4781,"(6.171601,-75.427454)"
2019,Diciembre,Indonesia,360,1,0,1,"(6.171601,-75.427454)"
2014,Octubre,Filipinas,608,0,19,19,"(10.971302,-74.765397)"
2014,Agosto,Letonia,428,5,5,10,"(4.697144,-74.140516)"
2014,Enero,Brasil,76,42,36,78,"(12.586067,-81.702563)"
2013,Diciembre,Reino Unido de Gran Bretaña e Irlanda del Norte,826,1,1,2,"(4.452882,-75.766298)"
2013,Julio,Japón,392,143,501,644,"(4.697144,-74.140516)"
2021,Septiembre,Francia,250,5,8,13,"(10.408582,-75.538003)"
2014,Febrero,Costa Rica,188,433,663,1096,"(4.697144,-74.140516)"
2022,Agosto,Georgia,268,1,1,2,"(6.171601,-75.427454)"
2014,Agosto,Francia,250,1,1,2,"(4.452882,-75.766298)"
2017,Octubre,Argentina,32,107,172,279,"(0.814836,-77.662532)"
2013,Diciembre,Reino Unido de Gran Bretaña e Irlanda del Norte,826,3,13,16,"(-4.197703,-69.941278)"
2021,Noviembre,903,99999,1,0,1,"(4.697144,-74.140516)"
2020,Septiembre,Honduras,340,2,1,3,"(10.445761,-75.516429)"
2016,Febrero,Zimbabue,716,0,1,1,"(4.697144,-74.140516)"
2019,Febrero,Bolivia,68,1,1,2,"(-4.197703,-69.941278)"
2019,Abril,España,724,1,4,5,"(7.088729,-70.740253)"
2018,Marzo,Ecuador,218,0,2,2,"(7.128456,-73.183637)"
2013,Septiembre,Estados Unidos de América,840,1,1,2,"(10.971302,-74.765397)"
2019,Noviembre,España,724,130,248,378,"(10.445761,-75.516429)"
2013,Octubre,Italia,380,3,11,14,"(10.886611,-74.776708)"
2014,Septiembre,Turquía,792,0,1,1,"(11.247723,-74.213989)"
2023,Abril,San  Vicente y las Granadinas,670,3,4,7,"(4.697144,-74.140516)"
2012,Abril,Canadá,124,25,43,68,"(3.541112,-76.384584)"
2015,Enero,Venezuela,862,9,13,22,"(4.815061,-75.736532)"
2019,Noviembre,India,356,0,1,1,"(0.814836,-77.662532)"
2022,Agosto,Finlandia,246,11,12,23,"(6.171601,-75.427454)"
2017,Abril,Desconocido,99999,68,144,212,"(4.697144,-74.140516)"
2023,Junio,Argentina,32,525,425,950,"(10.445761,-75.516429)"
2023,Enero,Dominica,212,1,2,3,"(10.445761,-75.516429)"
2013,Octubre,Japón,392,1,0,1,"(11.360009,-72.129330)"
2019,Abril,República de Irlanda,372,1,2,3,"(11.247723,-74.213989)"
2020,Enero,Filipinas,608,3,0,3,"(12.586067,-81.702563)"
2020,Marzo,Islandia,352,0,7,7,"(4.697144,-74.140516)"
2019,Abril,Panamá,591,1417,1343,2761,"(6.171601,-75.427454)"
2018,Mayo,Austria,40,2,0,2,"(8.635765,-77.346578)"
2018,Noviembre,Estados Unidos de América,840,9795,16974,26769,"(4.697144,-74.140516)"
2012,Noviembre,Francia,250,28,89,117,"(6.171601,-75.427454)"
2012,Enero,Brasil,76,1,1,2,"(7.128456,-73.183637)"
2015,Marzo,Australia,36,12,23,35,"(3.541112,-76.384584)"
2022,Septiembre,Bolivia,68,1,1,2,"(7.927209,-72.507910)"
2018,Diciembre,Uganda,800,1,1,2,"(4.697144,-74.140516)"
2016,Mayo,Honduras,340,230,247,477,"(4.697144,-74.140516)"
2018,Octubre,Australia,36,0,1,1,"(11.360009,-72.129330)"
2022,Noviembre,México,484,4,6,10,"(11.360009,-72.129330)"
2016,Abril,Camboya,116,0,2,2,"(4.697144,-74.140516)"
2022,Diciembre,Kenia,404,0,1,1,"(10.445761,-75.516429)"
2014,Mayo,El Salvador,222,3,2,5,"(10.886611,-74.776708)"
2019,Diciembre,Perú,604,7,17,24,"(-4.197703,-69.941278)"
2023,Marzo,República de Irlanda,372,42,36,78,"(10.445761,-75.516429)"
2022,Mayo,Nueva Zelanda,554,3,2,5,"(3.541112,-76.384584)"
2023,Mayo,Polonia,616,2,5,7,"(10.886611,-74.776708)"
2023,Febrero,Polonia,616,36,45,81,"(6.171601,-75.427454)"
2021,Febrero,Tailandia,764,6,1,7,"(4.697144,-74.140516)"
2012,Agosto,Trinidad y Tobago,780,1,2,3,"(11.360009,-72.129330)"
2014,Enero,Italia,380,19,98,117,"(3.541112,-76.384584)"
2015,Noviembre,Federación de Rusia,643,0,1,1,"(0.25129,-76.875963)"
2017,Diciembre,Nicaragua,558,21,10,31,"(10.445761,-75.516429)"
2015,Marzo,Federación de Rusia,643,7,7,14,"(3.541112,-76.384584)"
2020,Octubre,China,156,2,4,6,"(6.171601,-75.427454)"
2013,Abril,Países Bajos,528,5,15,20,"(10.408582,-75.538003)"
2022,Mayo,Venezuela,862,12,14,26,"(4.815061,-75.736532)"
2017,Enero,Países Bajos,528,227,357,584,"(6.171601,-75.427454)"
2018,Enero,Túnez,788,6,8,14,"(4.697144,-74.140516)"
2021,Diciembre,Honduras,340,250,226,476,"(4.697144,-74.140516)"
2018,Mayo,México,484,77,170,247,"(3.541112,-76.384584)"
2019,Noviembre,Suiza,756,16,19,35,"(10.408582,-75.538003)"
2018,Octubre,Uzbekistán,860,0,2,2,"(4.697144,-74.140516)"
2020,Febrero,Ucrania,804,1,3,4,"(0.814836,-77.662532)"
2019,Febrero,México,484,0,4,4,"(11.360009,-72.129330)"
2013,Septiembre,Guyana,328,0,1,1,"(10.408582,-75.538003)"
2020,Febrero,Nepal,524,0,4,4,"(6.171601,-75.427454)"
2013,Julio,Mauritania,478,0,1,1,"(4.697144,-74.140516)"
2023,Marzo,Portugal,620,28,36,64,"(10.445761,-75.516429)"
2017,Octubre,Bosnia y Herzegovina,70,0,1,1,"(10.445761,-75.516429)"
2022,Octubre,Portugal,620,0,1,1,"(3.893038,-77.067921)"
2019,Noviembre,Canadá,124,1346,2363,3709,"(4.697144,-74.140516)"
2020,Marzo,Estados Unidos de América,840,377,618,995,"(10.886611,-74.776708)"
2018,Febrero,Venezuela,862,14,12,26,"(7.128456,-73.183637)"
2012,Abril,Puerto Rico/Territorio de Estados Unidos,630,0,2,2,"(3.541112,-76.384584)"
2018,Julio,Bolivia,68,78,58,137,"(6.171601,-75.427454)"
2019,Diciembre,San  Vicente y las Granadinas,670,1,1,2,"(6.171601,-75.427454)"
2023,Abril,Uruguay,858,27,18,45,"(12.586067,-81.702563)"
2017,Julio,Vietnam,704,10,12,22,"(4.697144,-74.140516)"
2023,Marzo,Turquía,792,7,24,31,"(6.171601,-75.427454)"
2017,Diciembre,Dinamarca,208,1,0,1,"(12.5744111,-81.703935)"
2022,Julio,República de Moldavia,498,0,1,1,"(10.886611,-74.776708)"
2021,Diciembre,Túnez,788,6,11,17,"(4.697144,-74.140516)"
2014,Junio,Sudáfrica,710,2,7,9,"(10.408582,-75.538003)"
2015,Febrero,República Democrática del Congo,180,2,6,8,"(4.697144,-74.140516)"
2022,Mayo,Rumania,642,0,1,1,"(4.815061,-75.736532)"
2017,Febrero,Malta,470,0,1,1,"(0.814836,-77.662532)"
2022,Marzo,Suiza,756,64,107,171,"(6.171601,-75.427454)"
2014,Octubre,Eslovenia,705,0,1,1,"(0.814836,-77.662532)"
2015,Diciembre,Estados Unidos de América,840,11867,18252,30119,"(4.697144,-74.140516)"
2013,Enero,Jamaica,388,0,1,1,"(7.818934,-72.453226)"
2017,Enero,Canadá,124,1,1,2,"(11.247723,-74.213989)"
2014,Mayo,Guatemala,320,26,91,117,"(6.171601,-75.427454)"
2021,Agosto,Desconocido,99999,0,1,1,"(6.171601,-75.427454)"
2019,Enero,Venezuela,862,2,9,11,"(7.927209,-72.507910)"
2017,Marzo,Bután,64,1,1,2,"(4.697144,-74.140516)"
2018,Septiembre,Trinidad y Tobago,780,0,1,1,"(11.247723,-74.213989)"
2020,Enero,Australia,36,0,1,1,"(7.818934,-72.453226)"
2013,Diciembre,Indonesia,360,0,1,1,"(3.541112,-76.384584)"
2022,Abril,Panamá,591,2,5,7,"(8.635765,-77.346578)"
2018,Junio,Francia,250,114,170,284,"(10.445761,-75.516429)"
2012,Abril,Barbados,52,1,1,2,"(7.128456,-73.183637)"
2017,Junio,Rumania,642,7,8,15,"(10.445761,-75.516429)"
2018,Noviembre,Federación de Rusia,643,7,4,11,"(0.814836,-77.662532)"
2019,Enero,Uruguay,858,45,15,60,"(10.408582,-75.538003)"
2016,Enero,Bahréin,48,0,1,1,"(4.697144,-74.140516)"
2017,Diciembre,Venezuela,862,214,223,437,"(10.445761,-75.516429)"
2021,Junio,Perú,604,952,1295,2247,"(4.697144,-74.140516)"
2012,Agosto,República Árabe Siria,760,0,1,1,"(11.360009,-72.129330)"
2012,Febrero,Kenia,404,0,1,1,"(11.360009,-72.129330)"
2022,Mayo,Venezuela,862,0,2,2,"(12.165168,-71.983761)"
2022,Diciembre,Costa Rica,188,5,11,16,"(4.815061,-75.736532)"
2018,Septiembre,Luxemburgo,442,4,14,18,"(4.697144,-74.140516)"
2019,Abril,Bolivia,68,17,31,48,"(6.171601,-75.427454)"
2014,Mayo,Nicaragua,558,2,2,4,"(4.815061,-75.736532)"
2015,Abril,Georgia,268,2,1,3,"(4.697144,-74.140516)"
2016,Enero,Suecia,752,7,8,15,"(11.247723,-74.213989)"
2018,Diciembre,Luxemburgo,442,1,2,3,"(6.171601,-75.427454)"
2012,Septiembre,República Checa,203,0,1,1,"(3.541112,-76.384584)"
2013,Marzo,Noruega,578,0,1,1,"(8.635765,-77.346578)"
2012,Enero,Canadá,124,5,16,21,"(10.886611,-74.776708)"
2017,Mayo,India,356,10,43,53,"(10.445761,-75.516429)"
2017,Junio,Francia,250,5,3,8,"(0.25129,-76.875963)"
2017,Junio,Suiza,756,2,7,9,"(8.635765,-77.346578)"
2023,Junio,Federación de Rusia,643,3,4,7,"(10.886611,-74.776708)"
2019,Agosto,Haití,332,2,4,6,"(10.886611,-74.776708)"
2013,Agosto,Marruecos,504,2,8,10,"(4.697144,-74.140516)"
2014,Noviembre,Chile,152,3,2,5,"(4.815061,-75.736532)"
2013,Octubre,México,484,2,37,39,"(4.815061,-75.736532)"
2021,Diciembre,Rumania,642,73,89,162,"(4.697144,-74.140516)"
2023,Enero,Croacia,191,35,72,107,"(4.697144,-74.140516)"
2018,Noviembre,Alemania,276,0,1,1,"(11.360009,-72.129330)"
2017,Septiembre,Irán,364,0,1,1,"(10.408582,-75.538003)"
2018,Septiembre,Hong Kong,344,1,1,2,"(0.814836,-77.662532)"
2015,Enero,Dinamarca,208,0,2,2,"(10.971302,-74.765397)"
2022,Noviembre,Países Bajos,528,4,4,8,"(11.360009,-72.129330)"
2022,Febrero,Panamá,591,1936,1724,3660,"(6.171601,-75.427454)"
2015,Julio,Hong Kong,344,0,1,1,"(0.814836,-77.662532)"
2012,Mayo,Costa Rica,188,315,549,864,"(4.697144,-74.140516)"
2017,Enero,Grecia,300,0,1,1,"(9.402978,-75.681599)"
2013,Agosto,El Salvador,222,1,2,3,"(0.814836,-77.662532)"
2014,Mayo,Suecia,752,4,9,13,"(6.171601,-75.427454)"
2022,Noviembre,Guatemala,320,0,2,2,"(7.818934,-72.453226)"
2015,Noviembre,Portugal,620,3,7,10,"(10.886611,-74.776708)"
2019,Febrero,Argentina,32,4539,5660,10199,"(4.697144,-74.140516)"
2012,Diciembre,Albania,8,1,2,3,"(4.697144,-74.140516)"
2014,Noviembre,Egipto,818,0,1,1,"(6.171601,-75.427454)"
2022,Junio,Tailandia,764,3,0,3,"(6.171601,-75.427454)"
2012,Enero,Chile,152,0,1,1,"(7.927209,-72.507910)"
2018,Noviembre,Paraguay,600,1,3,4,"(10.408582,-75.538003)"
2016,Octubre,Argelia,12,3,5,8,"(4.697144,-74.140516)"
2018,Abril,Malta,470,0,1,1,"(6.171601,-75.427454)"
2021,Septiembre,Indonesia,360,12,24,37,"(4.697144,-74.140516)"
2019,Mayo,Italia,380,7,11,18,"(10.408582,-75.538003)"
2019,Marzo,Nueva Zelanda,554,0,1,1,"(13.3387613,-81.372937)"
2013,Octubre,Santa Sede/Ciudad del Vaticano,336,0,1,1,"(4.697144,-74.140516)"
2015,Enero,Bahamas,44,0,1,1,"(10.445761,-75.516429)"
2019,Junio,España,724,553,947,1500,"(6.171601,-75.427454)"
2012,Mayo,Trinidad y Tobago,780,1,3,4,"(7.128456,-73.183637)"
2022,Diciembre,Turkmenistán,795,1,10,11,"(4.697144,-74.140516)"
2020,Enero,Jamaica,388,13,18,31,"(4.697144,-74.140516)"
2019,Agosto,Panamá,591,3,5,8,"(0.814836,-77.662532)"
2018,Diciembre,Grecia,300,4,9,13,"(10.445761,-75.516429)"
2015,Diciembre,Reino Unido de Gran Bretaña e Irlanda del Norte,826,0,3,3,"(11.247723,-74.213989)"
2022,Mayo,Bélgica,56,4,1,5,"(10.408582,-75.538003)"
2015,Mayo,República de Irlanda,372,0,1,1,"(10.886611,-74.776708)"
2012,Julio,Japón,392,0,2,2,"(-4.197703,-69.941278)"
2017,Noviembre,Países Bajos,528,2,2,4,"(0.25129,-76.875963)"
2020,Septiembre,Haití,332,0,1,1,"(4.697144,-74.140516)"
2020,Febrero,Georgia,268,1,1,2,"(10.445761,-75.516429)"
2015,Enero,Argentina,32,2,3,5,"(7.927209,-72.507910)"
2019,Julio,Venezuela,862,54,34,88,"(6.185799,-67.483929)"
2022,Diciembre,Brasil,76,408,416,825,"(6.171601,-75.427454)"
2018,Enero,Panamá,591,2,6,8,"(7.102626,-77.762647)"
2022,Septiembre,Venezuela,862,16,28,44,"(-4.197703,-69.941278)"
2015,Agosto,República Checa,203,0,1,1,"(3.541112,-76.384584)"
2022,Enero,Países Bajos,528,1,2,3,"(-4.197703,-69.941278)"
2019,Septiembre,Australia,36,0,1,1,"(4.452882,-75.766298)"
2022,Diciembre,República Dominicana,214,0,2,2,"(10.408582,-75.538003)"
2014,Febrero,República de Kosovo,901,1,0,1,"(4.697144,-74.140516)"
2022,Marzo,Uruguay,858,0,2,2,"(7.128456,-73.183637)"
2016,Septiembre,Alemania,276,2,5,7,"(7.818934,-72.453226)"
2016,Octubre,México,484,1,3,4,"(-4.197703,-69.941278)"
2023,Enero,Polonia,616,1,0,1,"(8.364293,-72.405710)"
2015,Octubre,Argentina,32,0,1,1,"(7.927209,-72.507910)"
2014,Julio,Italia,380,6,7,13,"(10.408582,-75.538003)"
2022,Diciembre,Taiwán,158,7,8,15,"(6.171601,-75.427454)"
2012,Septiembre,Brasil,76,52,117,169,"(6.171601,-75.427454)"
2016,Abril,Australia,36,16,16,32,"(3.541112,-76.384584)"
2013,Mayo,República Democrática del Congo,180,1,0,1,"(6.171601,-75.427454)"
2014,Septiembre,Malasia,458,0,2,2,"(6.171601,-75.427454)"
2021,Octubre,República de Belarús,112,7,12,19,"(4.697144,-74.140516)"
2018,Agosto,Guyana,328,0,1,1,"(7.818934,-72.453226)"
2018,Agosto,Francia,250,212,334,546,"(6.171601,-75.427454)"
2015,Julio,Grecia,300,0,2,2,"(10.971302,-74.765397)"
2017,Marzo,Islandia,352,1,1,2,"(0.814836,-77.662532)"
2012,Enero,Taiwán,158,5,3,8,"(6.171601,-75.427454)"
2018,Febrero,Bulgaria,100,4,2,6,"(3.541112,-76.384584)"
2017,Abril,Croacia,191,1,0,1,"(10.886611,-74.776708)"
2019,Noviembre,Líbano,422,0,1,1,"(6.171601,-75.427454)"
2017,Julio,España,724,21,30,51,"(7.818934,-72.453226)"
2017,Julio,Bangladesh,50,0,1,1,"(10.971302,-74.765397)"
2014,Octubre,República de Corea,410,1,1,2,"(12.586067,-81.702563)"
2021,Agosto,Ecuador,218,95,144,239,"(6.171601,-75.427454)"
2014,Enero,Portugal,620,2,1,3,"(7.927209,-72.507910)"
2016,Febrero,Alemania,276,33,67,100,"(10.445761,-75.516429)"
2012,Diciembre,Reino Unido de Gran Bretaña e Irlanda del Norte,826,14,34,48,"(3.541112,-76.384584)"
2019,Febrero,Belice,84,0,1,1,"(6.171601,-75.427454)"
2015,Junio,Guatemala,320,7,15,22,"(10.886611,-74.776708)"
2017,Septiembre,Japón,392,2,6,8,"(0.814836,-77.662532)"
2012,Abril,Nicaragua,558,1,2,3,"(10.886611,-74.776708)"
2019,Marzo,Panamá,591,643,582,1225,"(10.445761,-75.516429)"
2016,Marzo,El Salvador,222,141,138,279,"(6.171601,-75.427454)"
2018,Diciembre,Australia,36,3,3,6,"(11.247723,-74.213989)"
2015,Marzo,Tailandia,764,5,1,6,"(10.445761,-75.516429)"
2022,Agosto,Federación de Rusia,643,1,0,1,"(11.360009,-72.129330)"
2018,Enero,Francia,250,13,12,25,"(8.635765,-77.346578)"
2019,Octubre,Austria,40,0,1,1,"(4.815061,-75.736532)"
2022,Febrero,Australia,36,7,12,19,"(10.445761,-75.516429)"
2016,Octubre,Nicaragua,558,1,2,3,"(12.586067,-81.702563)"
2019,Noviembre,Suiza,756,67,133,200,"(6.171601,-75.427454)"
2014,Enero,Nueva Zelanda,554,38,47,85,"(4.697144,-74.140516)"
2017,Julio,China,156,6,18,24,"(3.541112,-76.384584)"
2015,Noviembre,Estonia,233,1,0,1,"(3.541112,-76.384584)"
2012,Febrero,Polonia,616,12,21,33,"(0.814836,-77.662532)"
2014,Agosto,Cabo Verde,132,1,3,4,"(4.697144,-74.140516)"
2012,Diciembre,Costa Rica,188,5,4,9,"(7.128456,-73.183637)"
2018,Enero,Alemania,276,2,1,3,"(11.360009,-72.129330)"
2013,Mayo,Mauricio,480,1,1,2,"(6.171601,-75.427454)"
2013,Agosto,Venezuela,862,38,109,147,"(10.886611,-74.776708)"
2017,Julio,Italia,380,1,2,3,"(8.635765,-77.346578)"
2012,Marzo,Bolivia,68,10,12,22,"(3.541112,-76.384584)"
2022,Octubre,Barbados,52,1,2,3,"(3.541112,-76.384584)"
2018,Enero,Malasia,458,2,2,4,"(10.445761,-75.516429)"
2020,Noviembre,Ecuador,218,0,28,29,"(10.408582,-75.538003)"
2021,Octubre,Portugal,620,6,6,12,"(10.886611,-74.776708)"
2017,Agosto,Bután,64,0,1,1,"(4.697144,-74.140516)"
2021,Enero,Montenegro,499,0,1,1,"(6.171601,-75.427454)"
2018,Abril,Panamá,591,1515,1662,3177,"(4.697144,-74.140516)"
2016,Abril,Paraguay,600,4,2,6,"(10.408582,-75.538003)"
2021,Julio,Macedonia,807,0,1,1,"(6.171601,-75.427454)"
2019,Septiembre,Malasia,458,2,2,6,"(6.171601,-75.427454)"
2012,Febrero,Polonia,616,0,3,3,"(6.171601,-75.427454)"
2017,Abril,Países Bajos,528,198,294,492,"(6.171601,-75.427454)"
2018,Julio,Bermudas/Territorio Británico de Ultramar,60,4,5,9,"(4.697144,-74.140516)"
2018,Mayo,Jamaica,388,20,30,50,"(4.697144,-74.140516)"
2017,Mayo,Países Bajos,528,1,3,4,"(11.360009,-72.129330)"
2012,Octubre,Nueva Zelanda,554,6,16,22,"(0.814836,-77.662532)"
2019,Diciembre,Honduras,340,1,8,9,"(10.886611,-74.776708)"
2019,Noviembre,Ucrania,804,2,2,4,"(6.171601,-75.427454)"
2013,Agosto,Antigua y Barbuda,28,0,1,1,"(6.171601,-75.427454)"
2018,Abril,Bulgaria,100,0,1,1,"(10.886611,-74.776708)"
2017,Junio,Países Bajos,528,1211,1563,2774,"(4.697144,-74.140516)"
2022,Marzo,Estados Unidos de América,840,447,690,1137,"(4.815061,-75.736532)"
2014,Julio,Países Bajos,528,8,10,18,"(4.815061,-75.736532)"
2021,Noviembre,Dinamarca,208,3,0,3,"(10.408582,-75.538003)"
2014,Agosto,Kazajistán,398,2,8,10,"(4.697144,-74.140516)"
2013,Agosto,República Árabe Siria,760,0,7,7,"(4.697144,-74.140516)"
2015,Mayo,Nueva Zelanda,554,0,1,1,"(7.128456,-73.183637)"
2023,Junio,Sri Lanka,144,0,4,4,"(4.697144,-74.140516)"
2014,Marzo,Uganda,800,1,1,2,"(6.171601,-75.427454)"
2022,Agosto,Myanmar,104,0,1,1,"(10.445761,-75.516429)"
2017,Mayo,Polonia,616,5,14,19,"(10.445761,-75.516429)"
2023,Mayo,Australia,36,7,11,18,"(10.886611,-74.776708)"
2019,Abril,Indonesia,360,2,2,4,"(6.171601,-75.427454)"
2014,Noviembre,Canadá,124,1,1,2,"(13.3387613,-81.372937)"
2014,Enero,Venezuela,862,97,103,200,"(3.541112,-76.384584)"
2022,Septiembre,Chile,152,7,11,18,"(11.360009,-72.129330)"
2023,Mayo,India,356,22,110,132,"(10.445761,-75.516429)"
2018,Enero,República de Corea,410,1,2,3,"(10.408582,-75.538003)"
2016,Diciembre,Canadá,124,394,445,839,"(10.445761,-75.516429)"
2017,Noviembre,Alemania,276,4,6,10,"(7.818934,-72.453226)"
2018,Septiembre,Guatemala,320,19,47,66,"(10.886611,-74.776708)"
2016,Octubre,Israel,376,2,17,19,"(0.814836,-77.662532)"
2017,Noviembre,Eslovenia,705,1,8,9,"(6.171601,-75.427454)"
2016,Agosto,Paraguay,600,127,144,271,"(4.697144,-74.140516)"
2019,Julio,Suiza,756,0,2,2,"(0.25129,-76.875963)"
2019,Diciembre,Nigeria,566,0,1,1,"(10.886611,-74.776708)"
2018,Marzo,Cuba,192,2,2,4,"(4.815061,-75.736532)"
2015,Octubre,India,356,0,9,9,"(10.971302,-74.765397)"
2022,Abril,Haití,332,0,1,1,"(10.886611,-74.776708)"
2017,Septiembre,Cabo Verde,132,1,0,1,"(0.814836,-77.662532)"
2012,Diciembre,Belice,84,0,1,1,"(10.886611,-74.776708)"
2021,Octubre,República Checa,203,2,2,4,"(11.247723,-74.213989)"
2017,Diciembre,Países Bajos,528,48,80,128,"(3.541112,-76.384584)"
2013,Julio,Japón,392,1,0,1,"(-4.197703,-69.941278)"
2016,Agosto,Estados Unidos de América,840,3498,4655,8153,"(10.445761,-75.516429)"
2022,Mayo,Canadá,124,179,640,819,"(6.171601,-75.427454)"
2016,Junio,Luxemburgo,442,3,12,15,"(4.697144,-74.140516)"
2022,Diciembre,República de Irlanda,372,132,263,395,"(4.697144,-74.140516)"
2022,Noviembre,República Árabe de Yemen,887,0,1,1,"(0.814836,-77.662532)"
2015,Mayo,Alemania,276,2,0,2,"(0.25129,-76.875963)"
2016,Diciembre,Guatemala,320,183,214,397,"(10.445761,-75.516429)"
2017,Marzo,Iraq,368,0,3,3,"(4.697144,-74.140516)"
2017,Diciembre,Portugal,620,10,21,31,"(7.818934,-72.453226)"
2020,Febrero,República Árabe Siria,760,0,2,2,"(10.445761,-75.516429)"
2012,Julio,Países Bajos,528,0,1,1,"(11.247723,-74.213989)"
2016,Abril,Indonesia,360,0,3,3,"(10.408582,-75.538003)"
2015,Abril,Sudáfrica,710,30,71,101,"(4.697144,-74.140516)"
2016,Octubre,Nueva Zelanda,554,0,1,1,"(12.586067,-81.702563)"
2022,Abril,Dominica,212,0,2,2,"(3.541112,-76.384584)"
2014,Febrero,Cuba,192,0,1,1,"(10.408582,-75.538003)"
2018,Marzo,Venezuela,862,5215,5546,10761,"(4.697144,-74.140516)"
2017,Agosto,Nigeria,566,1,0,1,"(6.171601,-75.427454)"
2016,Octubre,Uruguay,858,1,4,5,"(4.815061,-75.736532)"
2015,Octubre,Panamá,591,0,4,4,"(0.814836,-77.662532)"
2016,Noviembre,Suecia,752,21,24,45,"(6.171601,-75.427454)"
2012,Febrero,Bolivia,68,10,13,23,"(10.445761,-75.516429)"
2014,Agosto,Costa Rica,188,5,27,32,"(4.815061,-75.736532)"
2015,Diciembre,Filipinas,608,1,9,10,"(10.886611,-74.776708)"
2022,Septiembre,Australia,36,193,354,547,"(4.697144,-74.140516)"
2016,Junio,Reino Unido de Gran Bretaña e Irlanda del Norte,826,2,3,5,"(12.586067,-81.702563)"
2012,Diciembre,México,484,7,31,38,"(7.818934,-72.453226)"
2018,Diciembre,Austria,40,1,1,2,"(11.247723,-74.213989)"
2014,Mayo,Bahamas,44,0,1,1,"(6.171601,-75.427454)"
2017,Mayo,Honduras,340,31,27,58,"(3.541112,-76.384584)"
2016,Mayo,Belice,84,3,2,5,"(6.171601,-75.427454)"
2018,Abril,San  Vicente y las Granadinas,670,0,1,1,"(10.445761,-75.516429)"
2021,Enero,Honduras,340,0,8,8,"(12.5744111,-81.703935)"
2017,Febrero,Paraguay,600,2,1,3,"(10.408582,-75.538003)"
2015,Diciembre,Canadá,124,0,1,1,"(11.117806,-74.232622)"
2012,Junio,Perú,604,5,7,12,"(11.360009,-72.129330)"
2016,Octubre,Ghana,288,1,0,1,"(6.171601,-75.427454)"
2018,Julio,Estados Unidos de América,840,55,86,141,"(7.128456,-73.183637)"
2018,Febrero,Etiopia,231,2,3,5,"(4.697144,-74.140516)"
2015,Febrero,Dinamarca,208,0,1,1,"(8.635765,-77.346578)"
2018,Junio,Filipinas,608,9,51,60,"(10.445761,-75.516429)"
2019,Febrero,China,156,1,3,4,"(4.815061,-75.736532)"
2017,Diciembre,Líbano,422,0,2,2,"(3.541112,-76.384584)"
2019,Noviembre,Serbia,688,0,1,1,"(10.886611,-74.776708)"
2021,Octubre,China,156,70,303,373,"(4.697144,-74.140516)"
2021,Febrero,Trinidad y Tobago,780,2,2,4,"(4.697144,-74.140516)"
2022,Noviembre,Nicaragua,558,25,36,61,"(6.171601,-75.427454)"
2022,Enero,República Checa,203,0,2,2,"(11.247723,-74.213989)"
2016,Marzo,República de Corea,410,3,3,6,"(7.818934,-72.453226)"
2017,Noviembre,Lesoto,426,1,0,1,"(4.697144,-74.140516)"
2015,Junio,Lituania,440,1,0,1,"(10.408582,-75.538003)"
2013,Junio,Alemania,276,5,5,10,"(11.360009,-72.129330)"
2013,Mayo,Países Bajos,528,1,5,6,"(10.445761,-75.516429)"
2018,Diciembre,Ecuador,218,43,33,76,"(1.813928,-78.763924)"
2020,Febrero,República Dominicana,214,1105,1216,2321,"(4.697144,-74.140516)"
2017,Marzo,Jamaica,388,5,4,9,"(10.445761,-75.516429)"
2022,Abril,Lituania,440,29,18,47,"(4.697144,-74.140516)"
2014,Abril,Serbia,688,0,1,1,"(6.171601,-75.427454)"
2012,Octubre,Lituania,440,0,2,2,"(10.408582,-75.538003)"
2015,Junio,Uzbekistán,860,1,0,1,"(4.697144,-74.140516)"
2022,Agosto,Cuba,192,20,34,54,"(6.171601,-75.427454)"
2014,Diciembre,Costa Rica,188,0,2,2,"(8.635765,-77.346578)"
2013,Junio,Albania,8,1,2,3,"(4.697144,-74.140516)"
2021,Febrero,Perú,604,1,5,6,"(-4.223468,-69.945098)"
2019,Mayo,España,724,155,310,465,"(3.541112,-76.384584)"
2012,Septiembre,Guatemala,320,0,1,1,"(10.408582,-75.538003)"
2016,Septiembre,Polonia,616,2,9,11,"(6.171601,-75.427454)"
2023,Abril,Tanzania,834,0,1,1,"(10.445761,-75.516429)"
2014,Noviembre,Suecia,752,1,4,5,"(10.886611,-74.776708)"
2014,Diciembre,Singapur,702,1,0,1,"(3.541112,-76.384584)"
2016,Noviembre,Cuba,192,18,17,35,"(3.541112,-76.384584)"
2015,Julio,Dinamarca,208,2,4,6,"(10.408582,-75.538003)"
2018,Agosto,Noruega,578,2,0,2,"(8.635765,-77.346578)"
2018,Enero,Luxemburgo,442,1,1,2,"(6.171601,-75.427454)"
2013,Enero,Italia,380,0,1,1,"(11.247723,-74.213989)"
2014,Abril,Austria,40,2,1,3,"(10.886611,-74.776708)"
2017,Junio,Chile,152,1,7,8,"(7.128456,-73.183637)"
2012,Abril,México,484,27,86,113,"(3.541112,-76.384584)"
2017,Octubre,Austria,40,10,21,31,"(10.445761,-75.516429)"
2022,Diciembre,Benín,204,0,1,1,"(10.445761,-75.516429)"
2014,Junio,Hungría,348,12,24,36,"(4.697144,-74.140516)"
2022,Noviembre,República Democrática del Congo,180,2,11,13,"(4.697144,-74.140516)"
2018,Octubre,Polonia,616,7,22,29,"(6.171601,-75.427454)"
2022,Julio,Panamá,591,0,2,2,"(12.5744111,-81.703935)"
2017,Diciembre,Uruguay,858,5,7,12,"(7.818934,-72.453226)"
2021,Septiembre,Costa Rica,188,16,14,30,"(4.815061,-75.736532)"
2014,Octubre,Nicaragua,558,1,2,3,"(10.886611,-74.776708)"
2022,Noviembre,Portugal,620,2,1,3,"(11.117806,-74.232622)"
2019,Septiembre,Estados Unidos de América,840,7,12,19,"(11.360009,-72.129330)"
2022,Mayo,Mozambique,508,0,1,1,"(4.697144,-74.140516)"
2014,Mayo,República Dominicana,214,27,59,86,"(10.445761,-75.516429)"
2019,Julio,Kazajistán,398,1,0,1,"(6.171601,-75.427454)"
2015,Julio,República de Irlanda,372,21,17,38,"(0.814836,-77.662532)"
2013,Mayo,Ucrania,804,0,2,2,"(10.445761,-75.516429)"
2016,Octubre,Bangladesh,50,0,2,2,"(4.697144,-74.140516)"
2016,Septiembre,Argentina,32,92,136,228,"(0.814836,-77.662532)"
2023,Enero,Irán,364,1,2,3,"(6.171601,-75.427454)"
2012,Enero,Federación de Rusia,643,4,0,4,"(12.586067,-81.702563)"
2014,Noviembre,Lituania,440,0,1,1,"(0.814836,-77.662532)"
2022,Febrero,Túnez,788,9,14,23,"(4.697144,-74.140516)"
2018,Junio,Panamá,591,1206,1029,2235,"(6.171601,-75.427454)"
2014,Octubre,Barbados,52,1,0,1,"(10.445761,-75.516429)"
2017,Diciembre,Dinamarca,208,0,4,4,"(4.815061,-75.736532)"
2012,Marzo,Reino Unido de Gran Bretaña e Irlanda del Norte,826,5,5,10,"(11.360009,-72.129330)"
2018,Mayo,San Cristóbal y Nevis,659,0,1,1,"(10.445761,-75.516429)"
2022,Marzo,Francia,250,0,2,2,"(7.128456,-73.183637)"
2014,Enero,Alemania,276,39,54,93,"(3.541112,-76.384584)"
2023,Febrero,Croacia,191,1,10,11,"(10.445761,-75.516429)"
2022,Septiembre,Francia,250,4,8,12,"(4.815061,-75.736532)"
2023,Marzo,Cuba,192,0,1,1,"(7.088729,-70.740253)"
2013,Abril,Noruega,578,9,7,16,"(0.814836,-77.662532)"
2021,Mayo,Brunei Darussalam,96,1,0,1,"(4.697144,-74.140516)"
2018,Diciembre,Japón,392,247,445,692,"(4.697144,-74.140516)"
2014,Octubre,Ghana,288,0,8,8,"(10.971302,-74.765397)"
2019,Julio,Italia,380,81,170,251,"(10.445761,-75.516429)"
2017,Agosto,India,356,1,0,1,"(4.815061,-75.736532)"
2017,Agosto,Albania,8,1,1,2,"(6.171601,-75.427454)"
2018,Mayo,Belice,84,0,1,1,"(3.541112,-76.384584)"
2019,Marzo,Cuba,192,182,347,530,"(4.697144,-74.140516)"
2022,Julio,México,484,7,14,21,"(7.927209,-72.507910)"
2019,Agosto,Bahamas,44,8,21,29,"(4.697144,-74.140516)"
2014,Septiembre,República de Irlanda,372,1,2,3,"(8.635765,-77.346578)"
2015,Diciembre,Noruega,578,11,12,23,"(6.171601,-75.427454)"
2015,Febrero,Uruguay,858,0,1,1,"(11.360009,-72.129330)"
2022,Mayo,Austria,40,2,1,3,"(-4.197703,-69.941278)"
2022,Diciembre,Portugal,620,5,4,9,"(10.886611,-74.776708)"
2015,Mayo,Bután,64,0,1,1,"(4.697144,-74.140516)"
2021,Noviembre,Suecia,752,10,29,39,"(6.171601,-75.427454)"
2019,Abril,Albania,8,0,1,1,"(3.541112,-76.384584)"
2014,Diciembre,República de Corea,410,0,1,1,"(0.25129,-76.875963)"
2015,Mayo,Rumania,642,1,0,1,"(4.815061,-75.736532)"
2014,Febrero,República de Corea,410,0,1,1,"(11.360009,-72.129330)"
2013,Julio,Suecia,752,1,1,2,"(11.360009,-72.129330)"
2012,Agosto,Países Bajos,528,30,30,60,"(11.528919,-72.919681)"
2013,Noviembre,Barbados,52,0,1,1,"(3.541112,-76.384584)"
2016,Septiembre,Países Bajos,528,1,6,7,"(7.818934,-72.453226)"
2014,Julio,Argentina,32,10,23,33,"(10.886611,-74.776708)"
2022,Marzo,Malta,470,2,1,3,"(10.445761,-75.516429)"
2017,Julio,Georgia,268,2,0,2,"(4.697144,-74.140516)"
2016,Noviembre,Cuba,192,0,1,1,"(4.452882,-75.766298)"
2014,Mayo,Federación de Rusia,643,115,165,280,"(4.697144,-74.140516)"
2014,Agosto,Grecia,300,2,0,2,"(0.814836,-77.662532)"
2022,Mayo,Sri Lanka,144,0,2,2,"(10.971302,-74.765397)"
2012,Octubre,Malasia,458,3,0,3,"(6.171601,-75.427454)"
2015,Abril,Suecia,752,0,1,1,"(13.3387613,-81.372937)"
2020,Septiembre,Australia,36,2,1,3,"(6.171601,-75.427454)"
2014,Diciembre,Noruega,578,1,1,2,"(11.247723,-74.213989)"
2014,Marzo,Argentina,32,74,132,206,"(0.814836,-77.662532)"
2014,Febrero,Canadá,124,4,9,13,"(-4.197703,-69.941278)"
2019,Junio,Belice,84,4,7,11,"(6.171601,-75.427454)"
2019,Julio,Italia,380,1,2,3,"(7.128456,-73.183637)"
2017,Abril,México,484,1,2,3,"(11.360009,-72.129330)"
2017,Febrero,El Salvador,222,3,9,12,"(10.886611,-74.776708)"
2015,Junio,Venezuela,862,2,1,3,"(0.25129,-76.875963)"
2016,Julio,Brasil,76,42,49,91,"(10.886611,-74.776708)"
2021,Enero,Venezuela,862,2,4,6,"(7.088729,-70.740253)"
2021,Abril,España,724,2,15,17,"(10.886611,-74.776708)"
2020,Diciembre,Alemania,276,29,92,121,"(6.171601,-75.427454)"
2015,Noviembre,Filipinas,608,0,7,7,"(9.402978,-75.681599)"
2019,Enero,España,724,1,1,2,"(4.452882,-75.766298)"
2022,Diciembre,Argentina,32,64,61,125,"(12.586067,-81.702563)"
2018,Agosto,Trinidad y Tobago,780,61,88,149,"(4.697144,-74.140516)"
2022,Diciembre,Italia,380,6,3,9,"(7.088729,-70.740253)"
2022,Febrero,Turquía,792,0,1,1,"(-4.197703,-69.941278)"
2022,Octubre,Brasil,76,6,6,12,"(4.452882,-75.766298)"
2023,Abril,Paraguay,600,0,1,1,"(4.452882,-75.766298)"
2018,Marzo,China,156,0,2,2,"(8.36068,-72.409396)"
2015,Octubre,Costa Rica,188,0,1,1,"(7.927209,-72.507910)"
2018,Diciembre,Croacia,191,0,1,1,"(0.814836,-77.662532)"
2022,Septiembre,Países Bajos,528,4,5,9,"(11.247723,-74.213989)"
2016,Junio,Liechtenstein,438,3,1,4,"(4.697144,-74.140516)"
2014,Enero,Tanzania,834,3,3,6,"(4.697144,-74.140516)"
2013,Noviembre,Irán,364,1,0,1,"(0.814836,-77.662532)"
2020,Enero,Canadá,124,1,5,6,"(11.360009,-72.129330)"
2012,Noviembre,Benín,204,1,0,1,"(6.171601,-75.427454)"
2021,Septiembre,Chile,152,65,97,162,"(3.541112,-76.384584)"
2022,Julio,Francia,250,0,4,4,"(7.818934,-72.453226)"
2022,Agosto,Suiza,756,365,443,808,"(4.697144,-74.140516)"
2014,Agosto,Países Bajos,528,1,1,2,"(7.927209,-72.507910)"
2017,Febrero,Bélgica,56,0,1,1,"(12.5744111,-81.703935)"
2018,Diciembre,Costa Rica,188,61,80,141,"(3.541112,-76.384584)"
2012,Agosto,Sri Lanka,144,1,3,4,"(4.697144,-74.140516)"
2018,Julio,España,724,1,7,8,"(12.586067,-81.702563)"
2016,Octubre,Barbados,52,1,0,1,"(3.541112,-76.384584)"
2015,Febrero,Bélgica,56,1,2,3,"(11.360009,-72.129330)"
2017,Agosto,Bulgaria,100,0,2,2,"(10.408582,-75.538003)"
2022,Febrero,Guatemala,320,1,2,3,"(7.927209,-72.507910)"
2017,Junio,España,724,1,2,3,"(0.812436,-77.847006)"
2015,Mayo,Brunei Darussalam,96,1,0,1,"(0.814836,-77.662532)"
2017,Junio,Santa Sede/Ciudad del Vaticano,336,0,2,2,"(4.697144,-74.140516)"
2019,Julio,Estados Unidos de América,840,53,91,144,"(0.814836,-77.662532)"
2017,Diciembre,Polonia,616,6,9,15,"(3.541112,-76.384584)"
2018,Junio,Indonesia,360,1,4,5,"(10.445761,-75.516429)"
2012,Abril,México,484,0,5,5,"(12.5744111,-81.703935)"
2013,Noviembre,Islas Caimán/Territorio Británico de Ultramar,136,1,0,1,"(4.697144,-74.140516)"
2012,Junio,Reino Unido de Gran Bretaña e Irlanda del Norte,826,188,440,628,"(4.697144,-74.140516)"
2013,Julio,Suiza,756,0,2,2,"(8.635765,-77.346578)"
2013,Febrero,República de Irlanda,372,7,8,15,"(0.814836,-77.662532)"
2017,Agosto,Panamá,591,171,228,399,"(3.541112,-76.384584)"
2022,Abril,Polonia,616,3,6,9,"(3.541112,-76.384584)"
2012,Marzo,Camerún,120,0,1,1,"(6.171601,-75.427454)"
2019,Agosto,Dinamarca,208,1,0,1,"(-4.197703,-69.941278)"
2019,Junio,Suiza,756,1,0,1,"(11.247723,-74.213989)"
2014,Diciembre,Estados Unidos de América,840,1701,2531,4232,"(3.541112,-76.384584)"
2022,Julio,Brasil,76,390,334,724,"(10.445761,-75.516429)"
2012,Agosto,Venezuela,862,2,0,2,"(11.528919,-72.919681)"
2014,Julio,Uruguay,858,14,25,39,"(3.541112,-76.384584)"
2021,Septiembre,República Dominicana,214,1001,1025,2027,"(4.697144,-74.140516)"
2022,Agosto,Italia,380,0,3,3,"(7.128456,-73.183637)"
2017,Marzo,Camerún,120,0,1,1,"(0.814836,-77.662532)"
2020,Enero,Canadá,124,0,2,2,"(7.088729,-70.740253)"
2018,Agosto,Canadá,124,2,4,6,"(-4.197703,-69.941278)"
2019,Marzo,Jordania,400,0,1,1,"(3.541112,-76.384584)"
2015,Diciembre,Suecia,752,44,60,104,"(3.541112,-76.384584)"
2018,Octubre,España,724,203,427,630,"(3.541112,-76.384584)"
2018,Julio,Costa Rica,188,187,126,313,"(12.586067,-81.702563)"
2014,Septiembre,Cuba,192,8,11,19,"(10.445761,-75.516429)"
2017,Julio,Honduras,340,47,41,88,"(10.445761,-75.516429)"
2021,Febrero,Haití,332,0,1,1,"(3.541112,-76.384584)"
2022,Mayo,Bosnia y Herzegovina,70,1,0,1,"(6.171601,-75.427454)"
2018,Junio,Bolivia,68,1,0,1,"(-4.223468,-69.945098)"
2015,Mayo,Rumania,642,1,0,1,"(11.247723,-74.213989)"
2018,Enero,Taiwán,158,6,16,22,"(6.171601,-75.427454)"
2018,Marzo,Eslovenia,705,0,1,1,"(10.886611,-74.776708)"
2012,Junio,Macedonia,807,2,1,3,"(4.697144,-74.140516)"
2018,Abril,República Checa,203,4,6,10,"(0.814836,-77.662532)"
2014,Febrero,España,724,36,54,90,"(0.814836,-77.662532)"
2014,Junio,Trinidad y Tobago,780,0,3,3,"(11.528919,-72.919681)"
2016,Noviembre,Países Bajos,528,0,6,6,"(7.818934,-72.453226)"
2015,Abril,Rumania,642,5,3,8,"(3.541112,-76.384584)"
2022,Abril,Sri Lanka,144,0,2,2,"(10.408582,-75.538003)"
2016,Enero,Uganda,800,1,0,1,"(4.697144,-74.140516)"
2013,Diciembre,Países Bajos,528,1,2,3,"(4.815061,-75.736532)"
2015,Febrero,Venezuela,862,135,231,366,"(6.171601,-75.427454)"
2012,Septiembre,Portugal,620,0,2,2,"(8.635765,-77.346578)"
2015,Agosto,República de Irlanda,372,1,1,2,"(11.360009,-72.129330)"
2019,Mayo,Macedonia,807,2,17,19,"(4.697144,-74.140516)"
2012,Septiembre,Ecuador,218,0,2,2,"(4.452882,-75.766298)"
2016,Abril,China,156,2,3,5,"(10.408582,-75.538003)"
2017,Octubre,Federación de Rusia,643,187,252,439,"(4.697144,-74.140516)"
2018,Octubre,Suiza,756,3,3,6,"(-4.197703,-69.941278)"
2019,Noviembre,Portugal,620,19,27,46,"(7.818934,-72.453226)"
2012,Julio,Honduras,340,18,17,35,"(3.541112,-76.384584)"
2013,Septiembre,Estados Unidos de América,840,0,1,1,"(7.102626,-77.762647)"
2014,Marzo,Argentina,32,43,101,144,"(3.541112,-76.384584)"
2013,Abril,Bélgica,56,1,2,3,"(10.886611,-74.776708)"
2013,Julio,Estados Unidos de América,840,1474,2050,3524,"(10.445761,-75.516429)"
2013,Agosto,República Dominicana,214,38,114,152,"(6.171601,-75.427454)"
2019,Octubre,Perú,604,3,14,17,"(-4.197703,-69.941278)"
2023,Febrero,Alemania,276,0,3,3,"(4.452882,-75.766298)"
2017,Enero,Grecia,300,0,3,3,"(10.408582,-75.538003)"
2016,Enero,México,484,8,10,18,"(12.586067,-81.702563)"
2017,Junio,Líbano,422,1,0,1,"(11.360009,-72.129330)"
2012,Marzo,Mozambique,508,1,1,2,"(4.697144,-74.140516)"
2015,Octubre,Ecuador,218,3517,4270,7787,"(4.697144,-74.140516)"
2018,Octubre,Israel,376,1,1,2,"(8.635765,-77.346578)"
2014,Octubre,Myanmar,104,1,1,2,"(4.697144,-74.140516)"
2023,Junio,Japón,392,13,25,38,"(6.171601,-75.427454)"
2019,Febrero,Estados Unidos de América,840,0,2,2,"(0.25129,-76.875963)"
2019,Julio,República Dominicana,214,10,5,15,"(7.818934,-72.453226)"
2017,Agosto,Angola,24,4,1,5,"(4.697144,-74.140516)"
2023,Enero,Chipre,196,4,9,13,"(4.697144,-74.140516)"
2012,Mayo,India,356,0,1,1,"(4.815061,-75.736532)"
2012,Octubre,Portugal,620,3,3,6,"(7.818934,-72.453226)"
2014,Octubre,Austria,40,6,6,12,"(0.814836,-77.662532)"
2018,Octubre,Ecuador,218,81,105,186,"(7.818934,-72.453226)"
2012,Diciembre,Honduras,340,0,2,2,"(11.360009,-72.129330)"
2020,Diciembre,Estados Unidos de América,840,1,0,1,"(6.228046,-77.404104)"
2015,Noviembre,Panamá,591,4,11,15,"(7.927209,-72.507910)"
2017,Julio,República de Kosovo,901,0,1,1,"(0.814836,-77.662532)"
2016,Abril,Canadá,124,18,16,34,"(10.408582,-75.538003)"
2022,Agosto,Desconocido,99999,0,3,3,"(7.927209,-72.507910)"
2023,Enero,Tailandia,764,18,8,26,"(4.697144,-74.140516)"
2016,Abril,Turquía,792,2,8,10,"(6.171601,-75.427454)"
2019,Marzo,Suecia,752,3,3,6,"(8.635765,-77.346578)"
2014,Diciembre,República de Irlanda,372,76,168,244,"(4.697144,-74.140516)"
2015,Febrero,Países Bajos,528,30,66,96,"(10.886611,-74.776708)"
2016,Junio,Trinidad y Tobago,780,0,10,10,"(10.408582,-75.538003)"
2014,Abril,Paraguay,600,3,2,5,"(10.886611,-74.776708)"
2020,Noviembre,Hungría,348,1,0,1,"(3.541112,-76.384584)"
2015,Abril,Filipinas,608,1,5,6,"(6.171601,-75.427454)"
2017,Octubre,Costa Rica,188,1,2,3,"(10.408582,-75.538003)"
2014,Noviembre,Luxemburgo,442,0,1,1,"(10.886611,-74.776708)"
2015,Octubre,Georgia,268,1,0,1,"(7.128456,-73.183637)"
2015,Julio,Malasia,458,20,23,43,"(4.697144,-74.140516)"
2019,Enero,Bulgaria,100,1,0,1,"(4.452882,-75.766298)"
2018,Marzo,Alemania,276,21,16,37,"(8.635765,-77.346578)"
2018,Abril,Dinamarca,208,1,1,2,"(4.815061,-75.736532)"
2020,Abril,Filipinas,608,0,1,1,"(10.971302,-74.765397)"
2013,Enero,Lituania,440,1,1,2,"(8.635765,-77.346578)"
2019,Mayo,República Árabe Siria,760,1,0,1,"(11.360009,-72.129330)"
2012,Junio,Jamaica,388,0,1,1,"(4.452882,-75.766298)"
2022,Marzo,Federación de Rusia,643,0,1,1,"(10.971302,-74.765397)"
2014,Agosto,República Checa,203,1,0,1,"(10.408582,-75.538003)"
2023,Enero,Ecuador,218,1,3,4,"(8.635765,-77.346578)"
2018,Enero,Italia,380,104,303,407,"(10.445761,-75.516429)"
2017,Mayo,Guyana,328,4,6,10,"(3.541112,-76.384584)"
2022,Noviembre,Montenegro,499,0,1,1,"(8.36068,-72.409396)"
2015,Septiembre,Brasil,76,1,2,3,"(7.927209,-72.507910)"
2013,Enero,Estados Unidos de América,840,50,97,147,"(7.818934,-72.453226)"
2022,Noviembre,India,356,0,42,42,"(10.408582,-75.538003)"
2015,Marzo,Suecia,752,143,252,395,"(4.697144,-74.140516)"
2018,Enero,Barbados,52,4,10,14,"(4.697144,-74.140516)"
2023,Enero,Federación de Rusia,643,1,1,2,"(12.586067,-81.702563)"
2020,Octubre,Perú,604,0,1,1,"(1.813928,-78.763924)"
2022,Marzo,Filipinas,608,0,102,102,"(3.893038,-77.067921)"
2022,Noviembre,Trinidad y Tobago,780,1,1,2,"(4.815061,-75.736532)"
2016,Mayo,Singapur,702,3,3,6,"(10.445761,-75.516429)"
2015,Marzo,Polonia,616,3,24,27,"(10.408582,-75.538003)"
2020,Septiembre,Reino Unido de Gran Bretaña e Irlanda del Norte,826,15,36,51,"(4.697144,-74.140516)"
2012,Marzo,Venezuela,862,41,82,123,"(7.088729,-70.740253)"
2017,Febrero,Australia,36,0,1,1,"(12.586067,-81.702563)"
2022,Octubre,Honduras,340,427,295,722,"(10.445761,-75.516429)"
2017,Septiembre,Dinamarca,208,3,3,6,"(0.814836,-77.662532)"
2012,Abril,El Salvador,222,1,1,2,"(7.818934,-72.453226)"
2017,Noviembre,Suecia,752,17,30,47,"(6.171601,-75.427454)"
2023,Marzo,Alemania,276,69,62,131,"(0.814836,-77.662532)"
2016,Octubre,República CentroÁfricana,140,0,1,1,"(4.697144,-74.140516)"
2021,Mayo,Jamaica,388,18,17,35,"(4.697144,-74.140516)"
2013,Noviembre,Mozambique,508,0,2,2,"(4.697144,-74.140516)"
2012,Noviembre,Jordania,400,1,0,1,"(0.25129,-76.875963)"
2017,Abril,Ecuador,218,1,1,2,"(4.452882,-75.766298)"
2020,Marzo,Chile,152,58,107,165,"(3.541112,-76.384584)"
2014,Julio,República de Irlanda,372,12,22,34,"(0.814836,-77.662532)"
2014,Marzo,Costa Rica,188,1,2,3,"(10.408582,-75.538003)"
2023,Febrero,Eslovaquia,703,0,1,1,"(10.408582,-75.538003)"
2019,Noviembre,Venezuela,862,125,119,244,"(11.528919,-72.919681)"
2018,Septiembre,Chile,152,0,2,2,"(4.815061,-75.736532)"
2014,Diciembre,Letonia,428,0,1,1,"(3.893038,-77.067921)"
2017,Mayo,Israel,376,446,933,1379,"(4.697144,-74.140516)"
2019,Septiembre,India,356,17,53,70,"(10.445761,-75.516429)"
2013,Agosto,Indonesia,360,1,2,3,"(10.408582,-75.538003)"
2022,Octubre,Noruega,578,3,1,4,"(10.408582,-75.538003)"
2013,Abril,Italia,380,2,9,11,"(10.886611,-74.776708)"
2021,Septiembre,El Salvador,222,387,455,842,"(4.697144,-74.140516)"
2014,Junio,Israel,376,2,3,5,"(8.635765,-77.346578)"
2017,Mayo,República de Irlanda,372,18,31,49,"(6.171601,-75.427454)"
2022,Noviembre,Etiopia,231,7,47,54,"(4.697144,-74.140516)"
2014,Junio,República de Corea,410,0,3,3,"(10.408582,-75.538003)"
2014,Mayo,Perú,604,165,239,404,"(3.541112,-76.384584)"
2012,Febrero,Ucrania,804,1,1,2,"(6.171601,-75.427454)"
2016,Marzo,Aruba,533,1,0,1,"(4.697144,-74.140516)"
2022,Marzo,Japón,392,0,2,2,"(4.452882,-75.766298)"
2021,Agosto,Arabia Saudita,682,0,1,1,"(6.171601,-75.427454)"
2012,Agosto,Ecuador,218,2372,3256,5628,"(4.697144,-74.140516)"
2018,Marzo,Haití,332,1,0,1,"(7.128456,-73.183637)"
2020,Enero,República Dominicana,214,51,47,98,"(10.445761,-75.516429)"
2021,Septiembre,Argentina,32,6,22,28,"(3.541112,-76.384584)"
2014,Febrero,Nueva Zelanda,554,2,19,21,"(3.541112,-76.384584)"
2022,Diciembre,India,356,0,1,1,"(7.818934,-72.453226)"
2017,Enero,Austria,40,1,1,2,"(0.25129,-76.875963)"
2014,Mayo,Líbano,422,0,1,1,"(10.886611,-74.776708)"
2015,Mayo,Filipinas,608,1,3,4,"(3.541112,-76.384584)"
2015,Julio,China,156,6,26,32,"(3.541112,-76.384584)"
2016,Septiembre,Pakistán,586,1,12,13,"(4.697144,-74.140516)"
2014,Noviembre,Japón,392,0,3,3,"(10.408582,-75.538003)"
2021,Septiembre,Ucrania,804,1,1,2,"(11.247723,-74.213989)"
2021,Abril,Túnez,788,0,2,2,"(4.697144,-74.140516)"
2012,Agosto,Venezuela,862,1,1,2,"(4.452882,-75.766298)"
2022,Mayo,Canadá,124,8,16,24,"(4.815061,-75.736532)"
2013,Febrero,República Dominicana,214,1,9,10,"(10.408582,-75.538003)"
2021,Agosto,México,484,65,138,203,"(3.541112,-76.384584)"
2021,Enero,Filipinas,608,0,10,10,"(3.893038,-77.067921)"
2012,Julio,Suecia,752,0,5,5,"(-4.197703,-69.941278)"
2015,Marzo,Croacia,191,0,2,2,"(11.360009,-72.129330)"
2017,Abril,Brasil,76,1,0,1,"(-4.223468,-69.945098)"
2017,Marzo,Panamá,591,1,1,2,"(0.814836,-77.662532)"
2018,Octubre,Guatemala,320,1,0,1,"(8.36068,-72.409396)"
2015,Noviembre,Reino Unido de Gran Bretaña e Irlanda del Norte,826,2,6,8,"(12.586067,-81.702563)"
2019,Enero,Jamaica,388,23,26,49,"(4.697144,-74.140516)"
2015,Agosto,Sudáfrica,710,3,4,7,"(10.445761,-75.516429)"
2022,Febrero,Panamá,591,743,606,1349,"(10.445761,-75.516429)"
2019,Noviembre,Islandia,352,0,3,3,"(10.445761,-75.516429)"
2014,Julio,Turquía,792,1,2,3,"(10.886611,-74.776708)"
2017,Enero,Federación de Rusia,643,1,0,1,"(4.452882,-75.766298)"
2022,Agosto,Portugal,620,0,1,1,"(10.408582,-75.538003)"
2016,Junio,Austria,40,1,4,5,"(10.408582,-75.538003)"
2019,Julio,Bermudas/Territorio Británico de Ultramar,60,1,0,1,"(4.697144,-74.140516)"
2018,Mayo,Argentina,32,2,3,5,"(7.128456,-73.183637)"
2023,Mayo,Jamaica,388,81,136,217,"(4.697144,-74.140516)"
2021,Julio,Ecuador,218,14,39,53,"(0.814836,-77.662532)"
2022,Noviembre,Grecia,300,0,6,6,"(3.893038,-77.067921)"
2014,Abril,Barbados,52,2,1,3,"(6.171601,-75.427454)"
2016,Junio,Guyana,328,1,11,12,"(4.697144,-74.140516)"
2012,Marzo,Países Bajos,528,1,3,4,"(11.360009,-72.129330)"
2017,Noviembre,Somalia,706,0,1,1,"(4.697144,-74.140516)"
2017,Octubre,Malasia,458,0,1,1,"(10.886611,-74.776708)"
2019,Enero,Brasil,76,3,8,11,"(-4.223468,-69.945098)"
2022,Enero,Granada,308,3,4,7,"(4.697144,-74.140516)"
2013,Diciembre,México,484,30,69,99,"(10.886611,-74.776708)"
2023,Febrero,Guyana,328,3,5,8,"(6.171601,-75.427454)"
2018,Noviembre,Estonia,233,1,7,8,"(10.445761,-75.516429)"
2016,Diciembre,Guatemala,320,102,84,186,"(12.586067,-81.702563)"
2018,Julio,Guatemala,320,0,4,4,"(11.360009,-72.129330)"
2021,Octubre,Japón,392,3,4,7,"(6.171601,-75.427454)"
2019,Septiembre,Japón,392,3,22,25,"(10.445761,-75.516429)"
2015,Julio,Hungría,348,3,3,6,"(10.445761,-75.516429)"
2021,Junio,Barbados,52,0,1,1,"(6.171601,-75.427454)"
2022,Diciembre,Panamá,591,24,39,63,"(7.927209,-72.507910)"
2020,Enero,República de Irlanda,372,19,38,57,"(6.171601,-75.427454)"
2015,Enero,México,484,26,67,93,"(7.818934,-72.453226)"
2012,Octubre,Bolivia,68,1,0,1,"(8.635765,-77.346578)"
2022,Mayo,España,724,1,1,2,"(12.586067,-81.702563)"
2014,Diciembre,Perú,604,2706,3412,6118,"(4.697144,-74.140516)"
2013,Noviembre,Estados Unidos de América,840,24,19,43,"(7.927209,-72.507910)"
2019,Febrero,Guyana,328,0,2,2,"(7.818934,-72.453226)"
2021,Septiembre,Guyana,328,0,2,2,"(4.815061,-75.736532)"
2017,Febrero,Serbia,688,0,3,3,"(6.171601,-75.427454)"
2013,Enero,Haití,332,0,2,2,"(0.814836,-77.662532)"
2017,Diciembre,Bolivia,68,3,4,7,"(10.886611,-74.776708)"
2013,Abril,Israel,376,111,574,685,"(4.697144,-74.140516)"
2019,Julio,Eslovaquia,703,0,3,3,"(10.445761,-75.516429)"
2022,Mayo,Israel,376,8,32,40,"(-4.197703,-69.941278)"
2016,Abril,Perú,604,35,36,71,"(10.408582,-75.538003)"
2019,Julio,Nigeria,566,5,17,22,"(4.697144,-74.140516)"
2019,Junio,Bahamas,44,5,9,14,"(6.171601,-75.427454)"
2023,Marzo,Gambia,270,0,1,1,"(6.171601,-75.427454)"
2017,Septiembre,Albania,8,0,1,1,"(0.814836,-77.662532)"
2019,Enero,Suecia,752,19,52,71,"(6.171601,-75.427454)"
2019,Abril,Suiza,756,562,727,1289,"(4.697144,-74.140516)"
2015,Enero,Canadá,124,2,4,6,"(7.927209,-72.507910)"
2016,Agosto,Chile,152,18,20,38,"(7.818934,-72.453226)"
2019,Agosto,Guatemala,320,16,20,36,"(10.886611,-74.776708)"
2017,Marzo,Francia,250,1,1,2,"(1.813928,-78.763924)"
2015,Noviembre,Ecuador,218,0,2,2,"(11.360009,-72.129330)"
2014,Mayo,Cuba,192,2,2,4,"(0.814836,-77.662532)"
2019,Marzo,Vietnam,704,2,1,3,"(10.445761,-75.516429)"
2023,Febrero,Guatemala,320,12,11,23,"(11.117806,-74.232622)"
2017,Abril,Israel,376,5,9,14,"(-4.197703,-69.941278)"
2023,Febrero,Surinam,740,6,4,10,"(7.128456,-73.183637)"
2013,Septiembre,Estados Unidos de América,840,159,442,601,"(10.886611,-74.776708)"
2013,Marzo,Rumania,642,0,3,3,"(10.445761,-75.516429)"
2013,Enero,Grecia,300,9,46,55,"(4.697144,-74.140516)"
2020,Marzo,El Salvador,222,9,13,22,"(10.445761,-75.516429)"
2018,Enero,Japón,392,215,445,660,"(4.697144,-74.140516)"
2019,Abril,Países Bajos,528,0,2,2,"(-4.197703,-69.941278)"
2013,Agosto,Australia,36,0,2,2,"(4.815061,-75.736532)"
2023,Abril,Ecuador,218,95,88,184,"(3.541112,-76.384584)"
2018,Abril,Israel,376,658,1266,1925,"(4.697144,-74.140516)"
2017,Febrero,China,156,0,2,2,"(11.247723,-74.213989)"
2022,Febrero,Ecuador,218,86,137,223,"(3.541112,-76.384584)"
2018,Noviembre,República de Corea,410,1,6,7,"(3.541112,-76.384584)"
2016,Noviembre,Serbia,688,0,1,1,"(10.886611,-74.776708)"
2016,Agosto,Singapur,702,2,1,3,"(0.814836,-77.662532)"
2015,Noviembre,Santa Lucia,662,1,1,2,"(10.886611,-74.776708)"
2018,Octubre,Bélgica,56,2,2,4,"(10.408582,-75.538003)"
2023,Abril,Rumania,642,13,20,33,"(6.171601,-75.427454)"
2018,Agosto,Alemania,276,4,9,13,"(0.25129,-76.875963)"
2014,Marzo,Francia,250,44,72,116,"(10.445761,-75.516429)"
2023,Febrero,Países Bajos,528,361,341,702,"(10.445761,-75.516429)"
2015,Noviembre,Países Bajos,528,19,19,38,"(7.128456,-73.183637)"
2019,Octubre,Irán,364,7,15,22,"(4.697144,-74.140516)"
2015,Abril,España,724,0,1,1,"(6.228046,-77.404104)"
2022,Febrero,República Dominicana,214,0,1,1,"(7.927209,-72.507910)"
2023,Febrero,República de Moldavia,498,1,0,1,"(6.171601,-75.427454)"
2020,Diciembre,Cuba,192,99,132,231,"(4.697144,-74.140516)"
2022,Septiembre,Israel,376,0,1,1,"(12.586067,-81.702563)"
2019,Junio,República Checa,203,3,5,8,"(0.814836,-77.662532)"
2017,Junio,Japón,392,10,29,39,"(6.171601,-75.427454)"
2012,Abril,Polonia,616,1,2,3,"(7.818934,-72.453226)"
2013,Mayo,Surinam,740,7,9,16,"(6.171601,-75.427454)"
2019,Agosto,España,724,10,14,24,"(11.360009,-72.129330)"
2015,Febrero,Ucrania,804,1,1,2,"(10.445761,-75.516429)"
2021,Agosto,Brasil,76,72,58,130,"(-4.197703,-69.941278)"
2017,Julio,Uruguay,858,88,74,162,"(10.445761,-75.516429)"
2021,Junio,Estados Unidos de América,840,198,209,407,"(4.452882,-75.766298)"
2015,Febrero,Nigeria,566,0,1,1,"(10.886611,-74.776708)"
2014,Marzo,Trinidad y Tobago,780,13,39,52,"(4.697144,-74.140516)"
2019,Noviembre,Croacia,191,1,1,2,"(12.586067,-81.702563)"
2022,Febrero,Israel,376,0,5,5,"(8.635765,-77.346578)"
2019,Enero,Suecia,752,0,2,2,"(7.128456,-73.183637)"
2021,Julio,Suiza,756,33,43,76,"(6.171601,-75.427454)"
2012,Octubre,Reino Unido de Gran Bretaña e Irlanda del Norte,826,11,29,40,"(10.445761,-75.516429)"
2016,Marzo,Trinidad y Tobago,780,12,14,26,"(10.445761,-75.516429)"
2014,Junio,Brasil,76,46,68,114,"(3.541112,-76.384584)"
2017,Agosto,Portugal,620,1,7,8,"(10.886611,-74.776708)"
2018,Abril,Jamaica,388,7,0,7,"(3.541112,-76.384584)"
2018,Febrero,Canadá,124,286,276,562,"(12.586067,-81.702563)"
2012,Julio,Argelia,12,0,1,1,"(3.541112,-76.384584)"
2019,Mayo,Brasil,76,2,1,3,"(11.247723,-74.213989)"
2020,Febrero,Haití,332,4,12,16,"(6.171601,-75.427454)"
2019,Diciembre,Canadá,124,1975,3017,4993,"(4.697144,-74.140516)"
2019,Enero,Filipinas,608,3,7,10,"(3.541112,-76.384584)"
2020,Febrero,Alemania,276,111,126,237,"(0.814836,-77.662532)"
2015,Enero,España,724,11,20,31,"(12.586067,-81.702563)"
2018,Enero,Filipinas,608,0,7,7,"(12.5744111,-81.703935)"
2019,Septiembre,Italia,380,0,1,1,"(9.402978,-75.681599)"
2019,Julio,República de Belarús,112,1,4,5,"(4.697144,-74.140516)"
2017,Mayo,Trinidad y Tobago,780,3,9,12,"(10.445761,-75.516429)"
2021,Septiembre,Costa Rica,188,0,2,2,"(10.408582,-75.538003)"
2013,Septiembre,Federación de Rusia,643,0,1,1,"(11.360009,-72.129330)"
2016,Septiembre,Egipto,818,7,21,28,"(4.697144,-74.140516)"
2013,Marzo,Australia,36,0,2,2,"(7.818934,-72.453226)"
2018,Julio,Filipinas,608,2,1,3,"(4.815061,-75.736532)"
2014,Junio,Italia,380,1,2,3,"(11.247723,-74.213989)"
2013,Mayo,República de Irlanda,372,0,1,1,"(11.360009,-72.129330)"
2014,Diciembre,Canadá,124,18,52,70,"(10.886611,-74.776708)"
2019,Julio,Bolivia,68,1,1,2,"(8.36068,-72.409396)"
2016,Agosto,Nueva Zelanda,554,1,1,2,"(10.886611,-74.776708)"
2022,Enero,Estados Unidos de América,840,0,3,3,"(12.5744111,-81.703935)"
2019,Diciembre,Turquía,792,1,3,4,"(3.541112,-76.384584)"
2018,Febrero,Emiratos Árabes,784,0,4,4,"(6.171601,-75.427454)"
2014,Junio,Australia,36,30,83,113,"(6.171601,-75.427454)"
2020,Enero,República de Corea,410,0,1,1,"(-4.197703,-69.941278)"
2016,Enero,República de Corea,410,5,9,14,"(3.541112,-76.384584)"
2020,Septiembre,México,484,4,19,23,"(6.171601,-75.427454)"
2018,Marzo,Argentina,32,2745,2003,4748,"(10.445761,-75.516429)"
2022,Febrero,Canadá,124,39,59,98,"(3.541112,-76.384584)"
2022,Febrero,Luxemburgo,442,0,1,1,"(6.171601,-75.427454)"
2019,Enero,Bután,64,1,0,1,"(4.697144,-74.140516)"
2019,Noviembre,Estonia,233,6,4,10,"(10.445761,-75.516429)"
2017,Noviembre,Países Bajos,528,33,25,58,"(0.814836,-77.662532)"
2017,Enero,Haití,332,0,1,1,"(12.586067,-81.702563)"
2014,Septiembre,Nicaragua,558,0,1,1,"(10.408582,-75.538003)"
2016,Abril,Canadá,124,0,4,4,"(4.815061,-75.736532)"
2019,Febrero,Hong Kong,344,2,0,2,"(10.445761,-75.516429)"
2018,Octubre,Lituania,440,2,4,6,"(10.445761,-75.516429)"
2021,Mayo,Australia,36,0,1,1,"(4.815061,-75.736532)"
2022,Abril,Venezuela,862,22,17,39,"(4.815061,-75.736532)"
2021,Diciembre,Irán,364,0,1,1,"(10.445761,-75.516429)"
2018,Marzo,Ucrania,804,1,0,1,"(0.814836,-77.662532)"
2015,Abril,Filipinas,608,1,10,11,"(3.541112,-76.384584)"
2016,Octubre,El Salvador,222,0,1,1,"(10.408582,-75.538003)"
2021,Enero,Sudáfrica,710,0,1,1,"(10.445761,-75.516429)"
2021,Diciembre,Ucrania,804,1,16,17,"(10.408582,-75.538003)"
2014,Junio,Hungría,348,7,7,14,"(6.171601,-75.427454)"
2016,Abril,Argentina,32,0,1,1,"(8.635765,-77.346578)"
2018,Febrero,Indonesia,360,18,41,59,"(4.697144,-74.140516)"
2019,Julio,Granada,308,2,0,2,"(12.586067,-81.702563)"
2022,Septiembre,Reino Unido de Gran Bretaña e Irlanda del Norte,826,1,1,2,"(7.128456,-73.183637)"
2021,Mayo,Reino Unido de Gran Bretaña e Irlanda del Norte,826,0,2,2,"(10.408582,-75.538003)"
2017,Junio,Granada,308,1,0,1,"(3.541112,-76.384584)"
2013,Octubre,Islas Marshall,584,0,1,1,"(4.697144,-74.140516)"
2017,Diciembre,Honduras,340,2,1,3,"(7.128456,-73.183637)"
2014,Marzo,Reino Unido de Gran Bretaña e Irlanda del Norte,826,1,4,5,"(11.360009,-72.129330)"
2012,Agosto,Argentina,32,72,108,180,"(0.814836,-77.662532)"
2013,Enero,Bahamas,44,0,1,1,"(6.171601,-75.427454)"
2023,Abril,Nicaragua,558,25,31,56,"(6.171601,-75.427454)"
2017,Abril,Luxemburgo,442,3,8,11,"(4.697144,-74.140516)"
2016,Octubre,Suiza,756,2,0,2,"(4.452882,-75.766298)"
2016,Septiembre,Países Bajos,528,4,5,9,"(8.635765,-77.346578)"
2022,Octubre,Estados Unidos de América,840,2,3,5,"(-4.223468,-69.945098)"
2020,Marzo,Hong Kong,344,1,1,2,"(10.445761,-75.516429)"
2012,Mayo,Hungría,348,1,2,3,"(0.814836,-77.662532)"
2016,Noviembre,Noruega,578,5,4,9,"(0.814836,-77.662532)"
2018,Octubre,Desconocido,99999,1,0,1,"(7.088729,-70.740253)"
2019,Enero,Singapur,702,1,1,2,"(10.445761,-75.516429)"
2020,Junio,República de Corea,410,2,1,3,"(4.697144,-74.140516)"
2013,Julio,Grecia,300,0,2,2,"(8.635765,-77.346578)"
2019,Octubre,Filipinas,608,0,3,3,"(9.402978,-75.681599)"
2012,Diciembre,Austria,40,2,5,7,"(11.360009,-72.129330)"
2021,Noviembre,Mozambique,508,1,0,1,"(4.697144,-74.140516)"
2012,Noviembre,Pakistán,586,0,3,3,"(6.171601,-75.427454)"
2015,Agosto,Reino Unido de Gran Bretaña e Irlanda del Norte,826,9,18,27,"(8.635765,-77.346578)"
2018,Diciembre,Benín,204,0,1,1,"(4.697144,-74.140516)"
2018,Abril,Polonia,616,0,2,2,"(10.971302,-74.765397)"
2012,Julio,Italia,380,2,1,3,"(10.408582,-75.538003)"
2014,Junio,Guatemala,320,0,2,2,"(7.818934,-72.453226)"
2013,Febrero,Alemania,276,38,73,111,"(3.541112,-76.384584)"
2021,Julio,República de Belarús,112,0,1,1,"(10.445761,-75.516429)"
2013,Marzo,Italia,380,2,11,13,"(10.886611,-74.776708)"
2017,Abril,España,724,5,7,12,"(-4.223468,-69.945098)"
2015,Octubre,Perú,604,87,308,395,"(0.814836,-77.662532)"
2019,Noviembre,Argentina,32,7,3,10,"(-4.197703,-69.941278)"
2015,Mayo,Venezuela,862,2,3,5,"(12.586067,-81.702563)"
2015,Marzo,Israel,376,2,33,35,"(10.445761,-75.516429)"
2014,Mayo,Francia,250,1,1,2,"(0.25129,-76.875963)"
2018,Marzo,República Checa,203,0,1,1,"(-4.197703,-69.941278)"
2018,Abril,Letonia,428,2,3,5,"(6.171601,-75.427454)"
2019,Julio,Eslovaquia,703,1,0,1,"(3.541112,-76.384584)"
2012,Agosto,Camerún,120,0,3,3,"(4.697144,-74.140516)"
2019,Octubre,Belice,84,0,2,2,"(3.541112,-76.384584)"
2023,Mayo,Arabia Saudita,682,1,0,1,"(11.117806,-74.232622)"
2018,Agosto,Costa Rica,188,0,4,4,"(11.117806,-74.232622)"
2021,Abril,Trinidad y Tobago,780,0,1,1,"(4.452882,-75.766298)"
2013,Julio,España,724,21,34,55,"(0.814836,-77.662532)"
2014,Octubre,Uruguay,858,0,1,1,"(4.815061,-75.736532)"
2019,Julio,India,356,1,9,10,"(10.886611,-74.776708)"
2021,Enero,Chile,152,29,31,60,"(6.171601,-75.427454)"
2019,Febrero,Ecuador,218,50,237,287,"(0.25129,-76.875963)"
2020,Febrero,Bosnia y Herzegovina,70,1,1,2,"(6.171601,-75.427454)"
2017,Noviembre,Bulgaria,100,0,7,7,"(10.445761,-75.516429)"
2018,Marzo,Grecia,300,0,2,2,"(3.893038,-77.067921)"
2014,Noviembre,Venezuela,862,4,4,8,"(7.128456,-73.183637)"
2023,Febrero,Nueva Zelanda,554,0,3,3,"(8.635765,-77.346578)"
2021,Diciembre,Guatemala,320,136,209,345,"(6.171601,-75.427454)"
2015,Septiembre,Noruega,578,1,2,3,"(10.886611,-74.776708)"
2017,Noviembre,Estados Unidos de América,840,46,80,126,"(0.814836,-77.662532)"
2014,Febrero,Bulgaria,100,0,2,2,"(10.408582,-75.538003)"
2014,Septiembre,Suecia,752,1,1,2,"(-4.197703,-69.941278)"
2013,Marzo,Canadá,124,374,325,699,"(12.586067,-81.702563)"
2019,Septiembre,Suiza,756,5,4,9,"(8.635765,-77.346578)"
2018,Diciembre,Israel,376,2,0,2,"(8.635765,-77.346578)"
2019,Septiembre,Australia,36,1,2,3,"(4.815061,-75.736532)"
2015,Abril,Portugal,620,4,1,5,"(12.586067,-81.702563)"
2013,Mayo,Brasil,76,1,0,1,"(6.185799,-67.483929)"
2013,Diciembre,Panamá,591,1,20,21,"(10.408582,-75.538003)"
2014,Diciembre,Alemania,276,67,92,159,"(3.541112,-76.384584)"
2017,Junio,Suecia,752,2,3,5,"(-4.223468,-69.945098)"
2018,Febrero,China,156,1,0,1,"(4.815061,-75.736532)"
2019,Mayo,Irán,364,6,17,23,"(4.697144,-74.140516)"
2015,Septiembre,Austria,40,1,7,8,"(10.445761,-75.516429)"
2013,Noviembre,Noruega,578,1,21,22,"(10.445761,-75.516429)"
2015,Octubre,Cuba,192,0,1,1,"(-4.197703,-69.941278)"
2022,Febrero,Estados Unidos de América,840,0,2,2,"(8.36068,-72.409396)"
2022,Junio,Argentina,32,48,112,160,"(3.541112,-76.384584)"
2019,Septiembre,Estados Unidos de América,840,1,0,1,"(7.088729,-70.740253)"
2022,Junio,Jordania,400,0,1,1,"(6.171601,-75.427454)"
2023,Marzo,Argentina,32,0,3,3,"(4.452882,-75.766298)"
2020,Febrero,Nicaragua,558,1,2,3,"(12.586067,-81.702563)"
2022,Mayo,Japón,392,2,2,4,"(10.886611,-74.776708)"
2015,Agosto,Bolivia,68,16,16,32,"(10.445761,-75.516429)"
2022,Noviembre,Gambia,270,1,0,1,"(10.408582,-75.538003)"
2013,Julio,Macedonia,807,2,10,12,"(4.697144,-74.140516)"
2022,Julio,Portugal,620,0,1,1,"(4.452882,-75.766298)"
2018,Julio,Brasil,76,2,2,4,"(-4.223468,-69.945098)"
2015,Octubre,Jordania,400,0,2,2,"(4.697144,-74.140516)"
2019,Junio,Australia,36,56,77,133,"(6.171601,-75.427454)"
2013,Marzo,Federación de Rusia,643,3,0,3,"(3.541112,-76.384584)"
2013,Febrero,Brasil,76,66,124,190,"(6.171601,-75.427454)"
2020,Diciembre,Italia,380,4,19,23,"(10.886611,-74.776708)"
2015,Junio,Malí,466,0,1,1,"(4.697144,-74.140516)"
2012,Agosto,México,484,0,6,6,"(7.128456,-73.183637)"
2019,Diciembre,Nepal,524,1,0,1,"(10.408582,-75.538003)"
2014,Abril,República de Corea,410,4,8,12,"(0.814836,-77.662532)"
2013,Junio,Noruega,578,79,120,199,"(4.697144,-74.140516)"
2018,Diciembre,Costa de Marfil,384,0,1,1,"(10.445761,-75.516429)"
2016,Julio,República de Kosovo,901,0,1,1,"(4.697144,-74.140516)"
2022,Agosto,Alemania,276,1,2,3,"(11.247723,-74.213989)"
2019,Septiembre,Francia,250,1626,2600,4226,"(4.697144,-74.140516)"
2016,Febrero,Paraguay,600,42,39,81,"(10.445761,-75.516429)"
2019,Abril,Venezuela,862,10,36,46,"(10.433609,-73.247863)"
2015,Agosto,Alemania,276,0,1,1,"(7.128456,-73.183637)"
2012,Septiembre,El Salvador,222,0,1,1,"(11.360009,-72.129330)"
2014,Abril,Canadá,124,16,34,50,"(0.814836,-77.662532)"
2013,Febrero,Reino Unido de Gran Bretaña e Irlanda del Norte,826,19,40,59,"(0.814836,-77.662532)"
2012,Mayo,Paraguay,600,0,1,1,"(7.818934,-72.453226)"
2023,Mayo,Brasil,76,100,83,183,"(-4.197703,-69.941278)"
2015,Enero,República de Belarús,112,2,1,3,"(7.818934,-72.453226)"
2022,Marzo,Estados Unidos de América,840,11,21,32,"(7.818934,-72.453226)"
2015,Febrero,Taiwán,158,11,13,24,"(4.697144,-74.140516)"
2023,Mayo,Panamá,591,1,1,2,"(7.102626,-77.762647)"
2016,Septiembre,República Del Congo,178,0,1,1,"(4.697144,-74.140516)"
2020,Enero,Islas Fiji,242,0,2,2,"(10.445761,-75.516429)"
2021,Noviembre,Sudáfrica,710,5,12,17,"(4.697144,-74.140516)"
2021,Enero,Bolivia,68,45,18,63,"(10.445761,-75.516429)"
2015,Diciembre,Francia,250,9,12,21,"(4.815061,-75.736532)"
2018,Octubre,Guatemala,320,0,2,2,"(7.128456,-73.183637)"
2019,Febrero,Paraguay,600,18,45,63,"(6.171601,-75.427454)"
2022,Abril,México,484,1,0,1,"(12.5744111,-81.703935)"
2023,Junio,Japón,392,0,1,1,"(11.117806,-74.232622)"
2022,Noviembre,Argentina,32,77,56,133,"(12.586067,-81.702563)"
2016,Junio,Cabo Verde,132,1,0,1,"(10.886611,-74.776708)"
2022,Febrero,Estados Unidos de América,840,1,2,3,"(8.635765,-77.346578)"
2016,Octubre,Nueva Zelanda,554,2,4,6,"(10.886611,-74.776708)"
2012,Mayo,Alemania,276,8,12,20,"(7.818934,-72.453226)"
2014,Enero,Indonesia,360,0,1,1,"(0.814836,-77.662532)"
2018,Marzo,Singapur,702,1,0,1,"(10.408582,-75.538003)"
2021,Diciembre,Arabia Saudita,682,0,1,1,"(10.445761,-75.516429)"
2019,Mayo,Canadá,124,171,460,631,"(6.171601,-75.427454)"
2012,Mayo,República Dominicana,214,29,72,101,"(6.171601,-75.427454)"
2016,Mayo,Taiwán,158,1,0,1,"(10.886611,-74.776708)"
2018,Junio,Canadá,124,0,1,1,"(0.25129,-76.875963)"
2014,Septiembre,Estados Unidos de América,840,1,2,3,"(13.3387613,-81.372937)"
2014,Abril,Vietnam,704,1,4,5,"(4.697144,-74.140516)"
2018,Febrero,Italia,380,1,5,6,"(11.247723,-74.213989)"
2019,Enero,Filipinas,608,0,10,10,"(11.247723,-74.213989)"
2015,Septiembre,Ucrania,804,0,2,2,"(3.541112,-76.384584)"
2022,Junio,Canadá,124,2,1,3,"(10.408582,-75.538003)"
2021,Abril,Costa Rica,188,218,291,509,"(4.697144,-74.140516)"
2015,Noviembre,Paraguay,600,0,2,2,"(0.814836,-77.662532)"
2014,Marzo,Nueva Zelanda,554,1,4,5,"(-4.197703,-69.941278)"
2017,Septiembre,Venezuela,862,4,2,6,"(4.452882,-75.766298)"
2023,Enero,Suiza,756,5,9,14,"(11.117806,-74.232622)"
2017,Julio,Albania,8,1,3,4,"(4.697144,-74.140516)"
2012,Mayo,Nueva Zelanda,554,0,1,1,"(10.408582,-75.538003)"
2021,Marzo,Indonesia,360,1,1,2,"(10.445761,-75.516429)"
2018,Septiembre,Alemania,276,63,84,147,"(3.541112,-76.384584)"
2016,Mayo,Israel,376,49,110,159,"(0.814836,-77.662532)"
2017,Octubre,Italia,380,17,26,43,"(0.814836,-77.662532)"
2020,Enero,Rumania,642,12,18,30,"(6.171601,-75.427454)"
2012,Abril,Ecuador,218,0,2,2,"(7.927209,-72.507910)"
2015,Mayo,Irán,364,0,2,2,"(6.171601,-75.427454)"
2014,Septiembre,Mongolia,496,0,3,3,"(4.697144,-74.140516)"
2018,Julio,Países Bajos,528,2849,3333,6182,"(4.697144,-74.140516)"
2014,Abril,Ecuador,218,0,1,1,"(12.5744111,-81.703935)"
2013,Julio,Hungría,348,1,3,4,"(6.171601,-75.427454)"
2014,Abril,Alemania,276,2,6,8,"(11.360009,-72.129330)"
2015,Abril,Croacia,191,1,1,2,"(0.814836,-77.662532)"
2022,Noviembre,Ecuador,218,5,4,9,"(0.812436,-77.847006)"
2022,Abril,Federación de Rusia,643,15,12,27,"(10.445761,-75.516429)"
2012,Noviembre,Arabia Saudita,682,0,1,1,"(10.445761,-75.516429)"
2016,Mayo,Pakistán,586,5,14,19,"(4.697144,-74.140516)"
2019,Marzo,Perú,604,1146,741,1887,"(10.445761,-75.516429)"
2018,Abril,Ecuador,218,1,0,1,"(7.088729,-70.740253)"
2015,Agosto,Países Bajos,528,0,1,1,"(4.697144,-74.140516)"
2018,Septiembre,España,724,330,678,1008,"(6.171601,-75.427454)"
2022,Noviembre,Suiza,756,0,2,2,"(11.360009,-72.129330)"
2017,Octubre,Nauru,520,1,0,1,"(4.697144,-74.140516)"
2016,Febrero,Rumania,642,2,13,15,"(10.408582,-75.538003)"
2015,Enero,Bosnia y Herzegovina,70,0,1,1,"(6.171601,-75.427454)"
2019,Abril,Sudáfrica,710,4,6,10,"(10.445761,-75.516429)"
2017,Octubre,Finlandia,246,7,6,13,"(10.445761,-75.516429)"
2018,Enero,Australia,36,0,1,1,"(13.3387613,-81.372937)"
2013,Febrero,República de Moldavia,498,1,1,2,"(6.171601,-75.427454)"
2022,Agosto,Luxemburgo,442,0,1,1,"(-4.197703,-69.941278)"
2018,Julio,Finlandia,246,3,0,3,"(0.25129,-76.875963)"
2016,Enero,Nepal,524,0,2,2,"(3.541112,-76.384584)"
2017,Agosto,República Dominicana,214,560,805,1365,"(4.697144,-74.140516)"
2013,Mayo,Cuba,192,89,132,221,"(4.697144,-74.140516)"
2021,Julio,Estados Unidos de América,840,3,3,6,"(11.360009,-72.129330)"
2016,Octubre,Eslovenia,705,0,1,1,"(10.408582,-75.538003)"
2020,Enero,San  Vicente y las Granadinas,670,0,1,1,"(6.171601,-75.427454)"
2015,Octubre,Egipto,818,0,1,1,"(11.247723,-74.213989)"
2016,Agosto,Canadá,124,4,3,7,"(7.128456,-73.183637)"
2014,Octubre,República Dominicana,214,12,21,33,"(10.886611,-74.776708)"
2016,Mayo,Costa Rica,188,91,75,166,"(12.586067,-81.702563)"
2019,Marzo,Chile,152,1,4,5,"(11.117806,-74.232622)"
2018,Noviembre,Kazajistán,398,1,2,3,"(10.445761,-75.516429)"
2013,Mayo,Australia,36,13,43,56,"(6.171601,-75.427454)"
2017,Diciembre,Trinidad y Tobago,780,7,12,19,"(10.445761,-75.516429)"
2014,Mayo,Chile,152,4,4,8,"(-4.197703,-69.941278)"
2017,Julio,República de Irlanda,372,0,1,1,"(-4.197703,-69.941278)"
2012,Septiembre,Trinidad y Tobago,780,2,1,3,"(7.128456,-73.183637)"
2012,Noviembre,Brasil,76,1,10,11,"(10.408582,-75.538003)"
2013,Septiembre,Bolivia,68,18,21,39,"(6.171601,-75.427454)"
2018,Mayo,Mongolia,496,3,10,13,"(4.697144,-74.140516)"
2017,Octubre,Ecuador,218,3,5,8,"(11.360009,-72.129330)"
2015,Mayo,Guatemala,320,44,111,155,"(6.171601,-75.427454)"
2017,Noviembre,Guatemala,320,3,3,6,"(10.408582,-75.538003)"
2014,Julio,Sudáfrica,710,0,5,5,"(10.886611,-74.776708)"
2023,Junio,Qatar,634,3,8,11,"(4.697144,-74.140516)"
2014,Marzo,Países Bajos,528,5,10,15,"(10.408582,-75.538003)"
2015,Septiembre,Suiza,756,2,5,7,"(11.247723,-74.213989)"
2016,Enero,Suiza,756,492,721,1213,"(4.697144,-74.140516)"
2021,Noviembre,República de Moldavia,498,1,1,2,"(6.171601,-75.427454)"
2021,Agosto,Bulgaria,100,0,5,5,"(3.541112,-76.384584)"
2019,Abril,Portugal,620,0,1,1,"(11.247723,-74.213989)"
2016,Octubre,México,484,4,14,18,"(7.818934,-72.453226)"
2023,Febrero,Alemania,276,10,11,21,"(0.25129,-76.875963)"
2023,Marzo,Panamá,591,572,621,1194,"(3.541112,-76.384584)"
2014,Octubre,Cuba,192,5,4,9,"(7.128456,-73.183637)"
2013,Agosto,Bolivia,68,1,5,6,"(7.818934,-72.453226)"
2013,Mayo,República de Corea,410,0,2,2,"(7.128456,-73.183637)"
2013,Abril,Eslovenia,705,0,3,3,"(10.445761,-75.516429)"
2016,Abril,Serbia,688,3,0,3,"(3.541112,-76.384584)"
2017,Febrero,Indonesia,360,13,14,27,"(4.697144,-74.140516)"
2018,Julio,India,356,13,17,30,"(3.541112,-76.384584)"
2022,Octubre,Guyana,328,2,1,3,"(3.541112,-76.384584)"
2023,Febrero,Filipinas,608,3,23,26,"(3.541112,-76.384584)"
2018,Septiembre,Japón,392,0,2,2,"(8.635765,-77.346578)"
2019,Marzo,Estados Unidos de América,840,826,1328,2154,"(10.886611,-74.776708)"
2014,Abril,Líbano,422,1,0,1,"(7.818934,-72.453226)"
2018,Marzo,Suiza,756,3,1,4,"(-4.223468,-69.945098)"
2023,Mayo,Australia,36,0,1,1,"(-4.197703,-69.941278)"
2012,Abril,Letonia,428,1,1,2,"(10.445761,-75.516429)"
2018,Junio,Paraguay,600,13,31,44,"(6.171601,-75.427454)"
2022,Enero,Rumania,642,10,27,37,"(6.171601,-75.427454)"
2013,Febrero,Estonia,233,1,0,1,"(10.886611,-74.776708)"
2022,Junio,Panamá,591,2,1,3,"(7.102626,-77.762647)"
2016,Noviembre,San  Vicente y las Granadinas,670,1,1,2,"(4.697144,-74.140516)"
2018,Julio,Cabo Verde,132,1,0,1,"(6.171601,-75.427454)"
2021,Septiembre,Países Bajos,528,1,1,2,"(10.408582,-75.538003)"
2018,Abril,Brasil,76,27,40,67,"(0.814836,-77.662532)"
2019,Agosto,Japón,392,0,1,1,"(7.128456,-73.183637)"
2020,Febrero,Francia,250,10,13,23,"(8.635765,-77.346578)"
2015,Agosto,Reino Unido de Gran Bretaña e Irlanda del Norte,826,0,2,2,"(4.452882,-75.766298)"
2012,Enero,Perú,604,13,18,31,"(10.886611,-74.776708)"
2015,Diciembre,Desconocido,99999,0,1,1,"(0.814836,-77.662532)"
2013,Marzo,Trinidad y Tobago,780,0,1,1,"(7.818934,-72.453226)"
2018,Mayo,Perú,604,376,651,1027,"(6.171601,-75.427454)"
2023,Junio,Países Bajos,528,3,10,13,"(4.815061,-75.736532)"
2022,Enero,Croacia,191,2,10,12,"(6.171601,-75.427454)"
2022,Julio,Chile,152,11,6,17,"(7.927209,-72.507910)"
2018,Febrero,Cuba,192,18,17,35,"(3.541112,-76.384584)"
2021,Agosto,Grecia,300,2,10,12,"(10.445761,-75.516429)"
2012,Enero,España,724,32,65,97,"(6.171601,-75.427454)"
2022,Diciembre,Bolivia,68,941,840,1781,"(4.697144,-74.140516)"
2018,Junio,Paraguay,600,22,8,30,"(3.541112,-76.384584)"
2022,Febrero,Taiwán,158,3,1,4,"(6.171601,-75.427454)"
2016,Julio,Países Bajos,528,126,170,296,"(3.541112,-76.384584)"
2022,Abril,Paraguay,600,2,2,4,"(10.886611,-74.776708)"
2015,Mayo,China,156,12,18,30,"(10.445761,-75.516429)"
2021,Septiembre,Letonia,428,0,1,1,"(10.408582,-75.538003)"
2022,Septiembre,Francia,250,1,0,1,"(-3.790089,-70.356599)"
2022,Agosto,Suiza,756,0,1,1,"(11.360009,-72.129330)"
2017,Enero,Eslovaquia,703,39,50,89,"(4.697144,-74.140516)"
2023,Junio,España,724,1,2,3,"(10.408582,-75.538003)"
2012,Junio,República de Corea,410,0,1,1,"(7.818934,-72.453226)"
2022,Septiembre,Uruguay,858,17,8,25,"(12.586067,-81.702563)"
2015,Junio,India,356,1,3,4,"(11.247723,-74.213989)"
2022,Noviembre,Polonia,616,47,40,87,"(10.445761,-75.516429)"
2015,Julio,Bulgaria,100,2,2,4,"(3.541112,-76.384584)"
2016,Julio,República Democrática del Congo,180,4,3,7,"(4.697144,-74.140516)"
2018,Marzo,India,356,0,2,2,"(3.893038,-77.067921)"
2013,Octubre,República Dominicana,214,2,3,5,"(10.408582,-75.538003)"
2015,Junio,Nigeria,566,1,8,9,"(4.697144,-74.140516)"
2016,Agosto,Costa Rica,188,0,1,1,"(7.818934,-72.453226)"
2015,Noviembre,República de Corea,410,0,1,1,"(7.818934,-72.453226)"
2022,Marzo,Filipinas,608,1,0,1,"(4.815061,-75.736532)"
2020,Enero,República de Corea,410,448,514,962,"(4.697144,-74.140516)"
2016,Febrero,Perú,604,13,17,30,"(10.886611,-74.776708)"
2017,Junio,Reino Unido de Gran Bretaña e Irlanda del Norte,826,0,2,2,"(4.815061,-75.736532)"
2017,Diciembre,República Checa,203,6,4,10,"(0.814836,-77.662532)"
2022,Marzo,Belice,84,0,3,3,"(6.171601,-75.427454)"
2015,Septiembre,Portugal,620,3,13,16,"(10.445761,-75.516429)"
2020,Noviembre,Ecuador,218,107,121,228,"(6.171601,-75.427454)"
2022,Octubre,Líbano,422,2,2,4,"(11.360009,-72.129330)"
2012,Agosto,Líbano,422,0,1,1,"(6.171601,-75.427454)"
2016,Agosto,Italia,380,12,14,26,"(12.586067,-81.702563)"
2022,Abril,España,724,126,194,320,"(10.445761,-75.516429)"
2012,Octubre,Venezuela,862,0,1,1,"(10.408582,-75.538003)"
2015,Diciembre,Chile,152,0,9,9,"(7.818934,-72.453226)"
2013,Abril,Hungría,348,1,2,3,"(10.445761,-75.516429)"
2013,Enero,Suecia,752,2,2,4,"(8.635765,-77.346578)"
2017,Octubre,Haití,332,1,0,1,"(3.541112,-76.384584)"
2023,Mayo,Croacia,191,0,4,4,"(10.408582,-75.538003)"
2022,Junio,Ucrania,804,0,5,5,"(10.971302,-74.765397)"
2018,Julio,República de Irlanda,372,1,1,2,"(-4.223468,-69.945098)"
2013,Marzo,Nigeria,566,3,8,11,"(4.697144,-74.140516)"
2016,Marzo,República de Belarús,112,5,7,12,"(4.697144,-74.140516)"
2012,Octubre,Reino Unido de Gran Bretaña e Irlanda del Norte,826,0,2,2,"(10.886611,-74.776708)"
2018,Agosto,Canadá,124,227,412,639,"(6.171601,-75.427454)"
2018,Octubre,Dinamarca,208,4,10,14,"(3.541112,-76.384584)"
2022,Septiembre,Barbados,52,10,9,19,"(4.697144,-74.140516)"
2014,Junio,Desconocido,99999,4,1,5,"(10.445761,-75.516429)"
2012,Febrero,Japón,392,13,12,25,"(10.445761,-75.516429)"
2013,Agosto,Turquía,792,0,10,10,"(6.171601,-75.427454)"
2018,Noviembre,República de Belarús,112,0,1,1,"(6.171601,-75.427454)"
2013,Enero,Canadá,124,780,784,1564,"(10.445761,-75.516429)"
2013,Febrero,Federación de Rusia,643,3,1,4,"(3.541112,-76.384584)"
2015,Diciembre,Polonia,616,0,1,1,"(4.815061,-75.736532)"
2012,Agosto,Chile,152,38,57,95,"(0.814836,-77.662532)"
2017,Julio,Italia,380,0,1,1,"(11.247723,-74.213989)"
2014,Mayo,Países Bajos,528,1,0,1,"(1.813928,-78.763924)"
2018,Mayo,Chile,152,0,21,21,"(11.360009,-72.129330)"
2012,Diciembre,Eslovaquia,703,1,0,1,"(3.541112,-76.384584)"
2017,Julio,Cuba,192,1,2,3,"(0.814836,-77.662532)"
2013,Noviembre,Federación de Rusia,643,0,1,1,"(10.971302,-74.765397)"
2022,Febrero,Marruecos,504,0,1,1,"(4.452882,-75.766298)"
2017,Diciembre,Chile,152,5,3,8,"(8.36068,-72.409396)"
2016,Febrero,México,484,0,1,1,"(8.635765,-77.346578)"
2012,Febrero,República Dominicana,214,198,333,531,"(4.697144,-74.140516)"
2016,Julio,Rumania,642,0,2,2,"(6.171601,-75.427454)"
2015,Marzo,Jamaica,388,8,12,20,"(4.697144,-74.140516)"
2013,Enero,Israel,376,0,1,1,"(7.128456,-73.183637)"
2019,Febrero,Panamá,591,0,1,1,"(0.25129,-76.875963)"
2017,Agosto,Santa Sede/Ciudad del Vaticano,336,0,5,5,"(4.697144,-74.140516)"
2015,Enero,Costa Rica,188,0,2,2,"(11.117806,-74.232622)"
2013,Diciembre,México,484,12,13,25,"(7.927209,-72.507910)"
2022,Diciembre,India,356,0,6,6,"(9.402978,-75.681599)"
2019,Febrero,Líbano,422,1,2,3,"(7.128456,-73.183637)"
2017,Septiembre,Uganda,800,1,4,5,"(3.541112,-76.384584)"
2022,Enero,Bélgica,56,3,5,8,"(0.814836,-77.662532)"
2023,Febrero,Bélgica,56,0,4,4,"(-4.197703,-69.941278)"
2012,Noviembre,Filipinas,608,0,6,6,"(10.886611,-74.776708)"
2022,Enero,Federación de Rusia,643,0,6,6,"(11.247723,-74.213989)"
2023,Junio,Marruecos,504,20,52,72,"(4.697144,-74.140516)"
2019,Marzo,Venezuela,862,250,388,638,"(10.886611,-74.776708)"
2021,Julio,Croacia,191,1,5,6,"(10.886611,-74.776708)"
2013,Junio,Kazajistán,398,0,1,1,"(6.171601,-75.427454)"
2022,Enero,Perú,604,410,356,766,"(10.445761,-75.516429)"
2014,Noviembre,España,724,6,28,34,"(10.886611,-74.776708)"
2016,Febrero,Grecia,300,0,3,3,"(9.402978,-75.681599)"
2018,Octubre,Islandia,352,1,1,2,"(4.815061,-75.736532)"
2015,Febrero,Israel,376,10,11,21,"(0.814836,-77.662532)"
2022,Junio,Turquía,792,0,36,36,"(3.893038,-77.067921)"
2016,Diciembre,Bulgaria,100,3,1,4,"(6.171601,-75.427454)"
2015,Mayo,Bahamas,44,3,3,6,"(4.697144,-74.140516)"
2015,Diciembre,Hungría,348,0,1,1,"(12.586067,-81.702563)"
2018,Julio,Pakistán,586,4,17,21,"(4.697144,-74.140516)"
2017,Marzo,República Dominicana,214,3,7,10,"(7.818934,-72.453226)"
2013,Octubre,Malasia,458,10,23,33,"(4.697144,-74.140516)"
2019,Enero,Nueva Zelanda,554,0,1,1,"(7.818934,-72.453226)"
2023,Abril,Trinidad y Tobago,780,2,0,2,"(8.364293,-72.405710)"
2019,Agosto,Liechtenstein,438,1,4,5,"(6.171601,-75.427454)"
2016,Julio,Austria,40,3,2,5,"(10.886611,-74.776708)"
2018,Junio,Portugal,620,1,0,1,"(10.408582,-75.538003)"
2020,Marzo,Panamá,591,765,774,1539,"(4.697144,-74.140516)"
2022,Marzo,Federación de Rusia,643,0,3,3,"(3.893038,-77.067921)"
2016,Julio,Polonia,616,5,7,12,"(10.445761,-75.516429)"
2014,Abril,Portugal,620,2,1,3,"(7.927209,-72.507910)"
2021,Junio,Vietnam,704,0,1,1,"(10.445761,-75.516429)"
2017,Diciembre,Federación de Rusia,643,2,1,3,"(7.818934,-72.453226)"
2014,Junio,El Salvador,222,28,31,59,"(6.171601,-75.427454)"
2022,Mayo,Ucrania,804,67,46,113,"(4.697144,-74.140516)"
2013,Julio,Paraguay,600,3,3,6,"(12.586067,-81.702563)"
2019,Diciembre,Ghana,288,4,7,11,"(4.697144,-74.140516)"
2018,Julio,Refugiado,99999,1,0,1,"(3.541112,-76.384584)"
2014,Diciembre,Polonia,616,135,150,285,"(4.697144,-74.140516)"
2020,Marzo,Egipto,818,2,16,18,"(4.697144,-74.140516)"
2015,Septiembre,El Salvador,222,586,771,1357,"(4.697144,-74.140516)"
2019,Julio,Venezuela,862,7,6,13,"(-4.197703,-69.941278)"
2019,Marzo,Refugiado,99999,1,0,1,"(3.541112,-76.384584)"
2023,Junio,Grecia,300,2,6,8,"(6.171601,-75.427454)"
2021,Septiembre,Dinamarca,208,0,1,1,"(7.818934,-72.453226)"
2015,Abril,Argentina,32,19,64,83,"(7.818934,-72.453226)"
2019,Septiembre,Qatar,634,0,3,3,"(6.171601,-75.427454)"
2017,Julio,Eslovenia,705,2,2,4,"(6.171601,-75.427454)"
2020,Febrero,Brasil,76,9,5,14,"(-4.223468,-69.945098)"
2014,Agosto,México,484,1,0,1,"(11.117806,-74.232622)"
2012,Diciembre,Brasil,76,1,1,2,"(4.815061,-75.736532)"
2013,Junio,Taiwán,158,1,3,4,"(10.886611,-74.776708)"
2022,Julio,Suecia,752,0,1,1,"(-4.197703,-69.941278)"
2021,Marzo,Uruguay,858,1,2,3,"(4.815061,-75.736532)"
2014,Diciembre,Federación de Rusia,643,19,24,43,"(10.445761,-75.516429)"
2015,Junio,Trinidad y Tobago,780,15,39,54,"(4.697144,-74.140516)"
2022,Agosto,Rumania,642,8,19,27,"(6.171601,-75.427454)"
2018,Mayo,Nueva Zelanda,554,5,11,16,"(0.814836,-77.662532)"
2018,Enero,Países Bajos,528,161,226,387,"(6.171601,-75.427454)"
2018,Julio,Turquía,792,150,246,396,"(4.697144,-74.140516)"
2020,Febrero,Suecia,752,1,1,2,"(7.128456,-73.183637)"
2019,Noviembre,China,156,2,0,2,"(6.185799,-67.483929)"
2015,Enero,Italia,380,45,131,176,"(10.445761,-75.516429)"
2016,Marzo,Suiza,756,7,4,11,"(8.635765,-77.346578)"
2016,Marzo,Bangladesh,50,0,6,6,"(4.697144,-74.140516)"
2013,Diciembre,Nueva Zelanda,554,3,10,13,"(6.171601,-75.427454)"
2016,Mayo,Grecia,300,0,3,3,"(3.541112,-76.384584)"
2016,Febrero,Vietnam,704,4,0,4,"(4.697144,-74.140516)"
2013,Octubre,Noruega,578,3,8,11,"(6.171601,-75.427454)"
2022,Octubre,El Salvador,222,1,0,1,"(11.360009,-72.129330)"
2015,Junio,China,156,1,0,1,"(7.128456,-73.183637)"
2017,Febrero,México,484,0,3,3,"(4.452882,-75.766298)"
2012,Enero,Países Bajos,528,1,1,2,"(11.247723,-74.213989)"
2021,Mayo,México,484,0,6,6,"(1.813928,-78.763924)"
2014,Octubre,Guatemala,320,3,13,16,"(4.815061,-75.736532)"
2016,Diciembre,Nueva Zelanda,554,2,2,4,"(10.408582,-75.538003)"
2016,Octubre,Venezuela,862,6435,8145,14580,"(7.818934,-72.453226)"
2020,Febrero,Rumania,642,0,7,7,"(10.971302,-74.765397)"
2021,Octubre,Francia,250,3,1,4,"(7.818934,-72.453226)"
2012,Marzo,Países Bajos,528,23,20,43,"(0.814836,-77.662532)"
2022,Febrero,Panamá,591,2,2,4,"(7.102626,-77.762647)"
2016,Septiembre,Nueva Zelanda,554,11,15,26,"(6.171601,-75.427454)"
2013,Diciembre,Finlandia,246,1,5,6,"(3.541112,-76.384584)"
2017,Octubre,Alemania,276,1,3,4,"(4.452882,-75.766298)"
2017,Julio,San  Vicente y las Granadinas,670,4,4,8,"(4.697144,-74.140516)"
2019,Octubre,Egipto,818,0,3,3,"(6.171601,-75.427454)"
2013,Febrero,Jamaica,388,2,0,2,"(10.408582,-75.538003)"
2019,Diciembre,República CentroÁfricana,140,0,2,2,"(4.697144,-74.140516)"
2016,Mayo,Emiratos Árabes,784,2,5,7,"(4.697144,-74.140516)"
2017,Mayo,República Democrática del Congo,180,1,0,1,"(6.171601,-75.427454)"
2018,Noviembre,Myanmar,104,1,0,1,"(4.815061,-75.736532)"
2022,Julio,Myanmar,104,1,0,1,"(4.697144,-74.140516)"
2019,Marzo,España,724,138,183,321,"(10.445761,-75.516429)"
2023,Enero,Alemania,276,1,2,3,"(7.128456,-73.183637)"
2019,Enero,Ecuador,218,2,26,28,"(10.408582,-75.538003)"
2014,Febrero,Federación de Rusia,643,9,21,30,"(10.408582,-75.538003)"
2019,Agosto,Suiza,756,1,1,2,"(11.247723,-74.213989)"
2015,Agosto,Brasil,76,2,7,9,"(3.866713,-67.927521)"
2019,Diciembre,Suiza,756,1,4,5,"(4.815061,-75.736532)"
2020,Julio,Rumania,642,1,0,1,"(4.697144,-74.140516)"
2019,Junio,Honduras,340,17,25,42,"(3.541112,-76.384584)"
2018,Diciembre,Bolivia,68,0,1,1,"(-4.223468,-69.945098)"
2013,Noviembre,España,724,208,349,557,"(3.541112,-76.384584)"
2012,Enero,Costa Rica,188,0,2,2,"(11.247723,-74.213989)"
2015,Marzo,Bulgaria,100,0,1,1,"(10.971302,-74.765397)"
2018,Mayo,Letonia,428,0,1,1,"(12.586067,-81.702563)"
2022,Diciembre,Jamaica,388,15,42,57,"(6.171601,-75.427454)"
2012,Diciembre,Bolivia,68,12,12,24,"(10.445761,-75.516429)"
2012,Febrero,Israel,376,0,1,1,"(7.927209,-72.507910)"
2012,Diciembre,Ucrania,804,0,1,1,"(7.128456,-73.183637)"
2018,Abril,Suiza,756,0,1,1,"(11.360009,-72.129330)"
2019,Octubre,República Checa,203,1,2,3,"(0.25129,-76.875963)"
2021,Mayo,Noruega,578,2,0,2,"(3.541112,-76.384584)"
2016,Septiembre,Guyana,328,2,0,2,"(10.445761,-75.516429)"
2013,Enero,Filipinas,608,0,17,17,"(10.408582,-75.538003)"
2019,Diciembre,Paraguay,600,47,30,77,"(12.586067,-81.702563)"
2017,Abril,Francia,250,6,11,17,"(10.886611,-74.776708)"
2012,Diciembre,Canadá,124,158,172,330,"(12.586067,-81.702563)"
2017,Noviembre,Venezuela,862,16,12,28,"(0.25129,-76.875963)"
2012,Diciembre,Cuba,192,1,0,1,"(12.586067,-81.702563)"
2018,Mayo,Mónaco,492,1,2,3,"(4.697144,-74.140516)"
2016,Noviembre,Myanmar,104,0,1,1,"(3.893038,-77.067921)"
2023,Junio,Estados Unidos de América,840,9649,12586,22237,"(10.445761,-75.516429)"
2016,Mayo,Argentina,32,1,1,2,"(7.128456,-73.183637)"
2023,Febrero,Australia,36,5,5,10,"(0.814836,-77.662532)"
2013,Mayo,Letonia,428,1,1,2,"(12.586067,-81.702563)"
2013,Enero,Suecia,752,13,31,44,"(10.445761,-75.516429)"
2018,Octubre,Marruecos,504,10,13,23,"(4.697144,-74.140516)"
2015,Febrero,Paraguay,600,155,96,251,"(12.586067,-81.702563)"
2018,Noviembre,Santa Lucia,662,2,6,8,"(4.697144,-74.140516)"
2013,Enero,Barbados,52,7,2,9,"(4.697144,-74.140516)"
2015,Mayo,Paraguay,600,46,44,90,"(10.445761,-75.516429)"
2015,Septiembre,Honduras,340,204,382,586,"(4.697144,-74.140516)"
2016,Abril,Suiza,756,27,38,65,"(3.541112,-76.384584)"
2014,Septiembre,Canadá,124,0,1,1,"(13.3387613,-81.372937)"
2022,Enero,Australia,36,19,77,96,"(6.171601,-75.427454)"
2023,Febrero,Panamá,591,19,18,37,"(12.586067,-81.702563)"
2021,Octubre,Federación de Rusia,643,0,2,2,"(11.247723,-74.213989)"
2019,Noviembre,Reino Unido de Gran Bretaña e Irlanda del Norte,826,0,1,1,"(11.117806,-74.232622)"
2023,Febrero,Dinamarca,208,6,7,13,"(12.5744111,-81.703935)"
2014,Noviembre,Alemania,276,3,5,8,"(12.586067,-81.702563)"
2020,Diciembre,Venezuela,862,0,2,2,"(11.247723,-74.213989)"
2016,Diciembre,Rumania,642,0,1,1,"(9.402978,-75.681599)"
2018,Enero,Liberia,430,1,0,1,"(3.541112,-76.384584)"
2023,Febrero,Filipinas,608,0,168,168,"(10.971302,-74.765397)"
2022,Abril,Paraguay,600,159,113,272,"(10.445761,-75.516429)"
2022,Mayo,Arabia Saudita,682,0,5,5,"(6.171601,-75.427454)"
2023,Junio,Uruguay,858,451,557,1008,"(4.697144,-74.140516)"
2018,Agosto,Irán,364,3,1,4,"(10.445761,-75.516429)"
2015,Noviembre,Desconocido,99999,6,9,15,"(6.171601,-75.427454)"
2015,Diciembre,Brasil,76,1,5,6,"(3.866713,-67.927521)"
2022,Diciembre,Francia,250,22,39,61,"(10.886611,-74.776708)"
2016,Octubre,India,356,47,314,361,"(4.697144,-74.140516)"
2017,Agosto,Malta,470,1,0,1,"(6.171601,-75.427454)"
2021,Noviembre,Chile,152,1,5,6,"(10.408582,-75.538003)"
2016,Abril,Islas Salomón,90,0,1,1,"(4.697144,-74.140516)"
2012,Junio,Federación de Rusia,643,0,1,1,"(0.814836,-77.662532)"
2016,Julio,Marruecos,504,1,0,1,"(0.814836,-77.662532)"
2012,Marzo,Estados Unidos de América,840,438,593,1031,"(10.886611,-74.776708)"
2015,Febrero,Luxemburgo,442,0,1,1,"(3.541112,-76.384584)"
2022,Febrero,Islas Caimán/Territorio Británico de Ultramar,136,1,1,2,"(3.541112,-76.384584)"
2016,Abril,Nueva Zelanda,554,3,0,3,"(11.360009,-72.129330)"
2020,Enero,Islandia,352,2,4,6,"(10.445761,-75.516429)"
2013,Marzo,Venezuela,862,2,1,3,"(11.528919,-72.919681)"
2019,Diciembre,India,356,0,1,1,"(-4.223468,-69.945098)"
2020,Diciembre,Ecuador,218,13,24,37,"(3.541112,-76.384584)"
2015,Abril,Federación de Rusia,643,1,0,1,"(10.886611,-74.776708)"
2017,Junio,República de Irlanda,372,0,2,2,"(7.818934,-72.453226)"
2021,Diciembre,Perú,604,12,12,24,"(7.927209,-72.507910)"
2017,Febrero,Bahamas,44,0,1,1,"(10.445761,-75.516429)"
2018,Noviembre,Bolivia,68,1,2,3,"(7.128456,-73.183637)"
2017,Marzo,Estados Unidos de América,840,15,13,28,"(8.635765,-77.346578)"
2023,Junio,Panamá,591,3,2,5,"(7.916725,-72.462544)"
2016,Enero,Polonia,616,2,3,5,"(-4.197703,-69.941278)"
2017,Febrero,Bélgica,56,11,14,25,"(0.814836,-77.662532)"
2016,Agosto,Ecuador,218,0,2,2,"(-0.193180,-74.784874)"
2021,Septiembre,Ecuador,218,22,28,50,"(10.886611,-74.776708)"
2018,Mayo,Ucrania,804,0,1,1,"(3.541112,-76.384584)"
2018,Febrero,Marruecos,504,2,2,4,"(0.814836,-77.662532)"
2017,Marzo,Austria,40,1,8,9,"(3.541112,-76.384584)"
2015,Mayo,República de Irlanda,372,1,0,1,"(11.247723,-74.213989)"
2012,Marzo,Rumania,642,41,79,120,"(4.697144,-74.140516)"
2016,Agosto,Irán,364,6,16,22,"(4.697144,-74.140516)"
2021,Marzo,Brasil,76,1,2,3,"(-4.197703,-69.941278)"
2015,Febrero,Kazajistán,398,0,2,2,"(6.171601,-75.427454)"
2017,Enero,Canadá,124,5,3,8,"(7.818934,-72.453226)"
2019,Octubre,Uruguay,858,2,6,8,"(0.814836,-77.662532)"
2018,Diciembre,Hungría,348,0,1,1,"(0.25129,-76.875963)"
2022,Octubre,Canadá,124,35,56,91,"(3.541112,-76.384584)"
2016,Mayo,Reino Unido de Gran Bretaña e Irlanda del Norte,826,1,1,2,"(13.3387613,-81.372937)"
2017,Julio,Bahamas,44,4,1,5,"(3.541112,-76.384584)"
2017,Julio,Guatemala,320,373,735,1108,"(4.697144,-74.140516)"
2020,Marzo,Portugal,620,1,0,1,"(7.128456,-73.183637)"
2016,Octubre,Países Bajos,528,21,52,73,"(10.445761,-75.516429)"
2015,Julio,Eslovenia,705,0,1,1,"(6.171601,-75.427454)"
2023,Marzo,Pakistán,586,1,1,2,"(10.445761,-75.516429)"
2019,Junio,Taiwán,158,0,1,1,"(4.697144,-74.140516)"
2017,Agosto,Reino Unido de Gran Bretaña e Irlanda del Norte,826,7,22,29,"(10.886611,-74.776708)"
2012,Abril,República de Corea,410,9,13,22,"(10.445761,-75.516429)"
2017,Diciembre,España,724,0,2,2,"(11.247723,-74.213989)"
2018,Mayo,Suiza,756,36,36,72,"(10.445761,-75.516429)"
2012,Febrero,Cuba,192,1,0,1,"(7.128456,-73.183637)"
2023,Abril,Dinamarca,208,0,1,1,"(10.886611,-74.776708)"
2013,Abril,Turquía,792,0,1,1,"(8.635765,-77.346578)"
2020,Febrero,Cuba,192,0,4,4,"(0.814836,-77.662532)"
2016,Marzo,Suiza,756,399,650,1049,"(4.697144,-74.140516)"
2018,Abril,Guatemala,320,0,2,2,"(6.185799,-67.483929)"
2014,Enero,República de Corea,410,1,1,2,"(3.541112,-76.384584)"
2013,Junio,Francia,250,1,0,1,"(11.247723,-74.213989)"
2018,Mayo,Uruguay,858,2,1,3,"(4.815061,-75.736532)"
2016,Mayo,Reino Unido de Gran Bretaña e Irlanda del Norte,826,32,39,71,"(8.635765,-77.346578)"
2018,Marzo,Italia,380,0,2,2,"(13.3387613,-81.372937)"
2016,Febrero,Suiza,756,35,46,81,"(10.445761,-75.516429)"
2016,Mayo,Mozambique,508,1,1,2,"(4.697144,-74.140516)"
2017,Septiembre,Costa Rica,188,213,156,369,"(10.445761,-75.516429)"
2022,Julio,Serbia,688,3,8,11,"(6.171601,-75.427454)"
2017,Julio,Uganda,800,0,1,1,"(4.697144,-74.140516)"
2012,Junio,Australia,36,4,3,7,"(11.360009,-72.129330)"
2023,Marzo,Bolivia,68,1,0,1,"(-4.223468,-69.945098)"
2023,Febrero,Italia,380,11,26,37,"(0.814836,-77.662532)"
2016,Octubre,Francia,250,7,1,8,"(0.25129,-76.875963)"
2017,Agosto,República de Corea,410,9,9,18,"(0.814836,-77.662532)"
2017,Septiembre,Canadá,124,81,135,216,"(10.445761,-75.516429)"
2022,Julio,Mozambique,508,1,1,2,"(3.541112,-76.384584)"
2016,Octubre,República de Irlanda,372,11,30,41,"(6.171601,-75.427454)"
2017,Agosto,España,724,3,3,6,"(4.452882,-75.766298)"
2017,Mayo,Bélgica,56,0,1,1,"(4.815061,-75.736532)"
2022,Febrero,México,484,0,7,7,"(1.813928,-78.763924)"
2013,Enero,República de Irlanda,372,3,14,17,"(6.171601,-75.427454)"
2022,Noviembre,Brasil,76,4,6,10,"(4.452882,-75.766298)"
2015,Octubre,Ecuador,218,12,22,34,"(10.886611,-74.776708)"
2012,Marzo,Polonia,616,1,1,2,"(10.886611,-74.776708)"
2016,Agosto,Federación de Rusia,643,132,161,293,"(4.697144,-74.140516)"
2018,Junio,Estonia,233,0,1,1,"(10.408582,-75.538003)"
2015,Septiembre,Japón,392,1,2,3,"(-4.197703,-69.941278)"
2023,Abril,México,484,2,3,5,"(-4.223468,-69.945098)"
2016,Octubre,Chile,152,0,1,1,"(8.36068,-72.409396)"
2016,Julio,Belice,84,0,3,3,"(6.171601,-75.427454)"
2012,Febrero,Países Bajos,528,1,0,1,"(7.818934,-72.453226)"
2019,Noviembre,España,724,0,2,2,"(4.452882,-75.766298)"
2017,Enero,Irán,364,6,8,14,"(4.697144,-74.140516)"
2021,Agosto,Liechtenstein,438,1,2,3,"(4.697144,-74.140516)"
2023,Mayo,Bélgica,56,0,2,2,"(10.886611,-74.776708)"
2017,Marzo,Venezuela,862,159,165,324,"(3.866713,-67.927521)"
2015,Junio,Italia,380,37,78,115,"(3.541112,-76.384584)"
2018,Julio,Rumania,642,3,3,6,"(0.814836,-77.662532)"
2014,Diciembre,Líbano,422,3,4,7,"(11.360009,-72.129330)"
2016,Mayo,Finlandia,246,40,48,88,"(4.697144,-74.140516)"
2012,Julio,Filipinas,608,1,4,5,"(6.171601,-75.427454)"
2016,Noviembre,Países Bajos,528,18,24,42,"(0.814836,-77.662532)"
2015,Abril,Bolivia,68,2,1,3,"(12.586067,-81.702563)"
2015,Noviembre,Sudáfrica,710,1,1,2,"(3.541112,-76.384584)"
2014,Febrero,Singapur,702,2,1,3,"(10.445761,-75.516429)"
2019,Octubre,Estados Unidos de América,840,5,2,7,"(8.635765,-77.346578)"
2018,Julio,Taiwán,158,1,1,2,"(7.818934,-72.453226)"
2014,Julio,China,156,10,6,16,"(10.445761,-75.516429)"
2021,Diciembre,Vietnam,704,0,1,1,"(0.814836,-77.662532)"
2021,Mayo,Nueva Zelanda,554,3,4,7,"(4.697144,-74.140516)"
2017,Agosto,El Salvador,222,80,55,135,"(10.445761,-75.516429)"
2022,Diciembre,Kuwait,414,6,5,11,"(4.697144,-74.140516)"
2013,Agosto,Rumania,642,25,47,72,"(4.697144,-74.140516)"
2019,Octubre,China,156,1,0,1,"(11.360009,-72.129330)"
2017,Abril,Bulgaria,100,0,1,1,"(10.408582,-75.538003)"
2018,Octubre,Malasia,458,1,0,1,"(0.814836,-77.662532)"
2020,Febrero,Suiza,756,0,4,4,"(11.117806,-74.232622)"
2016,Julio,China,156,5,2,7,"(4.815061,-75.736532)"
2016,Marzo,Malasia,458,0,1,1,"(10.408582,-75.538003)"
2019,Marzo,República Árabe Siria,760,0,1,1,"(3.541112,-76.384584)"
2015,Abril,Suiza,756,4,6,10,"(12.586067,-81.702563)"
2020,Agosto,Perú,604,10,43,53,"(4.697144,-74.140516)"
2018,Octubre,República Dominicana,214,3,3,6,"(10.408582,-75.538003)"
2021,Febrero,Ucrania,804,0,1,1,"(10.886611,-74.776708)"
2016,Septiembre,Suecia,752,1,2,3,"(-4.197703,-69.941278)"
2019,Julio,Eslovaquia,703,0,1,1,"(12.586067,-81.702563)"
2015,Febrero,Sudáfrica,710,0,3,3,"(10.445761,-75.516429)"
2012,Enero,Reino Unido de Gran Bretaña e Irlanda del Norte,826,25,35,60,"(10.445761,-75.516429)"
2014,Marzo,Namibia,516,1,0,1,"(4.697144,-74.140516)"
2012,Agosto,Francia,250,0,1,1,"(11.528919,-72.919681)"
2022,Marzo,Malí,466,0,1,1,"(4.697144,-74.140516)"
2012,Marzo,Suecia,752,1,4,5,"(11.360009,-72.129330)"
2016,Noviembre,Sudáfrica,710,4,6,10,"(-4.197703,-69.941278)"
2018,Marzo,Guatemala,320,1,5,6,"(4.815061,-75.736532)"
2012,Diciembre,Reino Unido de Gran Bretaña e Irlanda del Norte,826,0,2,2,"(12.586067,-81.702563)"
2015,Octubre,Micronesia,583,0,1,1,"(4.697144,-74.140516)"
2022,Febrero,El Salvador,222,59,82,141,"(6.171601,-75.427454)"
2018,Enero,Austria,40,3,1,4,"(-4.223468,-69.945098)"
2022,Noviembre,Ecuador,218,1,2,3,"(7.128456,-73.183637)"
2018,Junio,Israel,376,1,1,2,"(10.408582,-75.538003)"
2018,Febrero,Brasil,76,2,2,4,"(8.635765,-77.346578)"
2016,Diciembre,México,484,0,1,1,"(0.25129,-76.875963)"
2012,Octubre,Alemania,276,1,5,6,"(12.586067,-81.702563)"
2022,Octubre,Bulgaria,100,51,65,116,"(4.697144,-74.140516)"
2013,Enero,España,724,160,334,494,"(3.541112,-76.384584)"
2013,Mayo,Turquía,792,0,1,1,"(0.814836,-77.662532)"
2023,Abril,Trinidad y Tobago,780,9,17,26,"(6.171601,-75.427454)"
2016,Noviembre,Nicaragua,558,1,2,3,"(12.586067,-81.702563)"
2021,Diciembre,Bolivia,68,3,2,5,"(7.128456,-73.183637)"
2018,Noviembre,Namibia,516,0,1,1,"(10.408582,-75.538003)"
2023,Marzo,Estados Unidos de América,840,3,10,13,"(-4.223468,-69.945098)"
2018,Junio,República de Kosovo,901,0,1,1,"(10.445761,-75.516429)"
2015,Mayo,Polonia,616,0,1,1,"(3.893038,-77.067921)"
2018,Noviembre,India,356,0,2,2,"(0.814836,-77.662532)"
2022,Octubre,República de Corea,410,0,1,1,"(10.408582,-75.538003)"
2018,Noviembre,República Dominicana,214,0,2,2,"(11.117806,-74.232622)"
2015,Septiembre,Reino Unido de Gran Bretaña e Irlanda del Norte,826,839,1697,2536,"(4.697144,-74.140516)"
2016,Mayo,Hong Kong,344,0,1,1,"(6.171601,-75.427454)"
2012,Agosto,Brasil,76,1,0,1,"(10.408582,-75.538003)"
2015,Septiembre,India,356,57,428,485,"(4.697144,-74.140516)"
2015,Febrero,Portugal,620,4,4,8,"(12.586067,-81.702563)"
2016,Octubre,Noruega,578,2,2,4,"(10.886611,-74.776708)"
2023,Marzo,Ecuador,218,2,6,8,"(7.927209,-72.507910)"
2018,Octubre,Países Bajos,528,167,220,387,"(6.171601,-75.427454)"
2019,Febrero,Polonia,616,2,0,2,"(0.25129,-76.875963)"
2014,Enero,Jamaica,388,11,16,27,"(4.697144,-74.140516)"
2020,Enero,Islas Cocos,166,0,1,1,"(12.586067,-81.702563)"
2015,Enero,Chipre,196,0,1,1,"(6.171601,-75.427454)"
2023,Mayo,Chile,152,0,1,1,"(11.247723,-74.213989)"
2016,Octubre,Georgia,268,1,3,4,"(10.445761,-75.516429)"
2016,Septiembre,Noruega,578,2,7,9,"(3.541112,-76.384584)"
2012,Enero,El Salvador,222,12,35,47,"(6.171601,-75.427454)"
2014,Febrero,Costa Rica,188,4,9,13,"(4.815061,-75.736532)"
2015,Enero,Guyana,328,0,1,1,"(6.171601,-75.427454)"
2022,Diciembre,Georgia,268,2,3,5,"(3.541112,-76.384584)"
2019,Abril,Dinamarca,208,15,30,45,"(6.171601,-75.427454)"
2013,Marzo,Noruega,578,0,1,1,"(11.360009,-72.129330)"
2016,Diciembre,Perú,604,10,19,29,"(10.408582,-75.538003)"
2023,Marzo,Australia,36,1,1,2,"(11.247723,-74.213989)"
2019,Julio,Turquía,792,0,1,1,"(10.408582,-75.538003)"
2017,Abril,Japón,392,6,14,20,"(3.541112,-76.384584)"
2022,Enero,Macedonia,807,1,8,9,"(4.697144,-74.140516)"
2015,Noviembre,India,356,0,2,2,"(4.815061,-75.736532)"
2019,Octubre,Cabo Verde,132,1,0,1,"(4.697144,-74.140516)"
2016,Abril,Costa Rica,188,38,56,94,"(3.541112,-76.384584)"
2022,Octubre,Chile,152,0,2,2,"(8.36068,-72.409396)"
2023,Enero,Desconocido,99999,0,1,1,"(8.364293,-72.405710)"
2019,Diciembre,Israel,376,0,1,1,"(4.452882,-75.766298)"
2012,Febrero,Reino Unido de Gran Bretaña e Irlanda del Norte,826,6,18,24,"(3.541112,-76.384584)"
2018,Enero,Eslovenia,705,1,1,2,"(3.541112,-76.384584)"
2023,Abril,República de Irlanda,372,1,4,5,"(0.814836,-77.662532)"
2022,Noviembre,Países Bajos,528,2,4,6,"(7.818934,-72.453226)"
2020,Diciembre,Honduras,340,0,1,1,"(10.971302,-74.765397)"
2021,Noviembre,Tanzania,834,0,1,1,"(4.697144,-74.140516)"
2013,Mayo,Perú,604,71,36,107,"(10.408582,-75.538003)"
2022,Febrero,Italia,380,0,2,2,"(3.893038,-77.067921)"
2021,Diciembre,Australia,36,134,309,443,"(4.697144,-74.140516)"
2020,Septiembre,China,156,0,1,1,"(3.893038,-77.067921)"
2018,Julio,Pakistán,586,0,1,1,"(6.171601,-75.427454)"
2018,Enero,Nigeria,566,0,2,2,"(6.171601,-75.427454)"
2013,Febrero,España,724,3,19,22,"(10.886611,-74.776708)"
2017,Marzo,Nigeria,566,0,1,1,"(11.360009,-72.129330)"
2013,Junio,Túnez,788,0,1,1,"(6.171601,-75.427454)"
2015,Junio,Francia,250,3,5,8,"(4.815061,-75.736532)"
2016,Mayo,Canadá,124,8,10,18,"(8.635765,-77.346578)"
2019,Febrero,India,356,13,78,91,"(6.171601,-75.427454)"
2018,Mayo,Jamaica,388,0,3,3,"(12.586067,-81.702563)"
2016,Julio,Federación de Rusia,643,0,1,1,"(4.815061,-75.736532)"
2020,Octubre,Filipinas,608,1,0,1,"(7.128456,-73.183637)"
2020,Marzo,Bélgica,56,4,12,16,"(3.541112,-76.384584)"
2019,Julio,Suiza,756,2,5,7,"(4.815061,-75.736532)"
2022,Mayo,México,484,5,5,10,"(4.452882,-75.766298)"
2023,Enero,Islandia,352,1,4,5,"(6.171601,-75.427454)"
2017,Diciembre,Uruguay,858,1,0,1,"(8.36068,-72.409396)"
2018,Abril,República Dominicana,214,13,9,22,"(10.408582,-75.538003)"
2019,Abril,Estados Unidos de América,840,18,21,39,"(-4.223468,-69.945098)"
2018,Noviembre,Ecuador,218,55,86,141,"(10.445761,-75.516429)"
2013,Junio,Jamaica,388,2,11,13,"(12.586067,-81.702563)"
2022,Diciembre,Finlandia,246,74,81,155,"(4.697144,-74.140516)"
2016,Septiembre,Nigeria,566,1,7,8,"(4.697144,-74.140516)"
2019,Septiembre,República de Irlanda,372,13,15,28,"(8.635765,-77.346578)"
2018,Abril,Alemania,276,1515,2391,3906,"(4.697144,-74.140516)"
2017,Diciembre,Bolivia,68,33,24,57,"(0.814836,-77.662532)"
2023,Marzo,Portugal,620,1,0,1,"(7.128456,-73.183637)"
2014,Junio,Albania,8,2,0,2,"(4.697144,-74.140516)"
2017,Abril,Taiwán,158,1,0,1,"(-4.223468,-69.945098)"
2017,Julio,Madagascar,450,0,2,2,"(10.445761,-75.516429)"
2017,Noviembre,Jamaica,388,0,3,3,"(10.886611,-74.776708)"
2014,Mayo,Zimbabue,716,0,2,2,"(3.541112,-76.384584)"
2014,Agosto,México,484,2,5,7,"(-4.197703,-69.941278)"
2017,Septiembre,Países Bajos,528,1,0,1,"(6.185799,-67.483929)"
2017,Marzo,Estados Unidos de América,840,3,6,9,"(11.360009,-72.129330)"
2022,Octubre,República de Irlanda,372,3,1,4,"(-4.197703,-69.941278)"
2019,Enero,Liechtenstein,438,0,1,1,"(6.171601,-75.427454)"
2019,Noviembre,Jamaica,388,0,1,1,"(12.586067,-81.702563)"
2019,Febrero,Palestina,99999,0,1,1,"(4.697144,-74.140516)"
2014,Marzo,Marruecos,504,0,6,6,"(4.697144,-74.140516)"
2019,Agosto,Costa de Marfil,384,1,0,1,"(6.171601,-75.427454)"
2012,Febrero,Grecia,300,0,4,4,"(10.408582,-75.538003)"
2019,Octubre,Brasil,76,56,124,180,"(3.541112,-76.384584)"
2017,Marzo,Macedonia,807,1,0,1,"(6.171601,-75.427454)"
2015,Agosto,México,484,111,179,290,"(3.541112,-76.384584)"
2014,Junio,Turquía,792,1,8,9,"(10.445761,-75.516429)"
2012,Noviembre,Canadá,124,9,18,27,"(10.408582,-75.538003)"
2018,Julio,Paraguay,600,1,2,3,"(0.814836,-77.662532)"
2020,Septiembre,Cuba,192,2,0,2,"(10.886611,-74.776708)"
2014,Diciembre,Líbano,422,1,1,2,"(12.586067,-81.702563)"
2019,Agosto,Suiza,756,454,665,1119,"(4.697144,-74.140516)"
2022,Diciembre,Guatemala,320,262,319,581,"(6.171601,-75.427454)"
2016,Diciembre,Estados Unidos de América,840,13,14,27,"(-4.197703,-69.941278)"
2017,Noviembre,Guyana,328,0,8,8,"(6.171601,-75.427454)"
2017,Octubre,Reino Unido de Gran Bretaña e Irlanda del Norte,826,0,1,1,"(7.128456,-73.183637)"
2022,Noviembre,Ucrania,804,67,38,105,"(4.697144,-74.140516)"
2015,Febrero,Francia,250,6,8,14,"(8.635765,-77.346578)"
2012,Noviembre,Perú,604,0,6,6,"(11.247723,-74.213989)"
2022,Diciembre,Argelia,12,3,13,16,"(4.697144,-74.140516)"
2017,Abril,Malta,470,3,21,24,"(4.697144,-74.140516)"
2021,Agosto,Georgia,268,2,0,2,"(7.128456,-73.183637)"
2013,Agosto,India,356,59,260,319,"(4.697144,-74.140516)"
2022,Enero,Japón,392,6,8,14,"(6.171601,-75.427454)"
2017,Agosto,Sudán,736,0,1,1,"(4.697144,-74.140516)"
2019,Diciembre,Países Bajos,528,216,370,586,"(6.171601,-75.427454)"
2021,Marzo,Arabia Saudita,682,0,4,4,"(4.697144,-74.140516)"
2017,Noviembre,Nueva Zelanda,554,9,6,15,"(10.445761,-75.516429)"
2013,Octubre,Filipinas,608,0,10,10,"(11.247723,-74.213989)"
2013,Octubre,República de Corea,410,0,1,1,"(11.360009,-72.129330)"
2013,Septiembre,Polonia,616,1,0,1,"(3.893038,-77.067921)"
2017,Abril,Bolivia,68,0,1,1,"(0.25129,-76.875963)"
2012,Septiembre,El Salvador,222,33,46,79,"(6.171601,-75.427454)"
2013,Agosto,Uruguay,858,0,4,4,"(4.815061,-75.736532)"
2019,Abril,Guatemala,320,0,1,1,"(8.635765,-77.346578)"
2019,Febrero,Bermudas/Territorio Británico de Ultramar,60,0,2,2,"(10.445761,-75.516429)"
2019,Agosto,Dinamarca,208,3,6,9,"(3.541112,-76.384584)"
2022,Abril,Perú,604,1125,701,1826,"(10.445761,-75.516429)"
2014,Diciembre,Estados Unidos de América,840,0,9,9,"(3.893038,-77.067921)"
2022,Marzo,Países Bajos,528,3,3,6,"(11.247723,-74.213989)"
2015,Enero,Polonia,616,129,204,333,"(4.697144,-74.140516)"
2017,Agosto,Federación de Rusia,643,0,1,1,"(7.818934,-72.453226)"
2012,Septiembre,República de Irlanda,372,0,1,1,"(8.635765,-77.346578)"
2022,Octubre,Estados Unidos de América,840,1,0,1,"(9.402978,-75.681599)"
2012,Noviembre,Nueva Zelanda,554,0,2,2,"(4.452882,-75.766298)"
2014,Agosto,República CentroÁfricana,140,5,0,5,"(4.697144,-74.140516)"
2016,Agosto,Noruega,578,6,7,13,"(10.445761,-75.516429)"
2023,Enero,China,156,0,34,34,"(3.893038,-77.067921)"
2019,Julio,Finlandia,246,2,3,5,"(3.541112,-76.384584)"
2021,Abril,Bosnia y Herzegovina,70,0,1,1,"(10.445761,-75.516429)"
2023,Febrero,República de Moldavia,498,2,4,6,"(4.697144,-74.140516)"
2020,Enero,Dinamarca,208,5,14,19,"(3.541112,-76.384584)"
2021,Octubre,Francia,250,23,40,63,"(3.541112,-76.384584)"
2018,Febrero,Jamaica,388,9,8,17,"(10.445761,-75.516429)"
2018,Noviembre,Venezuela,862,3,0,3,"(0.812436,-77.847006)"
2022,Marzo,Serbia,688,1,9,10,"(6.171601,-75.427454)"
2016,Julio,El Salvador,222,0,3,3,"(7.128456,-73.183637)"
2017,Diciembre,Suiza,756,2,1,3,"(12.586067,-81.702563)"
2012,Noviembre,Suiza,756,1,1,2,"(11.247723,-74.213989)"
2017,Diciembre,Ucrania,804,44,42,86,"(4.697144,-74.140516)"
2014,Febrero,Croacia,191,0,1,1,"(10.886611,-74.776708)"
2016,Octubre,Noruega,578,93,135,228,"(4.697144,-74.140516)"
2021,Octubre,España,724,1,0,1,"(8.36068,-72.409396)"
2016,Diciembre,Irán,364,1,1,2,"(6.171601,-75.427454)"
2019,Julio,España,724,7,3,10,"(8.635765,-77.346578)"
2018,Marzo,Canadá,124,2,0,2,"(0.25129,-76.875963)"
2022,Febrero,Austria,40,1,0,1,"(7.818934,-72.453226)"
2023,Marzo,Francia,250,6,6,12,"(8.635765,-77.346578)"
2023,Junio,China,156,0,1,1,"(7.927209,-72.507910)"
2016,Septiembre,Malta,470,6,10,16,"(4.697144,-74.140516)"
2014,Diciembre,Ucrania,804,0,4,4,"(10.408582,-75.538003)"
2016,Diciembre,Irán,364,2,0,2,"(10.886611,-74.776708)"
2016,Enero,Nueva Zelanda,554,1,1,2,"(11.247723,-74.213989)"
2019,Agosto,Reino Unido de Gran Bretaña e Irlanda del Norte,826,11,16,27,"(-4.197703,-69.941278)"
2015,Abril,Nepal,524,1,2,3,"(4.697144,-74.140516)"
2018,Junio,Venezuela,862,4,14,18,"(7.927209,-72.507910)"
2018,Junio,Argelia,12,0,2,2,"(6.171601,-75.427454)"
2018,Febrero,Eslovenia,705,1,2,3,"(0.814836,-77.662532)"
2014,Agosto,Tailandia,764,2,2,4,"(6.171601,-75.427454)"
2012,Noviembre,Venezuela,862,7,14,21,"(4.815061,-75.736532)"
2013,Agosto,Francia,250,7,5,12,"(8.635765,-77.346578)"
2018,Agosto,Venezuela,862,136,209,345,"(10.886611,-74.776708)"
2015,Junio,Perú,604,183,284,467,"(6.171601,-75.427454)"
2017,Diciembre,China,156,0,1,1,"(4.815061,-75.736532)"
2015,Julio,Alemania,276,8,17,25,"(7.818934,-72.453226)"
2013,Mayo,Jamaica,388,2,0,2,"(10.445761,-75.516429)"
2012,Febrero,Filipinas,608,0,1,1,"(7.927209,-72.507910)"
2023,Febrero,Malasia,458,14,15,29,"(4.697144,-74.140516)"
2016,Febrero,Indonesia,360,10,20,30,"(4.697144,-74.140516)"
2018,Marzo,Etiopia,231,0,2,2,"(10.445761,-75.516429)"
2014,Enero,Qatar,634,0,1,1,"(4.697144,-74.140516)"
2019,Abril,Estonia,233,2,9,11,"(6.171601,-75.427454)"
2015,Abril,Belice,84,3,12,15,"(4.697144,-74.140516)"
2023,Enero,Noruega,578,43,34,77,"(10.445761,-75.516429)"
2012,Agosto,Federación de Rusia,643,3,4,7,"(10.445761,-75.516429)"
2012,Diciembre,Rumania,642,2,0,2,"(3.541112,-76.384584)"
2018,Enero,Barbados,52,1,3,4,"(10.445761,-75.516429)"
2014,Septiembre,Austria,40,2,3,5,"(3.541112,-76.384584)"
2016,Enero,Barbados,52,11,12,23,"(4.697144,-74.140516)"
2017,Marzo,Lituania,440,3,4,7,"(10.445761,-75.516429)"
2017,Julio,Reino Unido de Gran Bretaña e Irlanda del Norte,826,16,26,42,"(10.408582,-75.538003)"
2021,Junio,Mónaco,492,1,1,2,"(4.697144,-74.140516)"
2019,Mayo,México,484,1,6,7,"(7.128456,-73.183637)"
2022,Enero,República Checa,203,1,2,3,"(10.886611,-74.776708)"
2015,Octubre,Turquía,792,0,7,7,"(3.893038,-77.067921)"
2019,Julio,Austria,40,3,2,5,"(8.635765,-77.346578)"
2018,Diciembre,Paraguay,600,0,2,2,"(0.814836,-77.662532)"
2015,Septiembre,Uruguay,858,227,415,642,"(4.697144,-74.140516)"
2013,Noviembre,Bangladesh,50,0,1,1,"(4.697144,-74.140516)"
2013,Junio,Federación de Rusia,643,2,4,6,"(6.171601,-75.427454)"
2018,Septiembre,Venezuela,862,203,225,428,"(10.445761,-75.516429)"
2014,Enero,Canadá,124,17,26,43,"(10.886611,-74.776708)"
2014,Enero,Nueva Zelanda,554,4,5,9,"(10.445761,-75.516429)"
2013,Febrero,España,724,4,6,10,"(12.586067,-81.702563)"
2016,Diciembre,Italia,380,1,1,2,"(8.36068,-72.409396)"
2023,Enero,Venezuela,862,2,7,9,"(10.408582,-75.538003)"
2017,Noviembre,Taiwán,158,7,6,13,"(6.171601,-75.427454)"
2021,Noviembre,Bangladesh,50,1,0,1,"(10.445761,-75.516429)"
2022,Septiembre,Costa Rica,188,1413,1242,2655,"(6.171601,-75.427454)"
2017,Abril,Cuba,192,1,0,1,"(8.36068,-72.409396)"
2014,Diciembre,Eslovenia,705,1,0,1,"(11.360009,-72.129330)"
2018,Diciembre,República de Irlanda,372,131,270,401,"(4.697144,-74.140516)"
2023,Junio,Tailandia,764,1,0,1,"(6.171601,-75.427454)"
2013,Noviembre,España,724,0,1,1,"(7.088729,-70.740253)"
2018,Abril,Francia,250,1,1,2,"(0.812436,-77.847006)"
2021,Febrero,Honduras,340,0,1,1,"(10.408582,-75.538003)"
2017,Octubre,República de Corea,410,0,2,2,"(10.408582,-75.538003)"
2015,Mayo,Trinidad y Tobago,780,3,15,18,"(10.445761,-75.516429)"
2015,Agosto,Emiratos Árabes,784,1,8,9,"(4.697144,-74.140516)"
2023,Febrero,Jamaica,388,0,1,1,"(10.886611,-74.776708)"
2022,Septiembre,Uruguay,858,0,3,3,"(7.927209,-72.507910)"
2019,Enero,Guyana,328,0,1,1,"(11.360009,-72.129330)"
2020,Enero,Portugal,620,0,5,5,"(-4.223468,-69.945098)"
2023,Enero,Suecia,752,1,1,2,"(-4.197703,-69.941278)"
2015,Enero,Austria,40,2,3,5,"(8.635765,-77.346578)"
2015,Enero,Uganda,800,0,1,1,"(10.445761,-75.516429)"
2021,Agosto,Emiratos Árabes,784,2,3,5,"(4.697144,-74.140516)"
2023,Junio,España,724,6,10,16,"(4.452882,-75.766298)"
2018,Julio,Alemania,276,4,3,7,"(12.586067,-81.702563)"
2018,Febrero,Suiza,756,3,1,4,"(12.586067,-81.702563)"
2022,Enero,Camerún,120,0,1,1,"(6.171601,-75.427454)"
2015,Abril,Costa Rica,188,2,18,20,"(10.886611,-74.776708)"
2012,Julio,Turquía,792,28,66,94,"(4.697144,-74.140516)"
2015,Marzo,Países Bajos,528,16,17,33,"(0.814836,-77.662532)"
2017,Abril,Montenegro,499,0,1,1,"(10.886611,-74.776708)"
2020,Diciembre,Panamá,591,420,590,1010,"(6.171601,-75.427454)"
2022,Abril,Brasil,76,111,82,193,"(12.586067,-81.702563)"
2023,Abril,España,724,115,166,281,"(3.541112,-76.384584)"
2017,Abril,Trinidad y Tobago,780,0,1,1,"(12.586067,-81.702563)"
2020,Mayo,Panamá,591,0,1,1,"(1.813928,-78.763924)"
2015,Octubre,Argentina,32,9,8,17,"(11.360009,-72.129330)"
2017,Marzo,Nueva Zelanda,554,1,1,2,"(-4.197703,-69.941278)"
2019,Agosto,Costa Rica,188,0,1,1,"(1.813928,-78.763924)"
2012,Septiembre,Lituania,440,0,1,1,"(10.971302,-74.765397)"
2018,Febrero,Surinam,740,8,14,22,"(4.697144,-74.140516)"
2020,Febrero,Indonesia,360,0,2,2,"(12.5744111,-81.703935)"
2012,Noviembre,Venezuela,862,2,3,5,"(4.452882,-75.766298)"
2021,Marzo,Omán,512,1,0,1,"(10.886611,-74.776708)"
2014,Octubre,Australia,36,22,31,53,"(10.408582,-75.538003)"
2014,Septiembre,Sri Lanka,144,0,2,2,"(4.697144,-74.140516)"
2019,Noviembre,México,484,1,4,5,"(11.117806,-74.232622)"
2018,Diciembre,Cuba,192,1,2,3,"(11.117806,-74.232622)"
2016,Febrero,Estados Unidos de América,840,91,127,218,"(4.452882,-75.766298)"
2014,Febrero,Brasil,76,0,1,1,"(7.102626,-77.762647)"
2019,Julio,Italia,380,167,305,472,"(6.171601,-75.427454)"
2014,Abril,Ecuador,218,29,64,93,"(0.25129,-76.875963)"
2018,Noviembre,China,156,0,1,1,"(-4.223468,-69.945098)"
2022,Diciembre,India,356,2,11,13,"(10.886611,-74.776708)"
2012,Marzo,Bahamas,44,0,3,3,"(10.886611,-74.776708)"
2020,Enero,San  Vicente y las Granadinas,670,1,2,3,"(4.697144,-74.140516)"
2017,Julio,Hong Kong,344,1,1,2,"(6.171601,-75.427454)"
2013,Enero,Surinam,740,2,5,7,"(6.171601,-75.427454)"
2023,Junio,Desconocido,99999,3,3,6,"(10.445761,-75.516429)"
2023,Marzo,Suiza,756,0,1,1,"(10.971302,-74.765397)"
2015,Noviembre,España,724,6,5,11,"(-4.197703,-69.941278)"
2012,Febrero,Países Bajos,528,11,22,33,"(3.541112,-76.384584)"
2016,Enero,Tailandia,764,0,1,1,"(6.171601,-75.427454)"
2018,Septiembre,Brasil,76,1,1,2,"(0.25129,-76.875963)"
2022,Diciembre,Iraq,368,0,6,6,"(4.697144,-74.140516)"
2018,Agosto,Bulgaria,100,35,19,54,"(4.697144,-74.140516)"
2016,Julio,Kazajistán,398,2,0,2,"(4.697144,-74.140516)"
2014,Diciembre,Nicaragua,558,2,13,15,"(6.171601,-75.427454)"
2019,Abril,Perú,604,0,5,5,"(7.128456,-73.183637)"
2012,Septiembre,Chile,152,11,14,25,"(7.818934,-72.453226)"
2015,Octubre,Burundi,108,2,0,2,"(4.697144,-74.140516)"
2022,Septiembre,Argentina,32,1,2,3,"(0.25129,-76.875963)"
2023,Enero,México,484,21,33,54,"(0.814836,-77.662532)"
2021,Mayo,Honduras,340,30,22,52,"(6.171601,-75.427454)"
2022,Mayo,Canadá,124,6,2,8,"(8.635765,-77.346578)"
2017,Abril,Bahamas,44,1,4,5,"(10.445761,-75.516429)"
2021,Marzo,Uzbekistán,860,0,2,2,"(10.445761,-75.516429)"
2021,Mayo,Costa Rica,188,5,9,14,"(3.541112,-76.384584)"
2021,Noviembre,Guatemala,320,88,94,182,"(10.445761,-75.516429)"
2012,Diciembre,India,356,0,14,14,"(3.893038,-77.067921)"
2019,Agosto,República Dominicana,214,7,20,27,"(0.814836,-77.662532)"
2015,Enero,Estados Unidos de América,840,0,5,5,"(12.5744111,-81.703935)"
2023,Mayo,República de Irlanda,372,0,1,1,"(11.247723,-74.213989)"
2022,Enero,Nueva Zelanda,554,1,0,1,"(10.886611,-74.776708)"
2018,Noviembre,Ucrania,804,0,8,8,"(10.971302,-74.765397)"
2019,Diciembre,Alemania,276,90,89,179,"(0.814836,-77.662532)"
2015,Junio,Qatar,634,0,1,1,"(6.171601,-75.427454)"
2012,Marzo,Federación de Rusia,643,0,2,2,"(10.971302,-74.765397)"
2015,Octubre,Estados Unidos de América,840,1573,2751,4324,"(10.445761,-75.516429)"
2015,Octubre,Camerún,120,0,1,1,"(10.445761,-75.516429)"
2018,Mayo,Mozambique,508,1,4,5,"(4.697144,-74.140516)"
2022,Septiembre,España,724,4,3,7,"(-4.223468,-69.945098)"
2016,Abril,China,156,8,12,20,"(3.541112,-76.384584)"
2018,Junio,Arabia Saudita,682,1,2,3,"(6.171601,-75.427454)"
2015,Noviembre,Azerbaiyán,31,0,2,2,"(4.697144,-74.140516)"
2017,Mayo,Bélgica,56,12,31,43,"(6.171601,-75.427454)"
2022,Diciembre,Sudáfrica,710,1,6,7,"(6.171601,-75.427454)"
2023,Mayo,Dinamarca,208,7,25,32,"(6.171601,-75.427454)"
2018,Diciembre,Honduras,340,0,1,1,"(7.128456,-73.183637)"
2015,Agosto,China,156,1,0,1,"(-4.197703,-69.941278)"
2018,Julio,Hungría,348,0,1,1,"(10.408582,-75.538003)"
2012,Octubre,España,724,11,13,24,"(10.445761,-75.516429)"
2021,Mayo,Panamá,591,0,1,1,"(8.635765,-77.346578)"
2018,Enero,Perú,604,518,361,879,"(10.445761,-75.516429)"
2023,Junio,República Checa,203,9,9,18,"(10.445761,-75.516429)"
2021,Julio,Bosnia y Herzegovina,70,1,1,2,"(6.171601,-75.427454)"
2021,Diciembre,Dinamarca,208,11,39,50,"(6.171601,-75.427454)"
2017,Diciembre,Noruega,578,14,33,47,"(6.171601,-75.427454)"
2013,Mayo,Eslovaquia,703,13,10,23,"(4.697144,-74.140516)"
2019,Febrero,República Democrática del Congo,180,1,0,1,"(3.541112,-76.384584)"
2013,Marzo,Rumania,642,1,1,2,"(0.814836,-77.662532)"
2014,Septiembre,Líbano,422,3,1,4,"(11.360009,-72.129330)"
2018,Marzo,Alemania,276,9,10,19,"(-4.197703,-69.941278)"
2018,Febrero,Perú,604,52,57,109,"(-4.223468,-69.945098)"
2014,Febrero,Canadá,124,792,790,1582,"(10.445761,-75.516429)"
2016,Septiembre,Portugal,620,7,50,57,"(3.541112,-76.384584)"
2018,Abril,Mauricio,480,0,2,2,"(10.408582,-75.538003)"
2020,Marzo,Alemania,276,24,29,53,"(10.408582,-75.538003)"
2017,Octubre,Kiribati,296,0,1,1,"(4.697144,-74.140516)"
2019,Octubre,Noruega,578,6,9,15,"(6.171601,-75.427454)"
2016,Noviembre,Malta,470,2,5,7,"(4.697144,-74.140516)"
2018,Mayo,Nicaragua,558,1,2,3,"(8.36068,-72.409396)"
2013,Enero,Surinam,740,1,0,1,"(10.445761,-75.516429)"
2012,Enero,Islandia,352,0,1,1,"(0.814836,-77.662532)"
2022,Marzo,Guatemala,320,10,18,28,"(10.886611,-74.776708)"
2015,Mayo,Brasil,76,251,203,454,"(10.445761,-75.516429)"
2017,Junio,Dinamarca,208,1,4,5,"(10.886611,-74.776708)"
2018,Mayo,Macedonia,807,0,1,1,"(10.445761,-75.516429)"
2020,Enero,Canadá,124,16,39,55,"(0.814836,-77.662532)"
2019,Diciembre,Suecia,752,0,1,1,"(0.25129,-76.875963)"
2012,Diciembre,República de Irlanda,372,1,2,3,"(11.360009,-72.129330)"
2015,Diciembre,República Checa,203,56,65,121,"(4.697144,-74.140516)"
2023,Marzo,Bulgaria,100,5,7,12,"(10.445761,-75.516429)"
2017,Abril,Perú,604,4,3,7,"(8.36068,-72.409396)"
2015,Febrero,Italia,380,18,37,55,"(0.814836,-77.662532)"
2022,Junio,Marruecos,504,1,0,1,"(10.886611,-74.776708)"
2018,Septiembre,Taiwán,158,7,11,18,"(10.445761,-75.516429)"
2012,Julio,Rwanda,646,1,0,1,"(4.697144,-74.140516)"
2021,Agosto,Guatemala,320,28,41,69,"(10.445761,-75.516429)"
2017,Abril,Tailandia,764,1,0,1,"(-4.223468,-69.945098)"
2015,Julio,Omán,512,0,2,2,"(4.697144,-74.140516)"
2014,Octubre,Venezuela,862,0,1,1,"(12.5744111,-81.703935)"
2012,Marzo,Portugal,620,0,5,5,"(3.541112,-76.384584)"
2015,Abril,Polonia,616,4,8,12,"(10.408582,-75.538003)"
2013,Noviembre,España,724,23,51,74,"(0.814836,-77.662532)"
2021,Septiembre,Suiza,756,2,2,4,"(10.886611,-74.776708)"
2019,Julio,Sri Lanka,144,0,1,1,"(6.171601,-75.427454)"
2021,Abril,República de Irlanda,372,1,1,2,"(3.541112,-76.384584)"
2022,Junio,República Checa,203,4,2,6,"(10.445761,-75.516429)"
2017,Agosto,Perú,604,111,185,296,"(7.818934,-72.453226)"
2022,Agosto,Granada,308,2,3,5,"(10.445761,-75.516429)"
2015,Agosto,Montenegro,499,1,1,2,"(10.445761,-75.516429)"
2015,Noviembre,Tanzania,834,0,1,1,"(10.445761,-75.516429)"
2014,Enero,Taiwán,158,1,0,1,"(4.452882,-75.766298)"
2022,Mayo,Estonia,233,3,5,8,"(6.171601,-75.427454)"
2016,Mayo,Panamá,591,0,6,6,"(10.408582,-75.538003)"
2019,Marzo,Trinidad y Tobago,780,1,1,2,"(4.815061,-75.736532)"
2014,Febrero,México,484,0,6,6,"(12.5744111,-81.703935)"
2013,Diciembre,Polonia,616,2,2,4,"(0.814836,-77.662532)"
2014,Mayo,Italia,380,27,110,137,"(6.171601,-75.427454)"
2015,Marzo,Alemania,276,53,93,146,"(3.541112,-76.384584)"
2022,Julio,Chile,152,2,6,8,"(4.815061,-75.736532)"
2012,Noviembre,Eslovaquia,703,16,15,31,"(4.697144,-74.140516)"
2018,Agosto,Brasil,76,377,412,789,"(10.408582,-75.538003)"
2013,Diciembre,Reino Unido de Gran Bretaña e Irlanda del Norte,826,41,91,132,"(3.541112,-76.384584)"
2022,Junio,Alemania,276,20,19,39,"(0.814836,-77.662532)"
2019,Diciembre,Polonia,616,20,33,54,"(10.445761,-75.516429)"
2016,Noviembre,Argentina,32,253,145,398,"(12.586067,-81.702563)"
2014,Junio,Austria,40,0,2,2,"(8.635765,-77.346578)"
2012,Mayo,Malta,470,0,1,1,"(0.814836,-77.662532)"
2016,Julio,Bélgica,56,406,548,954,"(4.697144,-74.140516)"
2012,Mayo,Italia,380,13,13,26,"(0.814836,-77.662532)"
2012,Julio,Letonia,428,1,1,2,"(11.528919,-72.919681)"
2016,Febrero,Argentina,32,1,1,2,"(7.128456,-73.183637)"
2017,Mayo,Sudán,736,0,1,1,"(4.697144,-74.140516)"
2016,Diciembre,España,724,49,54,103,"(0.814836,-77.662532)"
2014,Mayo,Polonia,616,0,12,12,"(3.893038,-77.067921)"
2021,Noviembre,República de Moldavia,498,5,9,14,"(4.697144,-74.140516)"
2017,Enero,Bélgica,56,1,1,2,"(11.360009,-72.129330)"
2014,Mayo,Japón,392,1,0,1,"(4.452882,-75.766298)"
2020,Febrero,Estados Unidos de América,840,2,5,7,"(0.25129,-76.875963)"
2021,Julio,Perú,604,172,97,269,"(10.445761,-75.516429)"
2019,Octubre,Etiopia,231,0,1,1,"(10.445761,-75.516429)"
2015,Noviembre,Croacia,191,0,1,1,"(10.408582,-75.538003)"
2017,Abril,Dominica,212,0,2,2,"(3.541112,-76.384584)"
2022,Febrero,España,724,111,124,235,"(10.445761,-75.516429)"
2022,Febrero,San Cristóbal y Nevis,659,2,6,8,"(4.697144,-74.140516)"
2015,Febrero,Tanzania,834,1,5,6,"(4.697144,-74.140516)"
2015,Diciembre,Brasil,76,0,1,1,"(12.5744111,-81.703935)"
2014,Abril,Sri Lanka,144,1,9,10,"(6.171601,-75.427454)"
2013,Julio,Burkina Faso,854,1,0,1,"(0.814836,-77.662532)"
2013,Julio,México,484,7,15,22,"(4.815061,-75.736532)"
2017,Agosto,España,724,0,3,3,"(7.088729,-70.740253)"
2018,Agosto,Perú,604,6,7,13,"(4.815061,-75.736532)"
2016,Julio,Estados Unidos de América,840,1630,1959,3589,"(3.541112,-76.384584)"
2018,Mayo,Nicaragua,558,1,2,3,"(7.128456,-73.183637)"
2015,Enero,Canadá,124,1,4,5,"(7.128456,-73.183637)"
2012,Junio,Japón,392,26,21,47,"(10.408582,-75.538003)"
2014,Octubre,Federación de Rusia,643,0,2,2,"(12.5744111,-81.703935)"
2019,Septiembre,Uruguay,858,47,80,127,"(6.171601,-75.427454)"
2023,Marzo,Uruguay,858,21,22,43,"(12.586067,-81.702563)"
2015,Noviembre,Croacia,191,0,8,8,"(3.541112,-76.384584)"
2018,Enero,Senegal,686,0,2,2,"(4.697144,-74.140516)"
2019,Mayo,Tailandia,764,1,1,2,"(0.814836,-77.662532)"
2017,Marzo,Irán,364,2,8,10,"(4.697144,-74.140516)"
2016,Julio,Jamaica,388,2,3,5,"(12.586067,-81.702563)"
2012,Diciembre,Costa Rica,188,2,3,5,"(7.818934,-72.453226)"
2019,Agosto,Cuba,192,1,0,1,"(12.586067,-81.702563)"
2014,Septiembre,Costa Rica,188,0,2,2,"(10.408582,-75.538003)"
2020,Febrero,Bélgica,56,2,0,2,"(13.3387613,-81.372937)"
2017,Abril,Austria,40,13,22,35,"(6.171601,-75.427454)"
2019,Febrero,Polonia,616,265,371,636,"(4.697144,-74.140516)"
2021,Abril,Chipre,196,0,2,2,"(3.541112,-76.384584)"
2019,Enero,República de Moldavia,498,2,4,6,"(4.697144,-74.140516)"
2012,Octubre,Sudán,736,0,1,1,"(4.697144,-74.140516)"
2020,Noviembre,Costa Rica,188,4,4,8,"(10.886611,-74.776708)"
2023,Mayo,Emiratos Árabes,784,3,20,23,"(4.697144,-74.140516)"
2013,Mayo,Panamá,591,522,845,1367,"(4.697144,-74.140516)"
2012,Enero,Reino Unido de Gran Bretaña e Irlanda del Norte,826,4,11,15,"(7.818934,-72.453226)"
2021,Octubre,Dominica,212,0,1,1,"(11.360009,-72.129330)"
2014,Junio,Perú,604,73,172,245,"(-4.197703,-69.941278)"
2023,Febrero,Georgia,268,1,2,3,"(10.445761,-75.516429)"
2012,Febrero,Eslovaquia,703,0,1,1,"(0.814836,-77.662532)"
2023,Marzo,Alemania,276,10,19,29,"(4.815061,-75.736532)"
2023,Febrero,Eslovaquia,703,9,15,24,"(6.171601,-75.427454)"
2020,Enero,Nigeria,566,0,2,2,"(3.541112,-76.384584)"
2021,Septiembre,Francia,250,0,2,2,"(4.815061,-75.736532)"
2020,Enero,Argentina,32,0,1,1,"(8.635765,-77.346578)"
2017,Diciembre,Argentina,32,1,4,5,"(8.36068,-72.409396)"
2018,Febrero,Chile,152,130,157,287,"(0.814836,-77.662532)"
2019,Diciembre,Suecia,752,2,4,6,"(8.635765,-77.346578)"
2015,Diciembre,Noruega,578,180,212,392,"(4.697144,-74.140516)"
2017,Enero,Perú,604,88,177,265,"(7.818934,-72.453226)"
2016,Junio,Italia,380,3,7,10,"(-4.197703,-69.941278)"
2018,Enero,China,156,1,1,2,"(11.247723,-74.213989)"
2021,Diciembre,Estados Unidos de América,840,29,81,110,"(10.408582,-75.538003)"
2014,Agosto,República de Corea,410,174,451,625,"(4.697144,-74.140516)"
2014,Abril,Italia,380,0,2,2,"(7.927209,-72.507910)"
2013,Julio,Isla de Man,833,2,4,6,"(10.445761,-75.516429)"
2015,Septiembre,Bolivia,68,10,16,26,"(0.814836,-77.662532)"
2019,Mayo,Reino Unido de Gran Bretaña e Irlanda del Norte,826,117,157,274,"(10.445761,-75.516429)"
2019,Julio,Croacia,191,23,45,68,"(4.697144,-74.140516)"
2022,Junio,Trinidad y Tobago,780,10,26,36,"(6.171601,-75.427454)"
2017,Febrero,Polonia,616,2,14,16,"(10.445761,-75.516429)"
2020,Febrero,Ecuador,218,0,1,1,"(8.635765,-77.346578)"
2019,Abril,Islas Caimán/Territorio Británico de Ultramar,136,1,0,1,"(3.541112,-76.384584)"
2017,Diciembre,Nueva Zelanda,554,4,1,5,"(3.541112,-76.384584)"
2015,Junio,Países Bajos,528,0,1,1,"(10.971302,-74.765397)"
2014,Enero,Grecia,300,16,56,72,"(4.697144,-74.140516)"
2018,Diciembre,Bolivia,68,0,2,2,"(8.36068,-72.409396)"
2018,Marzo,Desconocido,99999,80,132,212,"(4.697144,-74.140516)"
2019,Marzo,Vietnam,704,13,4,17,"(4.697144,-74.140516)"
2018,Diciembre,Finlandia,246,8,18,26,"(6.171601,-75.427454)"
2012,Abril,Brasil,76,7,21,28,"(7.818934,-72.453226)"
2017,Mayo,España,724,1,1,2,"(7.088729,-70.740253)"
2018,Noviembre,Estados Unidos de América,840,1,0,1,"(11.528919,-72.919681)"
2019,Junio,España,724,308,439,747,"(3.541112,-76.384584)"
2021,Julio,Bélgica,56,0,1,1,"(4.815061,-75.736532)"
2017,Noviembre,Federación de Rusia,643,0,1,1,"(-4.197703,-69.941278)"
2013,Noviembre,Nicaragua,558,0,1,1,"(12.586067,-81.702563)"
2022,Octubre,Nicaragua,558,20,12,32,"(10.445761,-75.516429)"
2021,Enero,República de Corea,410,2,1,3,"(3.541112,-76.384584)"
2017,Diciembre,Arabia Saudita,682,0,15,15,"(4.697144,-74.140516)"
2018,Enero,Venezuela,862,0,1,1,"(-4.223468,-69.945098)"
2014,Julio,Brasil,76,0,1,1,"(0.25129,-76.875963)"
2013,Abril,Guatemala,320,3,16,19,"(10.886611,-74.776708)"
2023,Febrero,Estados Unidos de América,840,25,26,51,"(7.927209,-72.507910)"
2021,Octubre,Dominica,212,0,1,1,"(6.171601,-75.427454)"
2021,Febrero,Portugal,620,1,3,4,"(10.445761,-75.516429)"
2019,Agosto,Islas Vírgenes Británicas/Territorio Británico de Ultramar,92,0,1,1,"(6.171601,-75.427454)"
2012,Diciembre,Túnez,788,1,0,1,"(10.445761,-75.516429)"
2014,Diciembre,Paraguay,600,12,2,14,"(3.541112,-76.384584)"
2022,Enero,Guinea,324,0,1,1,"(6.171601,-75.427454)"
2018,Diciembre,Noruega,578,2,1,3,"(10.408582,-75.538003)"
2015,Diciembre,Australia,36,8,18,26,"(10.886611,-74.776708)"
2023,Marzo,Bulgaria,100,0,1,1,"(10.886611,-74.776708)"
2018,Octubre,Costa Rica,188,12,12,24,"(12.586067,-81.702563)"
2019,Agosto,Jamaica,388,2,3,5,"(12.586067,-81.702563)"
2022,Febrero,Polonia,616,1,12,13,"(10.408582,-75.538003)"
2016,Enero,Reino Unido de Gran Bretaña e Irlanda del Norte,826,5,12,17,"(-4.197703,-69.941278)"
2018,Junio,Ecuador,218,7,5,12,"(10.408582,-75.538003)"
2015,Junio,Belice,84,10,8,18,"(4.697144,-74.140516)"
2018,Noviembre,Ecuador,218,10,9,19,"(11.360009,-72.129330)"
2023,Febrero,España,724,0,1,1,"(6.18189,-67.47535)"
2015,Septiembre,Estados Unidos de América,840,464,943,1407,"(10.886611,-74.776708)"
2022,Abril,Portugal,620,1,0,1,"(10.408582,-75.538003)"
2015,Mayo,Nicaragua,558,4,7,11,"(10.445761,-75.516429)"
2022,Abril,Egipto,818,0,2,2,"(10.886611,-74.776708)"
2018,Marzo,Guatemala,320,0,1,1,"(7.818934,-72.453226)"
2013,Noviembre,Suiza,756,21,46,67,"(6.171601,-75.427454)"
2015,Enero,Panamá,591,1,0,1,"(11.117806,-74.232622)"
2021,Junio,Guatemala,320,24,14,38,"(3.541112,-76.384584)"
2021,Septiembre,España,724,1335,2640,3975,"(4.697144,-74.140516)"
2021,Enero,Costa Rica,188,18,21,39,"(10.445761,-75.516429)"
2014,Mayo,Panamá,591,99,78,177,"(12.586067,-81.702563)"
2012,Junio,Perú,604,319,209,528,"(12.586067,-81.702563)"
2020,Febrero,República Dominicana,214,0,1,1,"(7.088729,-70.740253)"
2012,Julio,República Árabe Siria,760,0,1,1,"(10.408582,-75.538003)"
2017,Septiembre,México,484,3,2,5,"(7.088729,-70.740253)"
2013,Febrero,México,484,3,13,16,"(0.814836,-77.662532)"
2022,Febrero,Canadá,124,6,13,19,"(4.815061,-75.736532)"
2018,Febrero,Suiza,756,1,0,1,"(4.815061,-75.736532)"
2017,Abril,Japón,392,1,2,3,"(-4.223468,-69.945098)"
2015,Noviembre,Polonia,616,16,5,21,"(-4.197703,-69.941278)"
2021,Agosto,España,724,10,11,21,"(7.916725,-72.462544)"
2019,Junio,Reino Unido de Gran Bretaña e Irlanda del Norte,826,35,55,90,"(3.541112,-76.384584)"
2015,Noviembre,Rumania,642,3,3,6,"(6.171601,-75.427454)"
2021,Febrero,República de Irlanda,372,1,0,1,"(10.886611,-74.776708)"
2019,Noviembre,Sri Lanka,144,1,1,2,"(10.445761,-75.516429)"
2013,Agosto,Francia,250,29,38,67,"(10.445761,-75.516429)"
2017,Noviembre,Zimbabue,716,0,1,1,"(3.541112,-76.384584)"
2019,Abril,Bélgica,56,0,1,1,"(11.360009,-72.129330)"
2021,Enero,Países Bajos,528,192,404,596,"(4.697144,-74.140516)"
2019,Noviembre,Panamá,591,1843,1593,3436,"(6.171601,-75.427454)"
2013,Junio,Suecia,752,3,4,7,"(10.408582,-75.538003)"
2013,Noviembre,Perú,604,171,378,549,"(0.814836,-77.662532)"
2022,Octubre,Suecia,752,9,21,30,"(10.445761,-75.516429)"
2016,Enero,Panamá,591,33,41,74,"(4.815061,-75.736532)"
2012,Marzo,Suecia,752,2,8,10,"(10.886611,-74.776708)"
2018,Julio,Chile,152,0,1,1,"(4.452882,-75.766298)"
2016,Mayo,Cuba,192,0,1,1,"(11.117806,-74.232622)"
2012,Junio,Suiza,756,0,2,2,"(7.128456,-73.183637)"
2017,Julio,Polonia,616,0,1,1,"(8.36068,-72.409396)"
2016,Octubre,Japón,392,0,1,1,"(11.360009,-72.129330)"
2012,Junio,Palestina,99999,1,1,2,"(4.697144,-74.140516)"
2015,Julio,Jamaica,388,19,25,44,"(4.697144,-74.140516)"
2014,Enero,Mongolia,496,1,0,1,"(4.697144,-74.140516)"
2019,Mayo,Canadá,124,5,5,10,"(12.586067,-81.702563)"
2014,Abril,Noruega,578,3,4,7,"(3.541112,-76.384584)"
2018,Agosto,Israel,376,3,9,12,"(3.541112,-76.384584)"
2016,Junio,Filipinas,608,0,12,12,"(10.886611,-74.776708)"
2013,Agosto,Andorra,20,0,4,4,"(10.445761,-75.516429)"
2016,Enero,Estados Unidos de América,840,79,133,212,"(0.814836,-77.662532)"
2022,Marzo,Lituania,440,0,4,4,"(10.408582,-75.538003)"
2012,Noviembre,Israel,376,1,13,14,"(3.541112,-76.384584)"
2016,Junio,Estados Unidos de América,840,43,23,66,"(7.927209,-72.507910)"
2013,Noviembre,Reino Unido de Gran Bretaña e Irlanda del Norte,826,1,0,1,"(7.088729,-70.740253)"
2014,Agosto,Austria,40,8,12,20,"(6.171601,-75.427454)"
2017,Febrero,República Checa,203,1,0,1,"(10.886611,-74.776708)"
2019,Septiembre,México,484,289,388,677,"(10.445761,-75.516429)"
2016,Abril,Taiwán,158,1,3,4,"(0.814836,-77.662532)"
2021,Julio,México,484,30,44,74,"(10.886611,-74.776708)"
2013,Octubre,Chile,152,1,1,2,"(0.25129,-76.875963)"
2014,Marzo,República de Corea,410,0,1,1,"(-4.197703,-69.941278)"
2020,Mayo,Panamá,591,0,3,3,"(10.886611,-74.776708)"
2016,Enero,Austria,40,3,1,4,"(8.635765,-77.346578)"
2013,Enero,Japón,392,4,23,27,"(0.814836,-77.662532)"
2012,Diciembre,Australia,36,7,2,9,"(8.635765,-77.346578)"
2012,Septiembre,Surinam,740,0,1,1,"(3.541112,-76.384584)"
2023,Junio,República de Kosovo,901,1,1,2,"(4.697144,-74.140516)"
2012,Noviembre,Suecia,752,11,14,25,"(6.171601,-75.427454)"
2012,Enero,España,724,1,3,4,"(7.927209,-72.507910)"
2023,Abril,México,484,0,33,33,"(3.893038,-77.067921)"
2021,Marzo,Brasil,76,1,0,1,"(4.452882,-75.766298)"
2013,Enero,Brasil,76,9,7,16,"(10.408582,-75.538003)"
2015,Febrero,Cuba,192,4,4,8,"(3.541112,-76.384584)"
2014,Junio,Perú,604,89,70,159,"(10.445761,-75.516429)"
2014,Junio,Bolivia,68,20,21,41,"(6.171601,-75.427454)"
2012,Diciembre,Gabón,266,0,1,1,"(4.697144,-74.140516)"
2016,Octubre,República Dominicana,214,52,87,139,"(6.171601,-75.427454)"
2014,Marzo,Nicaragua,558,0,1,1,"(12.586067,-81.702563)"
2018,Abril,Australia,36,300,465,765,"(4.697144,-74.140516)"
2017,Agosto,Bélgica,56,0,3,3,"(10.886611,-74.776708)"
2019,Enero,Mauricio,480,3,0,3,"(4.697144,-74.140516)"
2020,Diciembre,Honduras,340,0,1,1,"(7.128456,-73.183637)"
2012,Septiembre,Canadá,124,1,0,1,"(11.247723,-74.213989)"
2023,Enero,Malta,470,1,4,5,"(6.171601,-75.427454)"
2014,Abril,Ecuador,218,2,0,2,"(6.185799,-67.483929)"
2016,Diciembre,Malta,470,3,8,11,"(4.697144,-74.140516)"
2023,Febrero,Ecuador,218,600,444,1044,"(10.445761,-75.516429)"
2019,Diciembre,México,484,33,53,86,"(10.886611,-74.776708)"
2016,Enero,Portugal,620,0,5,5,"(10.408582,-75.538003)"
2021,Enero,República Dominicana,214,20,17,37,"(10.445761,-75.516429)"
2012,Marzo,Estonia,233,18,18,36,"(4.697144,-74.140516)"
2018,Julio,Cuba,192,6,2,8,"(4.815061,-75.736532)"
2020,Febrero,Bermudas/Territorio Británico de Ultramar,60,1,0,1,"(6.171601,-75.427454)"
2016,Diciembre,España,724,10,18,28,"(12.586067,-81.702563)"
2014,Junio,Israel,376,102,531,633,"(4.697144,-74.140516)"
2014,Junio,Suiza,756,284,472,756,"(4.697144,-74.140516)"
2016,Octubre,China,156,11,14,25,"(3.541112,-76.384584)"
2017,Abril,El Salvador,222,142,182,324,"(3.541112,-76.384584)"
2023,Febrero,Canadá,124,1,4,5,"(7.818934,-72.453226)"
2021,Mayo,Francia,250,3,4,7,"(10.886611,-74.776708)"
2018,Junio,México,484,234,350,584,"(10.445761,-75.516429)"
2018,Marzo,Canadá,124,89,77,166,"(3.541112,-76.384584)"
2023,Marzo,México,484,12,10,22,"(7.927209,-72.507910)"
2017,Marzo,Suecia,752,4,3,7,"(8.635765,-77.346578)"
2019,Diciembre,Suecia,752,57,93,150,"(10.445761,-75.516429)"
2022,Septiembre,Panamá,591,2,9,11,"(8.635765,-77.346578)"
2019,Mayo,Eslovaquia,703,0,2,2,"(0.814836,-77.662532)"
2016,Junio,Ecuador,218,26,51,77,"(7.818934,-72.453226)"
2012,Enero,Taiwán,158,2,3,5,"(10.445761,-75.516429)"
2012,Noviembre,España,724,2,11,13,"(8.635765,-77.346578)"
2013,Octubre,Dinamarca,208,5,9,14,"(6.171601,-75.427454)"
2012,Noviembre,Alemania,276,2,1,3,"(11.247723,-74.213989)"
2023,Enero,Venezuela,862,297,240,537,"(10.445761,-75.516429)"
2019,Abril,Luxemburgo,442,1,0,1,"(6.171601,-75.427454)"
2017,Mayo,Portugal,620,164,430,594,"(4.697144,-74.140516)"
2022,Enero,El Salvador,222,2,2,4,"(4.452882,-75.766298)"
2021,Abril,Andorra,20,1,2,3,"(4.697144,-74.140516)"
2013,Julio,Uruguay,858,2,1,3,"(10.408582,-75.538003)"
2017,Abril,Filipinas,608,27,130,157,"(4.697144,-74.140516)"
2018,Marzo,Líbano,422,0,1,1,"(12.586067,-81.702563)"
2016,Marzo,Surinam,740,0,2,2,"(10.886611,-74.776708)"
2016,Febrero,Estados Unidos de América,840,14,14,28,"(8.635765,-77.346578)"
2015,Mayo,Canadá,124,656,1178,1834,"(4.697144,-74.140516)"
2014,Febrero,Uruguay,858,10,33,43,"(3.541112,-76.384584)"
2016,Octubre,India,356,6,27,33,"(10.445761,-75.516429)"
2021,Septiembre,Perú,604,0,1,1,"(1.813928,-78.763924)"
2021,Diciembre,Federación de Rusia,643,315,274,589,"(4.697144,-74.140516)"
2017,Julio,Hong Kong,344,8,2,10,"(4.697144,-74.140516)"
2016,Septiembre,Honduras,340,2,1,3,"(0.814836,-77.662532)"
2022,Marzo,Bolivia,68,2,1,3,"(4.452882,-75.766298)"
2018,Julio,España,724,16,20,36,"(10.408582,-75.538003)"
2013,Abril,Bangladesh,50,2,2,4,"(4.697144,-74.140516)"
2014,Diciembre,Filipinas,608,0,21,21,"(11.247723,-74.213989)"
2020,Febrero,Dominica,212,1,1,2,"(3.541112,-76.384584)"
2013,Enero,Francia,250,1,3,4,"(0.25129,-76.875963)"
2013,Octubre,Costa Rica,188,1,0,1,"(0.814836,-77.662532)"
2017,Julio,Suiza,756,872,1054,1926,"(4.697144,-74.140516)"
2016,Febrero,Venezuela,862,208,227,435,"(7.927209,-72.507910)"
2018,Agosto,Dinamarca,208,0,1,1,"(4.815061,-75.736532)"
2018,Febrero,Hungría,348,1,0,1,"(10.408582,-75.538003)"
2023,Mayo,Reino Unido de Gran Bretaña e Irlanda del Norte,826,0,5,5,"(11.247723,-74.213989)"
2013,Septiembre,Kuwait,414,0,2,2,"(4.697144,-74.140516)"
2015,Marzo,Panamá,591,1,6,7,"(8.635765,-77.346578)"
2019,Febrero,Paraguay,600,0,3,3,"(7.818934,-72.453226)"
2012,Marzo,Jamaica,388,2,4,6,"(10.445761,-75.516429)"
2022,Octubre,Venezuela,862,1,2,3,"(1.813928,-78.763924)"
2021,Diciembre,Italia,380,79,221,300,"(6.171601,-75.427454)"
2021,Marzo,República Dominicana,214,1,0,1,"(7.818934,-72.453226)"
2023,Junio,Argentina,32,36,30,66,"(11.117806,-74.232622)"
2020,Noviembre,Estados Unidos de América,840,110,204,314,"(4.452882,-75.766298)"
2019,Marzo,República Árabe Siria,760,1,4,5,"(4.697144,-74.140516)"
2012,Abril,Canadá,124,0,1,1,"(12.5744111,-81.703935)"
2015,Enero,Panamá,591,3,10,13,"(7.818934,-72.453226)"
2014,Febrero,Sri Lanka,144,0,1,1,"(6.171601,-75.427454)"
2023,Febrero,Filipinas,608,0,34,34,"(10.886611,-74.776708)"
2013,Enero,Bosnia y Herzegovina,70,1,0,1,"(6.171601,-75.427454)"
2017,Julio,El Salvador,222,685,814,1499,"(4.697144,-74.140516)"
2022,Noviembre,Perú,604,0,2,2,"(6.17134,-75.427194)"
2015,Noviembre,Barbados,52,0,1,1,"(11.360009,-72.129330)"
2019,Junio,Federación de Rusia,643,0,3,3,"(10.408582,-75.538003)"
2022,Marzo,Alemania,276,25,23,48,"(10.408582,-75.538003)"
2016,Marzo,Alemania,276,2016,2874,4890,"(4.697144,-74.140516)"
2015,Mayo,México,484,4,3,7,"(11.360009,-72.129330)"
2014,Febrero,México,484,1,0,1,"(0.25129,-76.875963)"
2014,Noviembre,Federación de Rusia,643,0,1,1,"(3.893038,-77.067921)"
2021,Noviembre,República de Irlanda,372,4,13,17,"(10.445761,-75.516429)"
2017,Agosto,Grecia,300,0,1,1,"(0.814836,-77.662532)"
2012,Enero,Uruguay,858,116,220,336,"(4.697144,-74.140516)"
2023,Abril,Panamá,591,83,153,236,"(4.815061,-75.736532)"
2015,Enero,Nicaragua,558,3,5,8,"(10.445761,-75.516429)"
2021,Diciembre,Liechtenstein,438,1,2,3,"(6.171601,-75.427454)"
2023,Abril,Alemania,276,1,1,2,"(8.36068,-72.409396)"
2018,Julio,Ucrania,804,0,6,6,"(10.408582,-75.538003)"
2022,Marzo,Australia,36,0,1,1,"(4.815061,-75.736532)"
2012,Abril,República Dominicana,214,28,54,82,"(10.445761,-75.516429)"
2022,Noviembre,Taiwán,158,7,11,18,"(6.171601,-75.427454)"
2022,Noviembre,Croacia,191,1,8,9,"(3.541112,-76.384584)"
2014,Julio,República de Irlanda,372,0,1,1,"(7.818934,-72.453226)"
2020,Febrero,Chile,152,17,26,43,"(7.818934,-72.453226)"
2020,Diciembre,Australia,36,16,70,86,"(4.697144,-74.140516)"
2012,Diciembre,Bolivia,68,18,11,29,"(12.586067,-81.702563)"
2023,Enero,Bahamas,44,5,12,17,"(6.171601,-75.427454)"
2018,Septiembre,Barbados,52,6,9,15,"(4.697144,-74.140516)"
2022,Diciembre,Estados Unidos de América,840,1,6,7,"(-4.197703,-69.941278)"
2017,Noviembre,Pakistán,586,1,1,2,"(10.445761,-75.516429)"
2014,Agosto,Países Bajos,528,3,5,8,"(8.635765,-77.346578)"
2019,Agosto,Portugal,620,2,1,3,"(-4.223468,-69.945098)"
2015,Abril,Belice,84,0,1,1,"(11.360009,-72.129330)"
2016,Mayo,Rumania,642,2,2,4,"(0.814836,-77.662532)"
2022,Mayo,Myanmar,104,0,1,1,"(11.247723,-74.213989)"
2013,Febrero,Indonesia,360,0,4,4,"(10.445761,-75.516429)"
2022,Julio,Ecuador,218,27,38,65,"(7.818934,-72.453226)"
2016,Julio,México,484,5171,7220,12391,"(4.697144,-74.140516)"
2013,Octubre,China,156,1,1,2,"(0.814836,-77.662532)"
2018,Enero,India,356,0,2,2,"(4.815061,-75.736532)"
2013,Julio,Tanzania,834,0,1,1,"(7.818934,-72.453226)"
2012,Septiembre,Brasil,76,2409,3943,6352,"(4.697144,-74.140516)"
2013,Enero,Uruguay,858,1,1,2,"(7.927209,-72.507910)"
2015,Abril,Países Bajos,528,15,21,36,"(0.814836,-77.662532)"
2014,Marzo,Uruguay,858,3,1,4,"(11.360009,-72.129330)"
2018,Agosto,Italia,380,2,3,5,"(8.635765,-77.346578)"
2014,Julio,Croacia,191,2,1,3,"(11.360009,-72.129330)"
2018,Diciembre,España,724,1,2,3,"(11.117806,-74.232622)"
2018,Mayo,Honduras,340,0,3,3,"(0.814836,-77.662532)"
2017,Junio,Venezuela,862,87,127,214,"(10.445761,-75.516429)"
2014,Agosto,Bélgica,56,9,22,31,"(0.814836,-77.662532)"
2023,Mayo,Israel,376,1,6,7,"(-4.223468,-69.945098)"
2023,Abril,México,484,1,0,1,"(13.3387613,-81.372937)"
2020,Abril,Tailandia,764,0,1,1,"(4.697144,-74.140516)"
2023,Junio,Panamá,591,0,7,7,"(3.893038,-77.067921)"
2018,Junio,Arabia Saudita,682,0,1,1,"(0.814836,-77.662532)"
2013,Mayo,República Checa,203,3,2,5,"(10.445761,-75.516429)"
2023,Marzo,Arabia Saudita,682,0,1,1,"(4.452882,-75.766298)"
2013,Octubre,Taiwán,158,0,1,1,"(11.360009,-72.129330)"
2015,Octubre,Bolivia,68,2,3,5,"(10.886611,-74.776708)"
2019,Junio,Islas Caimán/Territorio Británico de Ultramar,136,0,3,3,"(4.697144,-74.140516)"
2016,Enero,Polonia,616,12,20,32,"(0.814836,-77.662532)"
2022,Marzo,Países Bajos,528,0,3,3,"(11.360009,-72.129330)"
2016,Mayo,Bahréin,48,1,0,1,"(10.445761,-75.516429)"
2017,Marzo,Reino Unido de Gran Bretaña e Irlanda del Norte,826,82,157,239,"(10.445761,-75.516429)"
2022,Febrero,Ecuador,218,1,4,5,"(7.916725,-72.462544)"
2015,Enero,Taiwán,158,5,6,11,"(0.814836,-77.662532)"
2014,Agosto,San Cristóbal y Nevis,659,0,1,1,"(6.171601,-75.427454)"
2017,Junio,Turquía,792,0,1,1,"(10.408582,-75.538003)"
2020,Enero,Argelia,12,1,0,1,"(6.171601,-75.427454)"
2023,Mayo,Suiza,756,3,3,6,"(8.635765,-77.346578)"
2014,Marzo,Estados Unidos de América,840,1,2,3,"(13.3387613,-81.372937)"
2018,Mayo,Sudán,736,1,2,3,"(4.697144,-74.140516)"
2021,Noviembre,Argentina,32,2,9,11,"(7.818934,-72.453226)"
2023,Enero,Azerbaiyán,31,0,2,2,"(6.171601,-75.427454)"
2022,Mayo,Suecia,752,1,0,1,"(0.25129,-76.875963)"
2018,Septiembre,Trinidad y Tobago,780,1,2,3,"(10.886611,-74.776708)"
2021,Junio,Perú,604,6,14,20,"(4.815061,-75.736532)"
2022,Mayo,Japón,392,0,1,1,"(7.916725,-72.462544)"
2015,Febrero,Costa Rica,188,0,1,1,"(-4.197703,-69.941278)"
2017,Septiembre,Francia,250,0,1,1,"(13.3387613,-81.372937)"
2014,Diciembre,España,724,3,13,16,"(4.815061,-75.736532)"
2018,Agosto,México,484,28,64,92,"(10.886611,-74.776708)"
2019,Junio,Portugal,620,10,27,37,"(10.445761,-75.516429)"
2019,Mayo,Lituania,440,1,0,1,"(3.541112,-76.384584)"
2016,Marzo,India,356,0,1,1,"(3.893038,-77.067921)"
2018,Enero,Kuwait,414,0,6,6,"(4.697144,-74.140516)"
2013,Mayo,Paraguay,600,5,2,7,"(12.586067,-81.702563)"
2014,Octubre,Pakistán,586,1,1,2,"(6.171601,-75.427454)"
2017,Noviembre,Camerún,120,1,0,1,"(4.697144,-74.140516)"
2023,Junio,Gambia,270,0,2,2,"(4.697144,-74.140516)"
2019,Septiembre,Vietnam,704,2,0,2,"(10.445761,-75.516429)"
2022,Octubre,Australia,36,0,2,2,"(11.360009,-72.129330)"
2015,Julio,Austria,40,0,2,2,"(7.818934,-72.453226)"
2018,Abril,Jordania,400,1,1,2,"(10.445761,-75.516429)"
2017,Mayo,Canadá,124,952,1554,2506,"(4.697144,-74.140516)"
2015,Mayo,Honduras,340,0,1,1,"(11.360009,-72.129330)"
2015,Enero,Lituania,440,16,14,30,"(4.697144,-74.140516)"
2019,Julio,República Democrática del Congo,180,3,9,12,"(4.697144,-74.140516)"
2016,Agosto,Suiza,756,4,2,6,"(8.635765,-77.346578)"
2017,Enero,Macedonia,807,0,1,1,"(10.408582,-75.538003)"
2013,Julio,El Salvador,222,1,1,2,"(4.815061,-75.736532)"
2012,Febrero,Guatemala,320,1,5,6,"(10.408582,-75.538003)"
2016,Diciembre,Argentina,32,137,118,255,"(12.586067,-81.702563)"
2021,Noviembre,Chile,152,0,2,2,"(7.128456,-73.183637)"
2023,Marzo,El Salvador,222,2,4,6,"(12.586067,-81.702563)"
2023,Enero,Austria,40,1,3,4,"(11.117806,-74.232622)"
2023,Febrero,Desconocido,99999,1,0,1,"(10.445761,-75.516429)"
2015,Agosto,Estados Unidos de América,840,1,9,10,"(12.5744111,-81.703935)"
2017,Agosto,Ucrania,804,17,35,52,"(4.697144,-74.140516)"
2020,Febrero,Filipinas,608,0,16,16,"(10.886611,-74.776708)"
2018,Febrero,Panamá,591,390,343,733,"(3.541112,-76.384584)"
2018,Agosto,Portugal,620,8,15,23,"(3.541112,-76.384584)"
2019,Noviembre,Barbados,52,1,1,2,"(6.171601,-75.427454)"
2023,Febrero,Honduras,340,0,3,3,"(10.408582,-75.538003)"
2012,Octubre,Sudáfrica,710,3,1,4,"(10.408582,-75.538003)"
2012,Febrero,Islandia,352,1,0,1,"(6.171601,-75.427454)"
2017,Agosto,Australia,36,20,37,57,"(0.814836,-77.662532)"
2018,Septiembre,Uruguay,858,0,1,1,"(-4.223468,-69.945098)"
2014,Octubre,Dominica,212,2,2,4,"(4.697144,-74.140516)"
2017,Enero,Granada,308,0,1,1,"(10.445761,-75.516429)"
2019,Diciembre,Portugal,620,1,1,2,"(10.408582,-75.538003)"
2023,Enero,Francia,250,2771,3598,6369,"(4.697144,-74.140516)"
2012,Marzo,México,484,3,3,6,"(7.927209,-72.507910)"
2016,Agosto,España,724,7,37,44,"(7.818934,-72.453226)"
2022,Octubre,Perú,604,0,1,1,"(6.17134,-75.427194)"
2017,Octubre,República de Corea,410,3,2,5,"(-4.197703,-69.941278)"
2012,Marzo,Australia,36,0,1,1,"(4.815061,-75.736532)"
2013,Mayo,Honduras,340,1,3,4,"(8.635765,-77.346578)"
2022,Septiembre,Noruega,578,0,1,1,"(0.814836,-77.662532)"
2012,Mayo,España,724,0,2,2,"(12.586067,-81.702563)"
2018,Mayo,China,156,1,0,1,"(-4.223468,-69.945098)"
2016,Diciembre,Indonesia,360,1,1,2,"(6.171601,-75.427454)"
2022,Septiembre,Costa Rica,188,2160,2330,4491,"(4.697144,-74.140516)"
2013,Octubre,Venezuela,862,583,579,1162,"(6.171601,-75.427454)"
2017,Julio,Ecuador,218,32,96,128,"(1.813928,-78.763924)"
2019,Octubre,Estados Unidos de América,840,3,3,6,"(12.5744111,-81.703935)"
2012,Marzo,Nueva Zelanda,554,0,4,4,"(3.541112,-76.384584)"
2015,Junio,Panamá,591,4,8,12,"(7.128456,-73.183637)"
2020,Septiembre,Brunei Darussalam,96,1,0,1,"(3.541112,-76.384584)"
2015,Enero,Nicaragua,558,0,10,10,"(10.408582,-75.538003)"
2012,Mayo,Estados Unidos de América,840,1,1,2,"(7.088729,-70.740253)"
2018,Abril,Italia,380,0,2,2,"(12.5744111,-81.703935)"
2019,Noviembre,Israel,376,2,3,5,"(10.408582,-75.538003)"
2016,Agosto,Perú,604,152,131,283,"(10.445761,-75.516429)"
2018,Junio,España,724,1,0,1,"(4.452882,-75.766298)"
2016,Noviembre,Brasil,76,107,302,409,"(6.171601,-75.427454)"
2023,Abril,Brasil,76,1,7,8,"(10.408582,-75.538003)"
2017,Octubre,Bélgica,56,2,2,4,"(4.815061,-75.736532)"
2013,Agosto,Francia,250,1,1,2,"(0.25129,-76.875963)"
2013,Diciembre,Honduras,340,39,40,79,"(6.171601,-75.427454)"
2018,Diciembre,Bulgaria,100,5,8,13,"(10.445761,-75.516429)"
2018,Marzo,Estados Unidos de América,840,1368,1635,3003,"(3.541112,-76.384584)"
2015,Febrero,México,484,0,1,1,"(11.247723,-74.213989)"
2014,Junio,Brasil,76,8,15,23,"(0.814836,-77.662532)"
2014,Junio,Federación de Rusia,643,1,3,4,"(12.586067,-81.702563)"
2013,Septiembre,Hungría,348,0,1,1,"(4.815061,-75.736532)"
2021,Diciembre,Austria,40,1,2,3,"(0.814836,-77.662532)"
2012,Febrero,Chile,152,24,37,61,"(3.541112,-76.384584)"
2019,Diciembre,Granada,308,0,1,1,"(10.408582,-75.538003)"
2016,Abril,República Checa,203,0,2,2,"(8.635765,-77.346578)"
2022,Enero,República de Irlanda,372,6,3,9,"(10.408582,-75.538003)"
2014,Agosto,Belice,84,1,1,2,"(10.445761,-75.516429)"
2021,Marzo,Venezuela,862,0,1,1,"(6.228046,-77.404104)"
2021,Enero,España,724,1,2,3,"(11.247723,-74.213989)"
2019,Abril,Perú,604,313,349,662,"(3.541112,-76.384584)"
2017,Marzo,Haití,332,0,1,1,"(10.886611,-74.776708)"
2016,Marzo,Hungría,348,0,4,4,"(6.171601,-75.427454)"
2013,Abril,República Checa,203,2,1,3,"(0.814836,-77.662532)"
2014,Mayo,Alemania,276,0,1,1,"(7.088729,-70.740253)"
2013,Enero,Indonesia,360,3,14,17,"(4.697144,-74.140516)"
2019,Septiembre,Venezuela,862,49,53,102,"(10.408582,-75.538003)"
2018,Diciembre,India,356,3,7,10,"(3.541112,-76.384584)"
2023,Abril,Chipre,196,0,1,1,"(3.541112,-76.384584)"
2012,Abril,Estados Unidos de América,840,721,1994,2715,"(6.171601,-75.427454)"
2012,Marzo,Alemania,276,5,17,22,"(10.886611,-74.776708)"
2016,Febrero,Ucrania,804,22,30,52,"(4.697144,-74.140516)"
2018,Marzo,Suecia,752,1,0,1,"(7.128456,-73.183637)"
2013,Mayo,Israel,376,0,1,1,"(4.815061,-75.736532)"
2015,Febrero,Turquía,792,0,4,4,"(3.541112,-76.384584)"
2022,Junio,Chile,152,6,7,13,"(11.360009,-72.129330)"
2017,Diciembre,Estados Unidos de América,840,4638,5962,10600,"(10.445761,-75.516429)"
2018,Febrero,Bélgica,56,0,1,1,"(10.971302,-74.765397)"
2022,Julio,Argelia,12,7,22,29,"(4.697144,-74.140516)"
2018,Febrero,Pakistán,586,5,16,21,"(4.697144,-74.140516)"
2015,Agosto,Suiza,756,378,545,923,"(4.697144,-74.140516)"
2012,Octubre,Paraguay,600,3,3,6,"(7.128456,-73.183637)"
2018,Noviembre,Austria,40,1,3,4,"(11.247723,-74.213989)"
2014,Diciembre,San Marino,674,0,1,1,"(4.697144,-74.140516)"
2016,Mayo,Bulgaria,100,20,27,47,"(4.697144,-74.140516)"
2022,Octubre,Cuba,192,8,7,15,"(10.445761,-75.516429)"
2023,Febrero,Uruguay,858,293,389,682,"(4.697144,-74.140516)"
2014,Marzo,Sudáfrica,710,1,2,3,"(6.171601,-75.427454)"
2013,Octubre,Taiwán,158,0,1,1,"(6.171601,-75.427454)"
2014,Noviembre,Luxemburgo,442,3,8,11,"(4.697144,-74.140516)"
2019,Enero,Togo,768,0,1,1,"(4.697144,-74.140516)"
2017,Julio,Chipre,196,0,2,2,"(6.171601,-75.427454)"
2022,Enero,Cuba,192,175,260,435,"(4.697144,-74.140516)"
2018,Abril,Santa Sede/Ciudad del Vaticano,336,0,2,2,"(4.697144,-74.140516)"
2019,Diciembre,Reino Unido de Gran Bretaña e Irlanda del Norte,826,4,3,7,"(12.586067,-81.702563)"
2014,Febrero,Barbados,52,3,7,10,"(4.697144,-74.140516)"
2022,Mayo,México,484,42,78,120,"(10.886611,-74.776708)"
2012,Febrero,Noruega,578,1,0,1,"(11.360009,-72.129330)"
2012,Marzo,República Dominicana,214,2,2,4,"(4.815061,-75.736532)"
2018,Agosto,Palestina,99999,3,1,4,"(4.697144,-74.140516)"
2012,Agosto,República Checa,203,1,2,3,"(3.541112,-76.384584)"
2021,Julio,República de Armenia,51,1,1,2,"(6.171601,-75.427454)"
2014,Mayo,Suecia,752,0,5,5,"(10.886611,-74.776708)"
2013,Marzo,República Dominicana,214,0,1,1,"(-4.197703,-69.941278)"
2014,Marzo,República de Corea,410,0,3,3,"(7.818934,-72.453226)"
2012,Mayo,Francia,250,1,6,7,"(8.635765,-77.346578)"
2020,Diciembre,Croacia,191,1,0,1,"(6.171601,-75.427454)"
2018,Septiembre,Kenia,404,2,0,2,"(3.541112,-76.384584)"
2018,Diciembre,Chile,152,144,141,285,"(3.541112,-76.384584)"
2015,Diciembre,Brasil,76,6,7,13,"(7.818934,-72.453226)"
2015,Enero,Italia,380,2,4,6,"(0.25129,-76.875963)"
2014,Julio,Jamaica,388,1,5,6,"(10.445761,-75.516429)"
2018,Julio,Brasil,76,2,4,6,"(3.866713,-67.927521)"
2022,Marzo,Uruguay,858,0,2,2,"(7.818934,-72.453226)"
2022,Diciembre,Suecia,752,289,434,723,"(4.697144,-74.140516)"
2016,Diciembre,China,156,3,0,3,"(-4.197703,-69.941278)"
2023,Marzo,Alemania,276,2357,3259,5617,"(4.697144,-74.140516)"
2022,Agosto,Taiwán,158,0,2,2,"(7.818934,-72.453226)"
2018,Junio,República Dominicana,214,3,3,6,"(7.128456,-73.183637)"
2012,Diciembre,Cuba,192,0,3,3,"(7.818934,-72.453226)"
2017,Diciembre,España,724,3311,5609,8920,"(4.697144,-74.140516)"
2017,Agosto,Dinamarca,208,83,134,217,"(4.697144,-74.140516)"
2012,Mayo,Canadá,124,0,4,4,"(7.128456,-73.183637)"
2017,Abril,Argentina,32,7,7,14,"(-4.223468,-69.945098)"
2022,Febrero,República de Corea,410,58,118,176,"(4.697144,-74.140516)"
2012,Abril,China,156,0,3,3,"(11.360009,-72.129330)"
2020,Enero,Islandia,352,0,1,1,"(0.814836,-77.662532)"
2015,Agosto,Guatemala,320,0,1,1,"(1.813928,-78.763924)"
2017,Diciembre,Mozambique,508,1,3,4,"(4.697144,-74.140516)"
2017,Enero,Chile,152,434,320,754,"(10.445761,-75.516429)"
2016,Octubre,República Dominicana,214,2,4,6,"(11.360009,-72.129330)"
2018,Septiembre,Bulgaria,100,0,1,1,"(3.541112,-76.384584)"
2013,Septiembre,Vietnam,704,6,20,26,"(4.697144,-74.140516)"
2015,Enero,Nueva Zelanda,554,1,0,1,"(11.360009,-72.129330)"
2019,Octubre,Grecia,300,3,10,13,"(10.445761,-75.516429)"
2017,Noviembre,Ecuador,218,69,122,191,"(6.171601,-75.427454)"
2022,Agosto,Australia,36,1,0,1,"(7.818934,-72.453226)"
2013,Julio,Cuba,192,17,31,48,"(6.171601,-75.427454)"
2017,Octubre,Bolivia,68,1,0,1,"(0.25129,-76.875963)"
2022,Noviembre,Países Bajos,528,0,2,2,"(4.452882,-75.766298)"
2012,Abril,San Cristóbal y Nevis,659,2,2,4,"(10.445761,-75.516429)"
2014,Julio,Australia,36,0,1,1,"(12.586067,-81.702563)"
2015,Febrero,Jamaica,388,8,15,23,"(10.886611,-74.776708)"
2018,Noviembre,Barbados,52,1,1,2,"(10.445761,-75.516429)"
2016,Junio,Chile,152,3941,5343,9284,"(4.697144,-74.140516)"
2012,Marzo,Dinamarca,208,1,4,5,"(3.541112,-76.384584)"
2013,Febrero,Bélgica,56,3,14,17,"(6.171601,-75.427454)"
2016,Febrero,Suecia,752,4,5,9,"(10.408582,-75.538003)"
2012,Septiembre,Australia,36,17,25,42,"(10.445761,-75.516429)"
2015,Enero,Estados Unidos de América,840,72,119,191,"(0.814836,-77.662532)"
2017,Abril,Federación de Rusia,643,0,5,5,"(10.971302,-74.765397)"
2021,Agosto,Cuba,192,1,2,3,"(7.128456,-73.183637)"
2012,Septiembre,Trinidad y Tobago,780,15,47,62,"(4.697144,-74.140516)"
2013,Octubre,Costa Rica,188,71,173,244,"(6.171601,-75.427454)"
2014,Enero,Australia,36,33,46,79,"(0.814836,-77.662532)"
2022,Noviembre,Letonia,428,1,0,1,"(-4.197703,-69.941278)"
2019,Abril,Países Bajos,528,1826,2346,4172,"(4.697144,-74.140516)"
2015,Marzo,Ecuador,218,1,4,5,"(7.128456,-73.183637)"
2023,Junio,Reino Unido de Gran Bretaña e Irlanda del Norte,826,3,3,6,"(-4.197703,-69.941278)"
2014,Enero,Nicaragua,558,4,3,7,"(3.541112,-76.384584)"
2020,Febrero,Suecia,752,34,47,81,"(10.445761,-75.516429)"
2012,Diciembre,Venezuela,862,3349,4331,7680,"(11.360009,-72.129330)"
2012,Febrero,Finlandia,246,3,0,3,"(10.408582,-75.538003)"
2019,Agosto,Canadá,124,1,6,7,"(-4.197703,-69.941278)"
2013,Septiembre,Portugal,620,0,1,1,"(10.408582,-75.538003)"
2022,Octubre,Chile,152,33,54,87,"(7.818934,-72.453226)"
2021,Abril,Australia,36,3,15,18,"(6.171601,-75.427454)"
2012,Junio,República de Irlanda,372,2,1,3,"(10.408582,-75.538003)"
2017,Diciembre,Brasil,76,1,3,4,"(4.815061,-75.736532)"
2022,Mayo,China,156,0,1,1,"(8.36068,-72.409396)"
2019,Junio,España,724,1,6,7,"(11.247723,-74.213989)"
2017,Marzo,Eslovenia,705,1,0,1,"(0.814836,-77.662532)"
2015,Diciembre,Brasil,76,931,702,1633,"(10.445761,-75.516429)"
2014,Abril,El Salvador,222,0,8,8,"(10.886611,-74.776708)"
2019,Octubre,Panamá,591,2,3,5,"(0.814836,-77.662532)"
2016,Septiembre,Taiwán,158,3,3,6,"(10.445761,-75.516429)"
2019,Noviembre,Ecuador,218,11,17,28,"(12.586067,-81.702563)"
2015,Octubre,Jamaica,388,5,8,13,"(6.171601,-75.427454)"
2019,Julio,Italia,380,19,20,39,"(11.360009,-72.129330)"
2014,Marzo,India,356,0,1,1,"(12.586067,-81.702563)"
2012,Diciembre,Lituania,440,1,0,1,"(3.541112,-76.384584)"
2013,Junio,Guatemala,320,19,79,98,"(3.541112,-76.384584)"
2013,Junio,Taiwán,158,3,5,8,"(3.541112,-76.384584)"
2019,Abril,Ghana,288,0,4,4,"(4.697144,-74.140516)"
2023,Mayo,Grecia,300,1,12,13,"(10.408582,-75.538003)"
2014,Junio,Sudáfrica,710,1,4,5,"(10.886611,-74.776708)"
2012,Noviembre,Mónaco,492,0,2,2,"(4.697144,-74.140516)"
2017,Julio,Letonia,428,0,1,1,"(11.247723,-74.213989)"
2018,Febrero,Bélgica,56,0,2,2,"(11.360009,-72.129330)"
2015,Septiembre,Canadá,124,9,13,22,"(10.408582,-75.538003)"
2016,Mayo,República Checa,203,1,4,5,"(0.814836,-77.662532)"
2016,Diciembre,Canadá,124,69,113,182,"(10.886611,-74.776708)"
2018,Septiembre,Italia,380,1,6,7,"(11.360009,-72.129330)"
2020,Febrero,Costa Rica,188,1340,1541,2882,"(4.697144,-74.140516)"
2019,Enero,Canadá,124,2,4,6,"(-4.223468,-69.945098)"
2020,Junio,Filipinas,608,0,8,8,"(3.893038,-77.067921)"
2022,Diciembre,Australia,36,6,11,17,"(8.635765,-77.346578)"
2020,Julio,Ucrania,804,1,0,1,"(4.697144,-74.140516)"
2015,Mayo,Bélgica,56,1,0,1,"(-4.223468,-69.945098)"
2019,Noviembre,Luxemburgo,442,1,1,2,"(6.171601,-75.427454)"
2019,Septiembre,Japón,392,0,1,1,"(11.360009,-72.129330)"
2013,Diciembre,Brasil,76,69,137,206,"(6.171601,-75.427454)"
2015,Octubre,Suiza,756,1,3,4,"(-4.223468,-69.945098)"
2022,Noviembre,Montenegro,499,3,5,8,"(4.697144,-74.140516)"
2012,Febrero,Taiwán,158,24,50,74,"(4.697144,-74.140516)"
2023,Febrero,Italia,380,2,2,4,"(-4.223468,-69.945098)"
2023,Febrero,Reino Unido de Gran Bretaña e Irlanda del Norte,826,3,6,9,"(0.25129,-76.875963)"
2017,Mayo,Australia,36,36,86,122,"(6.171601,-75.427454)"
2021,Septiembre,Singapur,702,0,1,1,"(10.445761,-75.516429)"
2022,Febrero,Uruguay,858,3,0,3,"(11.360009,-72.129330)"
2019,Abril,Uruguay,858,1,4,5,"(0.25129,-76.875963)"
2020,Noviembre,España,724,0,2,2,"(7.128456,-73.183637)"
2017,Mayo,Reino Unido de Gran Bretaña e Irlanda del Norte,826,0,1,1,"(9.402978,-75.681599)"
2018,Agosto,Ecuador,218,8,8,16,"(11.360009,-72.129330)"
2014,Noviembre,Costa Rica,188,11,9,20,"(12.586067,-81.702563)"
2022,Noviembre,Bahamas,44,2,5,7,"(10.445761,-75.516429)"
2019,Junio,Japón,392,1,0,1,"(11.117806,-74.232622)"
2014,Agosto,Palau,585,1,0,1,"(6.171601,-75.427454)"
2018,Julio,Venezuela,862,306,586,892,"(10.886611,-74.776708)"
2022,Abril,Trinidad y Tobago,780,14,21,35,"(10.445761,-75.516429)"
2013,Mayo,Malta,470,0,7,7,"(4.697144,-74.140516)"
2014,Abril,Japón,392,1,3,4,"(12.586067,-81.702563)"
2020,Noviembre,Suiza,756,1,8,9,"(3.541112,-76.384584)"
2019,Marzo,Estonia,233,2,3,5,"(6.171601,-75.427454)"
2013,Abril,India,356,0,11,11,"(3.541112,-76.384584)"
2023,Marzo,Liberia,430,0,1,1,"(6.171601,-75.427454)"
2018,Noviembre,Portugal,620,2,1,3,"(8.36068,-72.409396)"
2022,Octubre,Venezuela,862,2,14,16,"(11.247723,-74.213989)"
2016,Octubre,Ucrania,804,1,1,2,"(6.171601,-75.427454)"
2019,Marzo,Estonia,233,0,1,1,"(3.541112,-76.384584)"
2022,Septiembre,Islandia,352,0,1,1,"(3.541112,-76.384584)"
2016,Abril,El Salvador,222,673,870,1543,"(4.697144,-74.140516)"
2016,Julio,España,724,1,4,5,"(7.128456,-73.183637)"
2017,Junio,México,484,255,441,696,"(10.445761,-75.516429)"
2013,Mayo,India,356,5,17,22,"(3.541112,-76.384584)"
2013,Julio,Grecia,300,13,52,65,"(4.697144,-74.140516)"
2012,Julio,Reino Unido de Gran Bretaña e Irlanda del Norte,826,5,17,22,"(7.818934,-72.453226)"
2012,Marzo,República Dominicana,214,2,2,4,"(0.814836,-77.662532)"
2016,Septiembre,Portugal,620,1,0,1,"(0.25129,-76.875963)"
2019,Marzo,Australia,36,0,1,1,"(7.818934,-72.453226)"
2017,Octubre,Pakistán,586,12,16,28,"(4.697144,-74.140516)"
2016,Abril,Suecia,752,4,5,9,"(8.635765,-77.346578)"
2022,Febrero,Nueva Zelanda,554,2,2,4,"(10.445761,-75.516429)"
2014,Octubre,Federación de Rusia,643,0,1,1,"(8.066966,-76.735404)"
2014,Junio,Bolivia,68,1,0,1,"(7.128456,-73.183637)"
2020,Febrero,Portugal,620,1,6,7,"(11.360009,-72.129330)"
2023,Mayo,Islas Fiji,242,0,1,1,"(4.697144,-74.140516)"
2019,Julio,Alemania,276,2491,2880,5371,"(4.697144,-74.140516)"
2021,Junio,Canadá,124,2,5,7,"(7.128456,-73.183637)"
2022,Noviembre,República de Corea,410,0,2,2,"(11.247723,-74.213989)"
2012,Abril,Países Bajos,528,4,20,24,"(10.445761,-75.516429)"
2017,Junio,Polonia,616,4,9,13,"(10.445761,-75.516429)"
2015,Enero,Jamaica,388,1,1,2,"(0.814836,-77.662532)"
2015,Diciembre,Alemania,276,1,3,4,"(0.25129,-76.875963)"
2013,Agosto,Perú,604,5,9,14,"(7.128456,-73.183637)"
2019,Septiembre,Francia,250,14,96,110,"(10.408582,-75.538003)"
2017,Junio,Países Bajos,528,5,5,10,"(-4.223468,-69.945098)"
2014,Agosto,Chile,152,29,64,93,"(3.541112,-76.384584)"
2013,Enero,Filipinas,608,0,6,6,"(3.893038,-77.067921)"
2015,Agosto,Suiza,756,17,32,49,"(3.541112,-76.384584)"
2015,Mayo,India,356,0,1,1,"(7.818934,-72.453226)"
2018,Enero,Camerún,120,0,1,1,"(0.814836,-77.662532)"
2018,Mayo,Turquía,792,1,4,5,"(3.541112,-76.384584)"
2017,Febrero,Panamá,591,3,2,5,"(0.814836,-77.662532)"
2021,Octubre,Perú,604,2,5,7,"(7.916725,-72.462544)"
2022,Mayo,Ecuador,218,0,2,2,"(3.893038,-77.067921)"
2016,Febrero,Países Bajos,528,225,330,555,"(6.171601,-75.427454)"
2018,Marzo,Venezuela,862,883,896,1779,"(6.171601,-75.427454)"
2022,Marzo,Israel,376,0,3,3,"(4.815061,-75.736532)"
2015,Septiembre,Polonia,616,6,13,19,"(6.171601,-75.427454)"
2023,Enero,Uruguay,858,3,3,6,"(7.927209,-72.507910)"
2012,Marzo,Polonia,616,0,1,1,"(8.635765,-77.346578)"
2020,Febrero,India,356,0,3,3,"(4.815061,-75.736532)"
2017,Abril,República de Irlanda,372,4,6,10,"(3.541112,-76.384584)"
2017,Agosto,Jamaica,388,0,8,8,"(12.586067,-81.702563)"
2017,Junio,Malta,470,6,7,13,"(4.697144,-74.140516)"
2014,Mayo,Reino Unido de Gran Bretaña e Irlanda del Norte,826,11,14,25,"(8.635765,-77.346578)"
2022,Septiembre,Portugal,620,2,0,2,"(0.814836,-77.662532)"
2012,Febrero,Senegal,686,1,0,1,"(4.697144,-74.140516)"
2017,Agosto,Filipinas,608,0,66,66,"(10.971302,-74.765397)"
2020,Febrero,Guatemala,320,455,737,1192,"(4.697144,-74.140516)"
2019,Octubre,Venezuela,862,406,355,761,"(7.088729,-70.740253)"
2012,Octubre,Puerto Rico/Territorio de Estados Unidos,630,0,4,4,"(10.445761,-75.516429)"
2016,Noviembre,Costa Rica,188,1,0,1,"(0.814836,-77.662532)"
2017,Abril,Federación de Rusia,643,1,0,1,"(8.635765,-77.346578)"
2021,Octubre,México,484,20,45,65,"(10.886611,-74.776708)"
2015,Julio,República de Corea,410,4,1,5,"(11.360009,-72.129330)"
2015,Febrero,Nicaragua,558,0,1,1,"(10.886611,-74.776708)"
2017,Junio,Macedonia,807,0,4,4,"(4.697144,-74.140516)"
2019,Agosto,Islas Caimán/Territorio Británico de Ultramar,136,3,3,6,"(4.697144,-74.140516)"
2015,Enero,Indonesia,360,0,3,3,"(7.818934,-72.453226)"
2015,Febrero,Cuba,192,0,3,3,"(0.814836,-77.662532)"
2015,Mayo,Chile,152,4,4,8,"(8.635765,-77.346578)"
2015,Julio,Sudáfrica,710,3,3,6,"(3.541112,-76.384584)"
2023,Febrero,China,156,294,662,956,"(4.697144,-74.140516)"
2014,Junio,Bolivia,68,19,20,39,"(10.445761,-75.516429)"
2017,Julio,Venezuela,862,82,114,196,"(3.541112,-76.384584)"
2015,Diciembre,Israel,376,1,3,4,"(12.586067,-81.702563)"
2013,Junio,China,156,4,3,7,"(10.445761,-75.516429)"
2018,Noviembre,Ecuador,218,2,3,5,"(7.128456,-73.183637)"
2017,Junio,Reino Unido de Gran Bretaña e Irlanda del Norte,826,2,4,6,"(12.586067,-81.702563)"
2015,Febrero,Chile,152,124,140,264,"(6.171601,-75.427454)"
2022,Julio,Argelia,12,2,2,4,"(10.445761,-75.516429)"
2022,Julio,Grecia,300,1,0,1,"(0.814836,-77.662532)"
2017,Diciembre,Bélgica,56,35,52,87,"(10.445761,-75.516429)"
2015,Enero,Bolivia,68,30,34,64,"(6.171601,-75.427454)"
2014,Mayo,Panamá,591,560,825,1385,"(4.697144,-74.140516)"
2016,Julio,Alemania,276,0,1,1,"(13.3387613,-81.372937)"
2014,Septiembre,Arabia Saudita,682,2,2,4,"(10.445761,-75.516429)"
2012,Septiembre,España,724,27,64,91,"(10.445761,-75.516429)"
2014,Septiembre,Uzbekistán,860,1,0,1,"(4.697144,-74.140516)"
2015,Octubre,Italia,380,1,3,4,"(0.25129,-76.875963)"
2021,Febrero,Canadá,124,155,317,472,"(4.697144,-74.140516)"
2012,Agosto,Austria,40,123,218,341,"(4.697144,-74.140516)"
2013,Octubre,India,356,0,2,2,"(9.402978,-75.681599)"
2018,Marzo,Eslovenia,705,1,0,1,"(11.360009,-72.129330)"
2016,Mayo,Kenia,404,0,1,1,"(3.541112,-76.384584)"
2013,Agosto,Liechtenstein,438,1,0,1,"(3.541112,-76.384584)"
2016,Febrero,Australia,36,0,2,2,"(13.3387613,-81.372937)"
2021,Enero,Estados Unidos de América,840,127,179,306,"(4.815061,-75.736532)"
2017,Junio,India,356,0,14,14,"(10.886611,-74.776708)"
2019,Febrero,Taiwán,158,1,0,1,"(10.886611,-74.776708)"
2016,Marzo,Palestina,99999,0,1,1,"(4.697144,-74.140516)"
2012,Abril,Eslovaquia,703,1,1,2,"(11.360009,-72.129330)"
2018,Enero,Chile,152,4507,4909,9416,"(4.697144,-74.140516)"
2014,Octubre,Filipinas,608,13,96,109,"(4.697144,-74.140516)"
2018,Noviembre,Japón,392,0,1,1,"(12.586067,-81.702563)"
2023,Febrero,Austria,40,0,1,1,"(12.586067,-81.702563)"
2012,Noviembre,Bermudas/Territorio Británico de Ultramar,60,0,1,1,"(4.815061,-75.736532)"
2015,Julio,Taiwán,158,2,0,2,"(10.445761,-75.516429)"
2014,Agosto,Costa Rica,188,16,49,65,"(3.541112,-76.384584)"
2016,Marzo,Italia,380,1,1,2,"(4.452882,-75.766298)"
2019,Julio,Mauricio,480,1,1,2,"(10.408582,-75.538003)"
2019,Septiembre,Reino Unido de Gran Bretaña e Irlanda del Norte,826,18,22,40,"(10.408582,-75.538003)"
2019,Diciembre,Guatemala,320,191,158,349,"(10.445761,-75.516429)"
2015,Junio,Bahréin,48,0,3,3,"(10.445761,-75.516429)"
2016,Mayo,República Dominicana,214,0,1,1,"(12.5744111,-81.703935)"
2017,Junio,Santa Lucia,662,0,1,1,"(11.360009,-72.129330)"
2013,Septiembre,Isla de Man,833,1,0,1,"(7.128456,-73.183637)"
2021,Septiembre,Gambia,270,0,1,1,"(10.445761,-75.516429)"
2018,Septiembre,Serbia,688,0,1,1,"(10.886611,-74.776708)"
2015,Septiembre,República de Corea,410,1,2,3,"(7.128456,-73.183637)"
2022,Febrero,Israel,376,1,1,2,"(10.408582,-75.538003)"
2019,Junio,Tailandia,764,14,10,24,"(4.697144,-74.140516)"
2023,Enero,Bahamas,44,17,6,23,"(3.541112,-76.384584)"
2021,Diciembre,Palestina,99999,0,1,1,"(6.171601,-75.427454)"
2022,Febrero,Venezuela,862,0,2,2,"(12.165168,-71.983761)"
2012,Julio,Estados Unidos de América,840,34,58,92,"(7.128456,-73.183637)"
2023,Febrero,Francia,250,1,4,5,"(13.3387613,-81.372937)"
2012,Mayo,Francia,250,23,46,69,"(3.541112,-76.384584)"
2014,Julio,Suiza,756,35,26,61,"(0.814836,-77.662532)"
2021,Diciembre,Santa Sede/Ciudad del Vaticano,336,0,3,3,"(4.697144,-74.140516)"
2021,Febrero,Federación de Rusia,643,4,13,17,"(10.445761,-75.516429)"
2021,Enero,República Dominicana,214,5,17,22,"(10.886611,-74.776708)"
2017,Junio,Honduras,340,1,1,2,"(0.814836,-77.662532)"
2022,Marzo,Venezuela,862,0,2,2,"(12.165168,-71.983761)"
2015,Noviembre,Dominica,212,1,1,2,"(6.171601,-75.427454)"
2019,Octubre,China,156,0,1,1,"(-4.197703,-69.941278)"
2016,Junio,Indonesia,360,1,0,1,"(6.171601,-75.427454)"
2023,Marzo,Cabo Verde,132,0,3,3,"(12.5744111,-81.703935)"
2015,Julio,Costa Rica,188,1,1,2,"(10.408582,-75.538003)"
2017,Diciembre,Cuba,192,12,19,31,"(10.445761,-75.516429)"
2015,Febrero,Lituania,440,1,0,1,"(3.541112,-76.384584)"
2021,Abril,Bolivia,68,13,10,23,"(3.541112,-76.384584)"
2019,Julio,Antigua y Barbuda,28,3,0,3,"(3.541112,-76.384584)"
2016,Diciembre,Australia,36,18,39,57,"(3.541112,-76.384584)"
2022,Julio,Canadá,124,287,618,905,"(6.171601,-75.427454)"
2016,Julio,Federación de Rusia,643,6,11,17,"(10.445761,-75.516429)"
2019,Mayo,Costa Rica,188,4,2,6,"(0.814836,-77.662532)"
2013,Abril,Filipinas,608,0,13,13,"(3.893038,-77.067921)"
2020,Agosto,Países Bajos,528,28,76,104,"(4.697144,-74.140516)"
2012,Marzo,Uruguay,858,0,6,6,"(0.814836,-77.662532)"
2016,Mayo,Egipto,818,1,3,4,"(6.171601,-75.427454)"
2020,Diciembre,Honduras,340,0,1,1,"(12.5744111,-81.703935)"
2022,Noviembre,Tailandia,764,4,1,5,"(6.171601,-75.427454)"
2021,Junio,Granada,308,1,0,1,"(10.445761,-75.516429)"
2015,Diciembre,México,484,7,5,12,"(7.927209,-72.507910)"
2018,Mayo,Madagascar,450,1,0,1,"(4.697144,-74.140516)"
2014,Agosto,Chile,152,0,4,4,"(7.927209,-72.507910)"
2013,Noviembre,Tanzania,834,0,1,1,"(4.697144,-74.140516)"
2018,Octubre,Dinamarca,208,15,32,47,"(10.445761,-75.516429)"
2015,Julio,Portugal,620,0,1,1,"(10.408582,-75.538003)"
2022,Enero,Reino Unido de Gran Bretaña e Irlanda del Norte,826,0,1,1,"(7.088729,-70.740253)"
2013,Diciembre,Bosnia y Herzegovina,70,0,1,1,"(4.697144,-74.140516)"
2019,Abril,Grecia,300,4,5,9,"(3.541112,-76.384584)"
2019,Diciembre,Perú,604,3485,4345,7830,"(4.697144,-74.140516)"
2019,Enero,Argentina,32,3,3,6,"(7.128456,-73.183637)"
2021,Julio,Kazajistán,398,1,1,2,"(6.171601,-75.427454)"
2012,Agosto,Australia,36,22,30,52,"(10.408582,-75.538003)"
2012,Junio,Alemania,276,2,6,8,"(3.893038,-77.067921)"
2018,Marzo,Indonesia,360,1,4,5,"(10.408582,-75.538003)"
2018,Diciembre,El Salvador,222,86,106,192,"(3.541112,-76.384584)"
2023,Junio,Filipinas,608,8,9,17,"(6.171601,-75.427454)"
2023,Mayo,Reino Unido de Gran Bretaña e Irlanda del Norte,826,1,0,1,"(4.452882,-75.766298)"
2014,Mayo,Uruguay,858,5,1,6,"(0.814836,-77.662532)"
2022,Agosto,Turquía,792,0,5,5,"(10.408582,-75.538003)"
2021,Mayo,República Democrática del Congo,180,2,1,3,"(4.697144,-74.140516)"
2020,Diciembre,Nigeria,566,0,2,2,"(4.697144,-74.140516)"
2023,Mayo,Alemania,276,3,5,8,"(11.247723,-74.213989)"
2016,Octubre,Brasil,76,1,8,9,"(4.815061,-75.736532)"
2019,Noviembre,China,156,4,2,6,"(7.818934,-72.453226)"
2020,Noviembre,Italia,380,6,8,14,"(10.886611,-74.776708)"
2019,Enero,Chile,152,218,218,436,"(3.541112,-76.384584)"
2021,Agosto,Australia,36,54,106,160,"(4.697144,-74.140516)"
2019,Enero,Suiza,756,1,0,1,"(7.818934,-72.453226)"
2015,Febrero,Suiza,756,0,2,2,"(11.247723,-74.213989)"
2018,Febrero,Países Bajos,528,2,5,7,"(0.25129,-76.875963)"
2022,Enero,China,156,0,1,1,"(4.815061,-75.736532)"
2017,Agosto,Myanmar,104,0,1,1,"(10.445761,-75.516429)"
2017,Noviembre,República de Corea,410,0,1,1,"(11.360009,-72.129330)"
2015,Agosto,Venezuela,862,1,4,5,"(8.635765,-77.346578)"
2022,Diciembre,India,356,0,16,16,"(10.971302,-74.765397)"
2022,Enero,India,356,0,12,12,"(10.886611,-74.776708)"
2019,Junio,Nueva Zelanda,554,1,2,3,"(-4.223468,-69.945098)"
2012,Julio,Nueva Zelanda,554,0,1,1,"(8.635765,-77.346578)"
2016,Noviembre,Eslovaquia,703,25,44,69,"(4.697144,-74.140516)"
2014,Febrero,Georgia,268,2,2,4,"(4.697144,-74.140516)"
2022,Junio,Eslovaquia,703,5,11,16,"(6.171601,-75.427454)"
2015,Marzo,Nigeria,566,1,1,2,"(10.445761,-75.516429)"
2016,Julio,Jamaica,388,2,2,4,"(10.886611,-74.776708)"
2015,Noviembre,Sri Lanka,144,1,0,1,"(3.541112,-76.384584)"
2015,Febrero,Noruega,578,1,0,1,"(4.815061,-75.736532)"
2021,Noviembre,Taiwán,158,1,0,1,"(7.128456,-73.183637)"
2023,Abril,Finlandia,246,2,0,2,"(3.541112,-76.384584)"
2013,Abril,India,356,4,26,30,"(6.171601,-75.427454)"
2018,Junio,Guatemala,320,1,2,3,"(7.818934,-72.453226)"
2016,Diciembre,Argentina,32,74,92,166,"(3.541112,-76.384584)"
2012,Febrero,Uruguay,858,3,8,11,"(0.814836,-77.662532)"
2023,Junio,Noruega,578,1,0,1,"(4.815061,-75.736532)"
2022,Febrero,Federación de Rusia,643,8,11,19,"(10.445761,-75.516429)"
2021,Febrero,Jordania,400,1,1,2,"(4.697144,-74.140516)"
2015,Diciembre,Uruguay,858,0,1,1,"(7.128456,-73.183637)"
2021,Febrero,Argelia,12,1,1,2,"(4.697144,-74.140516)"
2020,Enero,Portugal,620,0,1,1,"(7.128456,-73.183637)"
2015,Julio,Jamaica,388,4,13,17,"(6.171601,-75.427454)"
2022,Mayo,Barbados,52,5,6,11,"(4.697144,-74.140516)"
2016,Julio,Cuba,192,26,51,77,"(3.541112,-76.384584)"
2015,Junio,Honduras,340,15,23,38,"(3.541112,-76.384584)"
2022,Agosto,Federación de Rusia,643,1,0,1,"(4.452882,-75.766298)"
2022,Abril,Nueva Zelanda,554,5,4,9,"(10.445761,-75.516429)"
2013,Marzo,Arabia Saudita,682,0,10,10,"(4.697144,-74.140516)"
2013,Noviembre,Alemania,276,12,44,56,"(10.445761,-75.516429)"
2019,Octubre,Australia,36,329,563,892,"(4.697144,-74.140516)"
2023,Febrero,Argentina,32,1,0,1,"(8.635765,-77.346578)"
2019,Octubre,Argentina,32,1,0,1,"(1.813928,-78.763924)"
2013,Agosto,Suecia,752,9,13,22,"(6.171601,-75.427454)"
2023,Enero,Costa Rica,188,0,1,1,"(10.408582,-75.538003)"
2017,Enero,Dominica,212,0,1,1,"(10.886611,-74.776708)"
2012,Octubre,Estados Unidos de América,840,7,15,22,"(11.360009,-72.129330)"
2016,Noviembre,Australia,36,9,14,23,"(3.541112,-76.384584)"
2014,Diciembre,Países Bajos,528,2,5,7,"(7.818934,-72.453226)"
2023,Mayo,Venezuela,862,1187,959,2146,"(7.916725,-72.462544)"
2012,Febrero,Granada,308,0,2,2,"(4.697144,-74.140516)"
2012,Julio,Alemania,276,0,3,3,"(4.815061,-75.736532)"
2022,Julio,Alemania,276,4,4,8,"(7.818934,-72.453226)"
2018,Mayo,Canadá,124,2,5,7,"(7.128456,-73.183637)"
2019,Febrero,Panamá,591,4,18,22,"(10.408582,-75.538003)"
2021,Abril,Estados Unidos de América,840,3,2,5,"(10.408582,-75.538003)"
2020,Diciembre,Kuwait,414,0,1,1,"(4.697144,-74.140516)"
2016,Julio,Trinidad y Tobago,780,42,35,77,"(4.697144,-74.140516)"
2015,Julio,Panamá,591,4,1,5,"(8.635765,-77.346578)"
2020,Enero,Países Bajos,528,205,332,537,"(6.171601,-75.427454)"
2018,Febrero,Namibia,516,0,1,1,"(0.814836,-77.662532)"
2013,Julio,China,156,1,1,2,"(11.360009,-72.129330)"
2019,Diciembre,Guatemala,320,24,29,53,"(3.541112,-76.384584)"
2019,Enero,República Del Congo,178,0,1,1,"(4.697144,-74.140516)"
2015,Diciembre,República Dominicana,214,0,1,1,"(11.360009,-72.129330)"
2019,Noviembre,Vietnam,704,13,20,33,"(4.697144,-74.140516)"
2014,Mayo,Portugal,620,0,2,2,"(10.886611,-74.776708)"
2021,Marzo,India,356,0,16,16,"(10.886611,-74.776708)"
2019,Noviembre,Reino Unido de Gran Bretaña e Irlanda del Norte,826,4,13,17,"(10.886611,-74.776708)"
2022,Septiembre,Albania,8,0,2,2,"(10.445761,-75.516429)"
2014,Febrero,Ecuador,218,0,2,2,"(4.452882,-75.766298)"
2016,Julio,Argentina,32,28,37,65,"(10.886611,-74.776708)"
2018,Julio,Nueva Zelanda,554,8,10,18,"(0.814836,-77.662532)"
2013,Septiembre,Finlandia,246,0,1,1,"(3.541112,-76.384584)"
2016,Octubre,Letonia,428,1,1,2,"(10.445761,-75.516429)"
2022,Diciembre,México,484,0,3,3,"(8.635765,-77.346578)"
2012,Diciembre,Kenia,404,0,1,1,"(11.360009,-72.129330)"
2012,Mayo,Brasil,76,50,36,86,"(-4.197703,-69.941278)"
2021,Mayo,Trinidad y Tobago,780,3,3,6,"(10.445761,-75.516429)"
2022,Noviembre,Panamá,591,2,10,12,"(10.408582,-75.538003)"
2014,Junio,Cabo Verde,132,1,1,2,"(4.697144,-74.140516)"
2012,Mayo,Bahamas,44,0,3,3,"(6.171601,-75.427454)"
2017,Diciembre,Perú,604,155,257,412,"(7.818934,-72.453226)"
2014,Noviembre,Italia,380,1,12,13,"(10.886611,-74.776708)"
2016,Mayo,Chile,152,44,72,116,"(3.541112,-76.384584)"
2016,Enero,Jamaica,388,3,2,5,"(3.541112,-76.384584)"
2015,Abril,Haití,332,0,1,1,"(10.445761,-75.516429)"
2018,Agosto,Polonia,616,0,1,1,"(11.360009,-72.129330)"
2012,Marzo,Perú,604,19,31,50,"(-4.197703,-69.941278)"
2015,Abril,Dinamarca,208,0,8,8,"(3.541112,-76.384584)"
2013,Abril,Singapur,702,5,11,16,"(4.697144,-74.140516)"
2017,Febrero,Alemania,276,3,3,6,"(7.818934,-72.453226)"
2019,Octubre,Alemania,276,1,0,1,"(11.247723,-74.213989)"
2022,Febrero,Nicaragua,558,0,1,1,"(12.586067,-81.702563)"
2015,Diciembre,Costa Rica,188,25,17,42,"(4.815061,-75.736532)"
2023,Mayo,Polonia,616,0,4,4,"(10.971302,-74.765397)"
2020,Enero,Rumania,642,0,1,1,"(9.402978,-75.681599)"
2014,Abril,Estonia,233,1,0,1,"(12.586067,-81.702563)"
2023,Marzo,Japón,392,10,11,21,"(10.445761,-75.516429)"
2015,Noviembre,Chile,152,0,3,3,"(0.25129,-76.875963)"
2019,Enero,Rumania,642,15,9,24,"(6.171601,-75.427454)"
2019,Enero,Namibia,516,0,2,2,"(4.697144,-74.140516)"
2018,Noviembre,Albania,8,0,2,2,"(6.171601,-75.427454)"
2018,Diciembre,Alemania,276,0,1,1,"(4.452882,-75.766298)"
2014,Mayo,México,484,3,2,5,"(-4.197703,-69.941278)"
2014,Agosto,Guatemala,320,1,3,4,"(7.128456,-73.183637)"
2017,Febrero,Brasil,76,166,197,363,"(3.541112,-76.384584)"
2021,Septiembre,Ucrania,804,1,1,2,"(0.814836,-77.662532)"
2020,Noviembre,Nueva Zelanda,554,0,1,1,"(10.886611,-74.776708)"
2012,Julio,México,484,68,157,225,"(3.541112,-76.384584)"
2019,Febrero,China,156,1,1,2,"(8.36068,-72.409396)"
2017,Septiembre,Alemania,276,2,4,6,"(0.25129,-76.875963)"
2013,Mayo,Perú,604,8,26,34,"(11.360009,-72.129330)"
2022,Diciembre,Estados Unidos de América,840,8574,17285,25862,"(6.171601,-75.427454)"
2019,Mayo,Chad,148,1,0,1,"(4.697144,-74.140516)"
2012,Mayo,Taiwán,158,1,0,1,"(3.541112,-76.384584)"
2022,Diciembre,China,156,1,4,5,"(0.814836,-77.662532)"
2015,Mayo,Ecuador,218,2342,3594,5936,"(4.697144,-74.140516)"
2014,Abril,Desconocido,99999,45,78,123,"(4.697144,-74.140516)"
2012,Diciembre,Honduras,340,9,11,20,"(10.445761,-75.516429)"
2016,Diciembre,Rumania,642,65,77,142,"(4.697144,-74.140516)"
2019,Enero,Panamá,591,363,276,639,"(3.541112,-76.384584)"
2015,Julio,Brasil,76,1,7,8,"(7.128456,-73.183637)"
2012,Enero,Albania,8,1,2,3,"(4.697144,-74.140516)"
2022,Agosto,Italia,380,14,21,35,"(0.814836,-77.662532)"
2013,Diciembre,Desconocido,99999,1,5,6,"(6.171601,-75.427454)"
2017,Junio,Irán,364,1,1,2,"(6.171601,-75.427454)"
2017,Septiembre,China,156,310,818,1128,"(4.697144,-74.140516)"
2017,Julio,Emiratos Árabes,784,8,14,22,"(4.697144,-74.140516)"
2017,Octubre,Israel,376,4,14,18,"(0.814836,-77.662532)"
2018,Agosto,Madagascar,450,1,0,1,"(4.697144,-74.140516)"
2018,Octubre,Malasia,458,0,1,1,"(10.408582,-75.538003)"
2019,Abril,Suiza,756,5,3,8,"(0.25129,-76.875963)"
2017,Diciembre,Filipinas,608,0,3,3,"(9.402978,-75.681599)"
2018,Agosto,Nicaragua,558,3,4,7,"(4.815061,-75.736532)"
2022,Julio,México,484,0,1,1,"(0.25129,-76.875963)"
2017,Agosto,Australia,36,331,544,875,"(4.697144,-74.140516)"
2015,Abril,Ecuador,218,26,21,47,"(10.445761,-75.516429)"
2016,Agosto,Rumania,642,0,1,1,"(10.886611,-74.776708)"
2015,Noviembre,Polonia,616,0,1,1,"(9.402978,-75.681599)"
2014,Agosto,Países Bajos,528,0,1,1,"(7.927209,-72.507910)"
2018,Mayo,Paraguay,600,12,16,28,"(10.886611,-74.776708)"
2014,Julio,El Salvador,222,27,41,68,"(6.171601,-75.427454)"
2013,Octubre,Islas Turcas y Caicos/Territorio Británico de Ultramar,796,0,1,1,"(10.445761,-75.516429)"
2022,Noviembre,Venezuela,862,43,29,72,"(6.18189,-67.47535)"
2017,Septiembre,Eslovenia,705,1,0,1,"(11.360009,-72.129330)"
2015,Noviembre,Islandia,352,2,7,9,"(4.697144,-74.140516)"
2014,Octubre,Japón,392,1,5,6,"(7.818934,-72.453226)"
2018,Julio,República Democrática del Congo,180,8,6,14,"(4.697144,-74.140516)"
2020,Noviembre,Hong Kong,344,2,0,2,"(4.697144,-74.140516)"
2019,Febrero,Alemania,276,0,1,1,"(7.927209,-72.507910)"
2022,Octubre,Emiratos Árabes,784,0,1,1,"(3.541112,-76.384584)"
2014,Junio,Países Bajos,528,10,6,16,"(10.408582,-75.538003)"
2014,Mayo,Azerbaiyán,31,0,3,3,"(4.697144,-74.140516)"
2016,Marzo,Indonesia,360,0,2,2,"(10.445761,-75.516429)"
2013,Junio,Italia,380,1,1,2,"(-4.197703,-69.941278)"
2023,Febrero,Sudáfrica,710,2,0,2,"(6.171601,-75.427454)"
2012,Abril,República de Corea,410,160,387,547,"(4.697144,-74.140516)"
2022,Enero,Lituania,440,1,0,1,"(-0.193180,-74.784874)"
2021,Noviembre,Francia,250,0,1,1,"(7.916725,-72.462544)"
2016,Abril,Uruguay,858,1,2,3,"(4.452882,-75.766298)"
2017,Noviembre,Polonia,616,4,13,17,"(10.408582,-75.538003)"
2013,Enero,España,724,0,1,1,"(7.088729,-70.740253)"
2018,Marzo,Noruega,578,158,172,330,"(4.697144,-74.140516)"
2019,Julio,España,724,3,2,5,"(7.128456,-73.183637)"
2015,Marzo,Bélgica,56,6,17,23,"(10.445761,-75.516429)"
2013,Enero,Isla de Man,833,0,1,1,"(4.815061,-75.736532)"
2020,Febrero,Sudáfrica,710,0,5,5,"(10.408582,-75.538003)"
2018,Noviembre,Argentina,32,100,108,208,"(3.541112,-76.384584)"
2013,Agosto,Taiwán,158,0,1,1,"(7.128456,-73.183637)"
2013,Marzo,Nicaragua,558,1,1,2,"(12.586067,-81.702563)"
2016,Mayo,Jamaica,388,2,2,4,"(6.171601,-75.427454)"
2021,Noviembre,Japón,392,0,1,1,"(0.814836,-77.662532)"
2015,Octubre,Uruguay,858,0,2,2,"(-4.197703,-69.941278)"
2019,Marzo,Albania,8,0,1,1,"(3.541112,-76.384584)"
2012,Agosto,Argentina,32,652,577,1229,"(10.445761,-75.516429)"
2019,Diciembre,Australia,36,2,1,3,"(7.128456,-73.183637)"
2016,Septiembre,Reino Unido de Gran Bretaña e Irlanda del Norte,826,1,2,3,"(11.247723,-74.213989)"
2012,Mayo,Paraguay,600,5,7,12,"(10.445761,-75.516429)"
2018,Diciembre,Zambia,894,0,1,1,"(4.697144,-74.140516)"
2023,Mayo,Perú,604,1,0,1,"(6.18189,-67.47535)"
2023,Mayo,Australia,36,233,480,713,"(4.697144,-74.140516)"
2013,Junio,Países Bajos,528,3,6,9,"(0.814836,-77.662532)"
2013,Septiembre,Países Bajos,528,0,3,3,"(10.886611,-74.776708)"
2012,Julio,República Dominicana,214,0,1,1,"(7.818934,-72.453226)"
2013,Julio,Venezuela,862,69,115,184,"(0.814836,-77.662532)"
2012,Abril,Venezuela,862,7,20,27,"(10.408582,-75.538003)"
2012,Abril,Singapur,702,0,2,2,"(6.171601,-75.427454)"
2015,Agosto,Singapur,702,1,2,3,"(6.171601,-75.427454)"
2021,Noviembre,Japón,392,1,0,1,"(7.818934,-72.453226)"
2019,Noviembre,Israel,376,0,1,1,"(0.25129,-76.875963)"
2013,Agosto,Brasil,76,7,25,32,"(0.814836,-77.662532)"
2022,Noviembre,Australia,36,19,26,45,"(3.541112,-76.384584)"
2013,Abril,Gambia,270,1,0,1,"(4.697144,-74.140516)"
2012,Diciembre,Guatemala,320,1,0,1,"(7.128456,-73.183637)"
2022,Noviembre,Austria,40,3,1,4,"(-4.223468,-69.945098)"
2014,Enero,Bélgica,56,1,5,6,"(-4.197703,-69.941278)"
2016,Noviembre,Reino Unido de Gran Bretaña e Irlanda del Norte,826,0,4,4,"(4.815061,-75.736532)"
2012,Abril,Austria,40,4,3,7,"(10.445761,-75.516429)"
2019,Noviembre,Bélgica,56,1,3,4,"(8.635765,-77.346578)"
2017,Junio,Nepal,524,3,1,4,"(4.697144,-74.140516)"
2018,Enero,República de Kosovo,901,0,1,1,"(4.697144,-74.140516)"
2012,Abril,Canadá,124,29,19,48,"(0.814836,-77.662532)"
2018,Diciembre,Estados Unidos de América,840,12,9,21,"(8.635765,-77.346578)"
2017,Julio,Ecuador,218,0,2,2,"(10.971302,-74.765397)"
2014,Noviembre,Venezuela,862,92,186,278,"(10.445761,-75.516429)"
2022,Febrero,Ghana,288,0,1,1,"(10.445761,-75.516429)"
2017,Junio,República Dominicana,214,2,6,8,"(11.360009,-72.129330)"
2013,Agosto,Territorio Antártico Británico/Territorio Británico de Ultramar,260,0,1,1,"(6.171601,-75.427454)"
2016,Septiembre,Noruega,578,2,0,2,"(0.814836,-77.662532)"
2017,Mayo,Paraguay,600,239,197,436,"(4.697144,-74.140516)"
2018,Septiembre,México,484,4,4,8,"(4.452882,-75.766298)"
2022,Febrero,Costa Rica,188,8,22,30,"(10.886611,-74.776708)"
2022,Febrero,República Árabe Siria,760,1,2,3,"(4.697144,-74.140516)"
2012,Junio,India,356,0,3,3,"(4.815061,-75.736532)"
2022,Noviembre,Nicaragua,558,91,113,204,"(4.697144,-74.140516)"
2018,Septiembre,Turquía,792,0,2,2,"(0.814836,-77.662532)"
2016,Julio,Kazajistán,398,1,0,1,"(10.445761,-75.516429)"
2014,Noviembre,Filipinas,608,4,2,6,"(6.171601,-75.427454)"
2019,Octubre,Arabia Saudita,682,0,1,1,"(3.541112,-76.384584)"
2012,Julio,Arabia Saudita,682,0,1,1,"(10.445761,-75.516429)"
2022,Julio,Venezuela,862,13,24,37,"(4.452882,-75.766298)"
2015,Junio,Grecia,300,0,3,3,"(6.171601,-75.427454)"
2019,Mayo,Honduras,340,42,34,76,"(3.541112,-76.384584)"
2019,Julio,Irán,364,0,1,1,"(10.445761,-75.516429)"
2014,Agosto,Trinidad y Tobago,780,0,1,1,"(7.818934,-72.453226)"
2022,Agosto,Brasil,76,6,15,21,"(7.818934,-72.453226)"
2013,Abril,India,356,2,9,11,"(10.445761,-75.516429)"
2023,Marzo,Costa Rica,188,3,3,6,"(4.452882,-75.766298)"
2019,Diciembre,Camerún,120,1,0,1,"(6.171601,-75.427454)"
2023,Enero,Bélgica,56,1,2,3,"(10.886611,-74.776708)"
2014,Septiembre,Italia,380,0,1,1,"(4.452882,-75.766298)"
2015,Junio,Federación de Rusia,643,1,0,1,"(12.586067,-81.702563)"
2019,Febrero,Letonia,428,1,0,1,"(0.814836,-77.662532)"
2016,Octubre,Islas Salomón,90,1,0,1,"(4.697144,-74.140516)"
2021,Septiembre,Rumania,642,0,2,2,"(10.408582,-75.538003)"
2012,Mayo,Territorio Antártico Británico/Territorio Británico de Ultramar,260,0,1,1,"(7.818934,-72.453226)"
2014,Junio,Taiwán,158,4,1,5,"(10.445761,-75.516429)"
2015,Octubre,Alemania,276,0,3,3,"(7.128456,-73.183637)"
2013,Febrero,Venezuela,862,6,5,11,"(10.408582,-75.538003)"
2016,Junio,República Checa,203,0,4,4,"(3.541112,-76.384584)"
2018,Octubre,Estados Unidos de América,840,115,176,291,"(4.815061,-75.736532)"
2018,Mayo,Israel,376,1,2,3,"(10.408582,-75.538003)"
2014,Octubre,Líbano,422,1,1,2,"(3.541112,-76.384584)"
2017,Febrero,Brasil,76,611,504,1115,"(12.586067,-81.702563)"
2020,Enero,Dinamarca,208,1,2,3,"(10.886611,-74.776708)"
2013,Octubre,Chile,152,43,60,103,"(0.814836,-77.662532)"
2022,Noviembre,Indonesia,360,3,5,8,"(6.171601,-75.427454)"
2021,Julio,Panamá,591,0,2,2,"(10.971302,-74.765397)"
2014,Abril,Eritrea,232,0,1,1,"(3.541112,-76.384584)"
2016,Marzo,Japón,392,0,1,1,"(11.360009,-72.129330)"
2014,Abril,México,484,8,12,20,"(7.128456,-73.183637)"
2012,Junio,República Dominicana,214,1,2,3,"(7.818934,-72.453226)"
2019,Abril,Líbano,422,18,30,48,"(4.697144,-74.140516)"
2017,Abril,Portugal,620,262,470,732,"(4.697144,-74.140516)"
2023,Junio,México,484,25,13,38,"(11.117806,-74.232622)"
2012,Marzo,España,724,10,8,18,"(10.408582,-75.538003)"
2017,Enero,Argentina,32,1,0,1,"(9.402978,-75.681599)"
2012,Abril,El Salvador,222,0,1,1,"(0.814836,-77.662532)"
2021,Febrero,Estados Unidos de América,840,1,0,1,"(10.408582,-75.538003)"
2022,Marzo,Estonia,233,2,1,3,"(10.445761,-75.516429)"
2021,Octubre,Bahamas,44,1,0,1,"(10.886611,-74.776708)"
2017,Junio,Austria,40,1,4,5,"(10.408582,-75.538003)"
2021,Octubre,Polonia,616,2,1,3,"(10.886611,-74.776708)"
2016,Abril,Perú,604,186,256,442,"(3.541112,-76.384584)"
2017,Junio,Croacia,191,0,1,1,"(10.886611,-74.776708)"
2023,Junio,Macedonia,807,0,3,3,"(6.171601,-75.427454)"
2022,Agosto,Filipinas,608,11,12,23,"(6.171601,-75.427454)"
2015,Julio,Alemania,276,0,2,2,"(7.927209,-72.507910)"
2016,Octubre,Jamaica,388,0,1,1,"(12.586067,-81.702563)"
2022,Julio,Federación de Rusia,643,1,0,1,"(-4.197703,-69.941278)"
2020,Febrero,Brasil,76,19,28,47,"(10.886611,-74.776708)"
2016,Mayo,Bahréin,48,0,1,1,"(4.697144,-74.140516)"
2015,Enero,Estados Unidos de América,840,10,19,29,"(11.360009,-72.129330)"
2018,Julio,Antigua y Barbuda,28,2,5,7,"(4.697144,-74.140516)"
2012,Octubre,Canadá,124,25,92,117,"(10.445761,-75.516429)"
2020,Agosto,Letonia,428,0,1,1,"(10.886611,-74.776708)"
2018,Julio,Nueva Zelanda,554,0,1,1,"(7.128456,-73.183637)"
2018,Febrero,República Dominicana,214,36,121,157,"(10.445761,-75.516429)"
2016,Julio,Perú,604,0,1,1,"(7.088729,-70.740253)"
2019,Agosto,Taiwán,158,1,1,2,"(10.886611,-74.776708)"
2015,Febrero,Ecuador,218,0,1,1,"(0.812436,-77.847006)"
2019,Enero,Jamaica,388,0,1,1,"(0.814836,-77.662532)"
2015,Abril,Marruecos,504,0,1,1,"(0.814836,-77.662532)"
2022,Octubre,Canadá,124,1,0,1,"(11.360009,-72.129330)"
2017,Abril,Nueva Zelanda,554,51,90,141,"(4.697144,-74.140516)"
2021,Diciembre,Bolivia,68,0,1,1,"(7.927209,-72.507910)"
2015,Marzo,Argentina,32,1,6,7,"(-4.197703,-69.941278)"
2019,Abril,España,724,4,4,8,"(0.25129,-76.875963)"
2022,Junio,Dinamarca,208,0,2,2,"(10.886611,-74.776708)"
2021,Agosto,Argentina,32,1,3,4,"(7.128456,-73.183637)"
2014,Abril,Perú,604,136,121,257,"(10.445761,-75.516429)"
2022,Junio,Estonia,233,1,0,1,"(10.445761,-75.516429)"
2015,Febrero,Sudáfrica,710,0,1,1,"(7.818934,-72.453226)"
2018,Enero,Dominica,212,7,4,11,"(4.697144,-74.140516)"
2015,Septiembre,Guatemala,320,5,9,14,"(10.886611,-74.776708)"
2018,Septiembre,Guatemala,320,1,3,4,"(7.128456,-73.183637)"
2020,Febrero,Israel,376,1,1,2,"(-4.197703,-69.941278)"
2021,Mayo,Rumania,642,30,29,59,"(4.697144,-74.140516)"
2022,Diciembre,Alemania,276,2,5,7,"(4.452882,-75.766298)"
2019,Agosto,República de Corea,410,0,6,6,"(10.886611,-74.776708)"
2014,Mayo,España,724,0,5,5,"(7.128456,-73.183637)"
2020,Enero,México,484,9,18,27,"(10.408582,-75.538003)"
2012,Agosto,Islas Fiji,242,1,0,1,"(4.697144,-74.140516)"
2019,Noviembre,Bermudas/Territorio Británico de Ultramar,60,0,1,1,"(3.541112,-76.384584)"
2022,Diciembre,Perú,604,0,1,1,"(10.971302,-74.765397)"
2018,Febrero,Macedonia,807,0,1,1,"(10.408582,-75.538003)"
2016,Agosto,Italia,380,10,26,36,"(10.886611,-74.776708)"
2023,Mayo,Honduras,340,0,8,8,"(12.5744111,-81.703935)"
2016,Marzo,Serbia,688,1,4,5,"(6.171601,-75.427454)"
2017,Junio,Francia,250,0,1,1,"(-0.193180,-74.784874)"
2019,Agosto,Sudáfrica,710,1,1,2,"(10.886611,-74.776708)"
2016,Mayo,Alemania,276,6,3,9,"(7.818934,-72.453226)"
2019,Agosto,Ecuador,218,0,5,5,"(12.586067,-81.702563)"
2014,Marzo,Cuba,192,0,1,1,"(4.815061,-75.736532)"
2015,Mayo,Italia,380,0,1,1,"(1.813928,-78.763924)"
2021,Octubre,Uruguay,858,1,4,5,"(4.815061,-75.736532)"
2012,Noviembre,México,484,13,30,43,"(10.886611,-74.776708)"
2022,Abril,Barbados,52,7,7,14,"(4.697144,-74.140516)"
2014,Enero,Honduras,340,0,3,3,"(7.927209,-72.507910)"
2019,Julio,Liberia,430,0,2,2,"(4.697144,-74.140516)"
2014,Agosto,Sudán,736,0,1,1,"(4.697144,-74.140516)"
2016,Marzo,Federación de Rusia,643,0,4,4,"(10.971302,-74.765397)"
2014,Abril,Finlandia,246,2,6,8,"(10.408582,-75.538003)"
2012,Julio,Federación de Rusia,643,1,3,4,"(0.814836,-77.662532)"
2021,Enero,Noruega,578,0,7,7,"(6.171601,-75.427454)"
2017,Mayo,Reino Unido de Gran Bretaña e Irlanda del Norte,826,9,11,20,"(-4.197703,-69.941278)"
2013,Octubre,Hungría,348,0,2,2,"(3.541112,-76.384584)"
2023,Enero,Guatemala,320,1,1,2,"(7.927209,-72.507910)"
2014,Febrero,Guatemala,320,0,1,1,"(12.586067,-81.702563)"
2020,Enero,República Democrática del Congo,180,0,2,2,"(0.25129,-76.875963)"
2014,Septiembre,Ecuador,218,2,2,4,"(4.815061,-75.736532)"
2019,Abril,Cuba,192,2,0,2,"(-4.197703,-69.941278)"
2015,Julio,Australia,36,0,1,1,"(4.452882,-75.766298)"
2023,Junio,Islandia,352,5,3,8,"(6.171601,-75.427454)"
2023,Enero,Honduras,340,0,3,3,"(3.893038,-77.067921)"
2017,Mayo,Suiza,756,1,0,1,"(12.586067,-81.702563)"
2019,Noviembre,Zimbabue,716,0,1,1,"(6.171601,-75.427454)"
2015,Octubre,Indonesia,360,0,11,11,"(10.408582,-75.538003)"
2012,Mayo,Cuba,192,0,1,1,"(4.452882,-75.766298)"
2012,Octubre,Países Bajos,528,1,4,5,"(11.360009,-72.129330)"
2019,Mayo,Rumania,642,69,69,138,"(4.697144,-74.140516)"
2012,Octubre,España,724,7,5,12,"(12.586067,-81.702563)"
2012,Abril,Reino Unido de Gran Bretaña e Irlanda del Norte,826,0,4,4,"(11.247723,-74.213989)"
2013,Noviembre,Sudáfrica,710,0,5,5,"(10.445761,-75.516429)"
2019,Marzo,México,484,0,1,1,"(6.228046,-77.404104)"
2013,Septiembre,Países Bajos,528,5,11,16,"(10.408582,-75.538003)"
2012,Mayo,Cuba,192,0,4,4,"(0.814836,-77.662532)"
2015,Julio,Francia,250,2157,3103,5260,"(4.697144,-74.140516)"
2013,Octubre,Dinamarca,208,0,8,8,"(3.541112,-76.384584)"
2014,Abril,Etiopia,231,4,7,11,"(6.171601,-75.427454)"
2017,Agosto,Israel,376,16,36,52,"(10.445761,-75.516429)"
2019,Junio,China,156,2,0,2,"(-4.197703,-69.941278)"
2014,Febrero,Belice,84,1,2,3,"(10.445761,-75.516429)"
2015,Octubre,Panamá,591,2,3,5,"(7.927209,-72.507910)"
2018,Junio,Francia,250,3,9,12,"(4.815061,-75.736532)"
2023,Abril,Granada,308,0,2,2,"(3.541112,-76.384584)"
2015,Enero,Rumania,642,0,3,3,"(6.171601,-75.427454)"
2018,Febrero,Malasia,458,1,1,2,"(8.635765,-77.346578)"
2022,Abril,Austria,40,0,1,1,"(3.541112,-76.384584)"
2016,Febrero,Israel,376,0,2,2,"(12.586067,-81.702563)"
2022,Diciembre,Emiratos Árabes,784,1,0,1,"(10.445761,-75.516429)"
2018,Febrero,Argentina,32,121,188,309,"(0.814836,-77.662532)"
2023,Mayo,Guatemala,320,778,1145,1923,"(4.697144,-74.140516)"
2019,Febrero,Bahamas,44,0,9,9,"(6.171601,-75.427454)"
2019,Octubre,Países Bajos,528,0,1,1,"(12.586067,-81.702563)"
2016,Octubre,Italia,380,11,19,30,"(7.818934,-72.453226)"
2014,Abril,Chile,152,6,17,23,"(10.886611,-74.776708)"
2022,Septiembre,Nicaragua,558,14,46,60,"(3.541112,-76.384584)"
2018,Marzo,Eslovaquia,703,32,57,89,"(4.697144,-74.140516)"
2014,Octubre,Filipinas,608,0,7,7,"(10.886611,-74.776708)"
2015,Febrero,Estonia,233,7,6,13,"(-4.197703,-69.941278)"
2018,Septiembre,Uruguay,858,467,602,1069,"(4.697144,-74.140516)"
2019,Marzo,Estados Unidos de América,840,291,460,751,"(4.815061,-75.736532)"
2016,Septiembre,Polonia,616,5,8,13,"(0.814836,-77.662532)"
2019,Enero,España,724,6,6,12,"(12.586067,-81.702563)"
2019,Agosto,Honduras,340,1,0,1,"(7.088729,-70.740253)"
2017,Abril,México,484,10,14,24,"(10.408582,-75.538003)"
2019,Febrero,Cuba,192,2,1,3,"(-4.197703,-69.941278)"
2015,Junio,Bulgaria,100,0,1,1,"(0.814836,-77.662532)"
2021,Diciembre,Antigua y Barbuda,28,0,1,1,"(6.171601,-75.427454)"
2015,Septiembre,Panamá,591,135,164,299,"(3.541112,-76.384584)"
2019,Mayo,Hungría,348,2,6,8,"(0.814836,-77.662532)"
2022,Septiembre,Azerbaiyán,31,0,1,1,"(3.893038,-77.067921)"
2023,Enero,Eslovenia,705,5,6,11,"(6.171601,-75.427454)"
2016,Diciembre,Ucrania,804,0,2,2,"(9.402978,-75.681599)"
2022,Agosto,Indonesia,360,27,25,52,"(4.697144,-74.140516)"
2017,Abril,Países Bajos,528,0,1,1,"(3.893038,-77.067921)"
2020,Noviembre,Kirguistán,417,1,0,1,"(4.697144,-74.140516)"
2021,Mayo,Polonia,616,2,6,8,"(6.171601,-75.427454)"
2015,Julio,Reino Unido de Gran Bretaña e Irlanda del Norte,826,0,1,1,"(7.088729,-70.740253)"
2018,Junio,Pakistán,586,0,1,1,"(10.971302,-74.765397)"
2018,Febrero,Reino Unido de Gran Bretaña e Irlanda del Norte,826,13,23,36,"(10.408582,-75.538003)"
2018,Febrero,República Checa,203,0,3,3,"(10.886611,-74.776708)"
2017,Julio,Francia,250,135,207,342,"(3.541112,-76.384584)"
2018,Abril,Reino Unido de Gran Bretaña e Irlanda del Norte,826,0,4,4,"(7.128456,-73.183637)"
2017,Mayo,Hungría,348,27,37,64,"(4.697144,-74.140516)"
2016,Enero,Venezuela,862,16,16,32,"(7.128456,-73.183637)"
2014,Marzo,Barbados,52,1,1,2,"(10.445761,-75.516429)"
2015,Marzo,Austria,40,0,1,1,"(11.360009,-72.129330)"
2023,Junio,Portugal,620,184,367,551,"(4.697144,-74.140516)"
2016,Junio,República de Corea,410,12,43,55,"(6.171601,-75.427454)"
2013,Febrero,Portugal,620,2,2,4,"(11.360009,-72.129330)"
2012,Marzo,Estados Unidos de América,840,12,19,31,"(11.360009,-72.129330)"
2022,Julio,Bahamas,44,3,3,6,"(10.886611,-74.776708)"
2023,Abril,Vietnam,704,0,1,1,"(10.445761,-75.516429)"
2022,Septiembre,Singapur,702,7,4,11,"(6.171601,-75.427454)"
2018,Junio,Canadá,124,0,2,2,"(8.635765,-77.346578)"
2019,Diciembre,Reino Unido de Gran Bretaña e Irlanda del Norte,826,1,1,2,"(0.25129,-76.875963)"
2012,Octubre,Estados Unidos de América,840,1,4,5,"(7.088729,-70.740253)"
2014,Septiembre,Cuba,192,21,42,63,"(6.171601,-75.427454)"
2012,Julio,Taiwán,158,3,4,7,"(10.445761,-75.516429)"
2018,Diciembre,Mozambique,508,1,1,2,"(4.697144,-74.140516)"
2022,Junio,Vietnam,704,1,0,1,"(3.541112,-76.384584)"
2023,Enero,Perú,604,93,108,201,"(7.818934,-72.453226)"
2019,Mayo,Surinam,740,19,33,52,"(4.697144,-74.140516)"
2016,Noviembre,Federación de Rusia,643,2,5,7,"(7.818934,-72.453226)"
2016,Agosto,Ecuador,218,505,555,1060,"(3.541112,-76.384584)"
2014,Junio,Filipinas,608,0,13,13,"(3.893038,-77.067921)"
2018,Mayo,Alemania,276,0,2,2,"(3.893038,-77.067921)"
2012,Julio,España,724,8,16,24,"(0.814836,-77.662532)"
2017,Julio,México,484,343,395,738,"(10.445761,-75.516429)"
2015,Marzo,Argentina,32,1,0,1,"(-4.223468,-69.945098)"
2014,Agosto,Italia,380,18,28,46,"(7.818934,-72.453226)"
2018,Octubre,Turquía,792,0,4,4,"(10.886611,-74.776708)"
2015,Diciembre,Italia,380,2,8,10,"(7.128456,-73.183637)"
2012,Agosto,Trinidad y Tobago,780,21,65,86,"(4.697144,-74.140516)"
2015,Diciembre,Bulgaria,100,1,0,1,"(-4.223468,-69.945098)"
2012,Enero,Panamá,591,127,224,351,"(6.171601,-75.427454)"
2022,Septiembre,Ucrania,804,0,1,1,"(6.17134,-75.427194)"
2018,Junio,Grecia,300,0,2,2,"(10.971302,-74.765397)"
2019,Marzo,Tanzania,834,1,1,2,"(10.445761,-75.516429)"
2017,Junio,Italia,380,25,69,94,"(3.541112,-76.384584)"
2015,Abril,República de Irlanda,372,2,0,2,"(8.635765,-77.346578)"
2019,Enero,Canadá,124,3,2,5,"(4.452882,-75.766298)"
2021,Mayo,Emiratos Árabes,784,0,2,2,"(4.697144,-74.140516)"
2022,Febrero,Italia,380,4,1,5,"(12.586067,-81.702563)"
2021,Septiembre,Chile,152,0,3,3,"(-4.197703,-69.941278)"
2020,Marzo,Austria,40,1,1,2,"(10.886611,-74.776708)"
2015,Noviembre,Egipto,818,0,1,1,"(3.541112,-76.384584)"
2022,Septiembre,Marruecos,504,1,1,2,"(10.445761,-75.516429)"
2017,Marzo,Sierra Leona,694,0,2,2,"(4.697144,-74.140516)"
2019,Septiembre,Argentina,32,218,407,625,"(6.171601,-75.427454)"
2016,Julio,República de Corea,410,1,7,8,"(7.818934,-72.453226)"
2017,Noviembre,Polonia,616,7,6,13,"(3.541112,-76.384584)"
2017,Abril,Panamá,591,157,173,330,"(3.541112,-76.384584)"
2022,Mayo,Senegal,686,0,2,2,"(4.697144,-74.140516)"
2016,Enero,Bermudas/Territorio Británico de Ultramar,60,0,1,1,"(10.445761,-75.516429)"
2022,Junio,Bahamas,44,5,10,15,"(10.445761,-75.516429)"
2018,Febrero,Portugal,620,2,8,10,"(0.814836,-77.662532)"
2015,Marzo,México,484,0,3,3,"(8.066966,-76.735404)"
2022,Agosto,Kuwait,414,2,1,3,"(10.445761,-75.516429)"
2014,Enero,Polonia,616,1,3,4,"(10.445761,-75.516429)"
2023,Junio,Sudán del Sur,728,0,1,1,"(4.697144,-74.140516)"
2013,Mayo,República Dominicana,214,0,1,1,"(4.815061,-75.736532)"
2015,Abril,Bahamas,44,0,1,1,"(6.171601,-75.427454)"
2016,Septiembre,Países Bajos,528,32,64,96,"(10.445761,-75.516429)"
2018,Agosto,India,356,0,1,1,"(3.893038,-77.067921)"
2014,Septiembre,Azerbaiyán,31,0,1,1,"(0.814836,-77.662532)"
2017,Agosto,El Salvador,222,2,2,4,"(7.818934,-72.453226)"
2018,Febrero,Nueva Zelanda,554,0,1,1,"(4.452882,-75.766298)"
2016,Noviembre,Seychelles,690,0,1,1,"(4.697144,-74.140516)"
2014,Abril,Rumania,642,5,4,9,"(6.171601,-75.427454)"
2015,Octubre,Países Bajos,528,1,0,1,"(10.886611,-74.776708)"
2022,Noviembre,Líbano,422,0,1,1,"(0.814836,-77.662532)"
2012,Julio,Surinam,740,15,7,22,"(4.697144,-74.140516)"
2018,Noviembre,México,484,0,1,1,"(4.452882,-75.766298)"
2014,Agosto,El Salvador,222,1,1,2,"(4.815061,-75.736532)"
2017,Junio,México,484,0,2,2,"(-4.197703,-69.941278)"
2014,Agosto,Dinamarca,208,2,2,4,"(10.445761,-75.516429)"
2015,Septiembre,Paraguay,600,43,27,70,"(12.586067,-81.702563)"
2017,Enero,Dinamarca,208,138,240,378,"(4.697144,-74.140516)"
2022,Febrero,Singapur,702,1,1,2,"(10.445761,-75.516429)"
2012,Febrero,Haití,332,0,11,11,"(4.697144,-74.140516)"
2020,Febrero,Francia,250,0,1,1,"(7.088729,-70.740253)"
2022,Mayo,Argentina,32,1,4,5,"(7.128456,-73.183637)"
2016,Noviembre,Chile,152,4,4,8,"(4.815061,-75.736532)"
2022,Julio,México,484,3,0,3,"(7.088729,-70.740253)"
2015,Septiembre,Iraq,368,0,5,5,"(4.697144,-74.140516)"
2014,Junio,Panamá,591,1,0,1,"(7.088729,-70.740253)"
2019,Octubre,Canadá,124,8,8,16,"(0.814836,-77.662532)"
2023,Enero,Suiza,756,79,85,164,"(10.445761,-75.516429)"
2016,Diciembre,Federación de Rusia,643,0,2,2,"(10.971302,-74.765397)"
2016,Agosto,Turquía,792,3,10,13,"(6.171601,-75.427454)"
2014,Febrero,Panamá,591,125,182,307,"(10.445761,-75.516429)"
2013,Mayo,España,724,2,1,3,"(10.408582,-75.538003)"
2020,Febrero,Reino Unido de Gran Bretaña e Irlanda del Norte,826,0,6,6,"(7.818934,-72.453226)"
2016,Diciembre,Bélgica,56,0,2,2,"(11.247723,-74.213989)"
2013,Noviembre,China,156,182,482,664,"(4.697144,-74.140516)"
2013,Febrero,República Checa,203,0,3,3,"(6.171601,-75.427454)"
2023,Enero,Venezuela,862,13,10,23,"(-4.197703,-69.941278)"
2019,Abril,Costa de Marfil,384,0,2,2,"(6.171601,-75.427454)"
2022,Octubre,Benín,204,0,2,2,"(6.171601,-75.427454)"
2020,Febrero,Bulgaria,100,3,3,6,"(3.541112,-76.384584)"
2019,Septiembre,Canadá,124,4,3,7,"(4.452882,-75.766298)"
2016,Marzo,Federación de Rusia,643,0,2,2,"(0.25129,-76.875963)"
2012,Abril,Francia,250,4,12,16,"(11.247723,-74.213989)"
2022,Octubre,Australia,36,3,3,6,"(8.635765,-77.346578)"
2014,Junio,Bolivia,68,1,0,1,"(0.25129,-76.875963)"
2014,Abril,Argentina,32,2668,3776,6444,"(4.697144,-74.140516)"
2014,Marzo,España,724,0,6,6,"(7.927209,-72.507910)"
2019,Febrero,Nepal,524,0,2,2,"(3.541112,-76.384584)"
2019,Enero,Argentina,32,317,302,619,"(3.541112,-76.384584)"
2019,Junio,Filipinas,608,1,19,20,"(10.886611,-74.776708)"
2015,Enero,Venezuela,862,3,3,6,"(0.25129,-76.875963)"
2017,Diciembre,Haití,332,5,3,8,"(10.445761,-75.516429)"
2015,Marzo,Ecuador,218,0,1,1,"(0.812436,-77.847006)"
2018,Agosto,Argentina,32,0,2,2,"(4.452882,-75.766298)"
2017,Junio,Rumania,642,0,1,1,"(9.402978,-75.681599)"
2018,Febrero,Austria,40,1,0,1,"(11.247723,-74.213989)"
2016,Agosto,Albania,8,2,4,6,"(4.697144,-74.140516)"
2013,Julio,Eslovaquia,703,1,0,1,"(11.360009,-72.129330)"
2020,Abril,Rumania,642,1,2,3,"(4.697144,-74.140516)"
2020,Febrero,Venezuela,862,4,27,31,"(1.813928,-78.763924)"
2022,Abril,India,356,0,2,2,"(9.402978,-75.681599)"
2018,Diciembre,Guatemala,320,0,3,3,"(0.814836,-77.662532)"
2014,Noviembre,Bélgica,56,3,4,7,"(0.814836,-77.662532)"
2012,Diciembre,Guyana,328,1,0,1,"(7.128456,-73.183637)"
2015,Agosto,Bolivia,68,6,3,9,"(12.586067,-81.702563)"
2019,Enero,República de Irlanda,372,1,0,1,"(-4.197703,-69.941278)"
2012,Mayo,Jamaica,388,2,1,3,"(10.445761,-75.516429)"
2017,Abril,Bélgica,56,0,2,2,"(4.815061,-75.736532)"
2019,Abril,República Checa,203,1,4,5,"(0.814836,-77.662532)"
2018,Mayo,China,156,1,1,2,"(-4.197703,-69.941278)"
2018,Abril,Países Bajos,528,2,0,2,"(12.5744111,-81.703935)"
2015,Septiembre,Venezuela,862,0,1,1,"(1.813928,-78.763924)"
2013,Noviembre,República Dominicana,214,0,1,1,"(7.927209,-72.507910)"
2012,Agosto,Argentina,32,3,3,6,"(-4.197703,-69.941278)"
2022,Junio,Georgia,268,13,49,62,"(4.697144,-74.140516)"
2012,Enero,Federación de Rusia,643,2,11,13,"(0.814836,-77.662532)"
2022,Mayo,China,156,10,15,25,"(10.445761,-75.516429)"
2016,Enero,Costa Rica,188,140,193,333,"(6.171601,-75.427454)"
2018,Julio,Nueva Zelanda,554,0,3,3,"(-4.197703,-69.941278)"
2018,Junio,México,484,4449,6618,11069,"(4.697144,-74.140516)"
2021,Noviembre,Nepal,524,0,1,1,"(10.445761,-75.516429)"
2019,Marzo,Chile,152,0,2,2,"(8.36068,-72.409396)"
2015,Julio,Suecia,752,6,9,15,"(0.814836,-77.662532)"
2017,Abril,Palestina,99999,1,0,1,"(4.697144,-74.140516)"
2019,Abril,Costa Rica,188,1,1,2,"(11.360009,-72.129330)"
2022,Enero,Montenegro,499,0,1,1,"(10.886611,-74.776708)"
2013,Diciembre,El Salvador,222,1,2,3,"(10.408582,-75.538003)"
2016,Octubre,Perú,604,0,2,2,"(1.813928,-78.763924)"
2021,Mayo,Guyana,328,2,1,3,"(3.541112,-76.384584)"
2018,Agosto,Reino Unido de Gran Bretaña e Irlanda del Norte,826,18,30,48,"(10.886611,-74.776708)"
2022,Diciembre,Albania,8,4,2,6,"(10.445761,-75.516429)"
2022,Junio,Georgia,268,1,4,5,"(10.445761,-75.516429)"
2017,Abril,Islas Caimán/Territorio Británico de Ultramar,136,1,2,3,"(10.886611,-74.776708)"
2022,Diciembre,Belice,84,3,2,5,"(10.886611,-74.776708)"
2017,Septiembre,Ecuador,218,1,3,4,"(0.812436,-77.847006)"
2022,Diciembre,Ecuador,218,150,160,311,"(3.541112,-76.384584)"
2015,Enero,El Salvador,222,6,7,13,"(10.445761,-75.516429)"
2020,Septiembre,Vanuatu,548,0,1,1,"(11.360009,-72.129330)"
2021,Marzo,Italia,380,0,1,1,"(7.128456,-73.183637)"
2019,Marzo,Sudán,736,0,1,1,"(4.697144,-74.140516)"
2016,Marzo,República de Kosovo,901,1,0,1,"(4.697144,-74.140516)"
2023,Febrero,Canadá,124,1215,1422,2637,"(10.445761,-75.516429)"
2018,Marzo,Países Bajos,528,5,2,7,"(-4.223468,-69.945098)"
2022,Mayo,Malta,470,0,1,1,"(10.886611,-74.776708)"
2019,Noviembre,Estados Unidos de América,840,180,342,522,"(4.815061,-75.736532)"
2014,Diciembre,España,724,214,406,620,"(3.541112,-76.384584)"
2022,Diciembre,Ecuador,218,1,2,3,"(7.088729,-70.740253)"
2022,Enero,Honduras,340,12,16,28,"(10.886611,-74.776708)"
2016,Abril,Venezuela,862,51,46,97,"(7.088729,-70.740253)"
2016,Diciembre,Bulgaria,100,0,1,1,"(-4.197703,-69.941278)"
2014,Agosto,República de Irlanda,372,10,18,28,"(10.445761,-75.516429)"
2022,Abril,República de Irlanda,372,23,23,46,"(10.445761,-75.516429)"
2014,Noviembre,Brasil,76,15,31,46,"(7.818934,-72.453226)"
2014,Octubre,Guyana,328,0,1,1,"(7.818934,-72.453226)"
2013,Mayo,Venezuela,862,4,3,7,"(7.128456,-73.183637)"
2012,Marzo,Honduras,340,1,1,2,"(12.586067,-81.702563)"
2018,Diciembre,Irán,364,0,1,1,"(11.360009,-72.129330)"
2015,Octubre,Luxemburgo,442,1,0,1,"(10.445761,-75.516429)"
2019,Agosto,Paraguay,600,2,0,2,"(0.814836,-77.662532)"
2018,Marzo,Letonia,428,2,4,6,"(10.445761,-75.516429)"
2014,Mayo,Francia,250,3,6,9,"(11.247723,-74.213989)"
2019,Mayo,Chipre,196,1,1,2,"(10.445761,-75.516429)"
2015,Enero,Egipto,818,1,1,2,"(3.541112,-76.384584)"
2015,Enero,Bermudas/Territorio Británico de Ultramar,60,0,1,1,"(6.171601,-75.427454)"
2016,Febrero,Noruega,578,3,12,15,"(10.445761,-75.516429)"
2018,Febrero,Panamá,591,129,122,251,"(10.886611,-74.776708)"
2013,Junio,Territorio Antártico Británico/Territorio Británico de Ultramar,260,1,0,1,"(10.886611,-74.776708)"
2013,Diciembre,Australia,36,42,81,123,"(6.171601,-75.427454)"
2019,Noviembre,Eslovaquia,703,1,0,1,"(0.25129,-76.875963)"
2018,Mayo,Honduras,340,33,41,74,"(10.445761,-75.516429)"
2020,Diciembre,Bahamas,44,0,5,5,"(6.171601,-75.427454)"
2012,Agosto,Países Bajos,528,53,71,124,"(6.171601,-75.427454)"
2016,Mayo,Etiopia,231,0,1,1,"(6.171601,-75.427454)"
2017,Mayo,Suiza,756,12,23,35,"(3.541112,-76.384584)"
2023,Marzo,Grecia,300,0,2,2,"(-4.223468,-69.945098)"
2021,Julio,Letonia,428,0,2,2,"(10.886611,-74.776708)"
2012,Septiembre,Guatemala,320,39,111,150,"(6.171601,-75.427454)"
2019,Septiembre,República de Armenia,51,1,0,1,"(3.541112,-76.384584)"
2019,Julio,Suecia,752,0,1,1,"(-4.197703,-69.941278)"
2019,Febrero,España,724,0,1,1,"(13.3387613,-81.372937)"
2016,Mayo,Nueva Zelanda,554,0,2,2,"(3.541112,-76.384584)"
2022,Enero,Nigeria,566,0,6,6,"(4.697144,-74.140516)"
2020,Febrero,Bermudas/Territorio Británico de Ultramar,60,1,1,2,"(4.697144,-74.140516)"
2021,Noviembre,República de Corea,410,7,7,14,"(10.445761,-75.516429)"
2015,Febrero,Portugal,620,0,2,2,"(8.635765,-77.346578)"
2022,Agosto,Estados Unidos de América,840,0,1,1,"(10.971302,-74.765397)"
2021,Septiembre,Austria,40,56,122,178,"(4.697144,-74.140516)"
2018,Diciembre,Croacia,191,0,2,2,"(10.886611,-74.776708)"
2022,Julio,México,484,6,18,24,"(7.818934,-72.453226)"
2023,Febrero,España,724,519,846,1365,"(6.171601,-75.427454)"
2016,Julio,España,724,10,18,28,"(12.586067,-81.702563)"
2021,Septiembre,Albania,8,0,1,1,"(10.886611,-74.776708)"
2012,Junio,Taiwán,158,27,48,75,"(4.697144,-74.140516)"
2013,Julio,Bangladesh,50,1,9,10,"(4.697144,-74.140516)"
2021,Agosto,República Dominicana,214,0,1,1,"(-4.197703,-69.941278)"
2012,Octubre,Austria,40,8,12,20,"(6.171601,-75.427454)"
2015,Abril,Cuba,192,1,0,1,"(4.815061,-75.736532)"
2019,Abril,Estonia,233,3,2,5,"(3.541112,-76.384584)"
2012,Agosto,España,724,1,4,5,"(7.128456,-73.183637)"
2017,Agosto,Honduras,340,1,2,3,"(4.815061,-75.736532)"
2012,Diciembre,Bermudas/Territorio Británico de Ultramar,60,0,2,2,"(6.171601,-75.427454)"
2020,Enero,México,484,0,1,1,"(10.971302,-74.765397)"
2022,Abril,Eslovenia,705,2,1,3,"(8.635765,-77.346578)"
2019,Enero,Brasil,76,1,1,2,"(8.635765,-77.346578)"
2015,Julio,Venezuela,862,3,1,4,"(4.452882,-75.766298)"
2013,Diciembre,Indonesia,360,0,4,4,"(10.408582,-75.538003)"
2019,Abril,Eslovenia,705,1,2,3,"(0.814836,-77.662532)"
2022,Junio,Países Bajos,528,1,0,1,"(7.927209,-72.507910)"
2019,Diciembre,Bolivia,68,17,11,28,"(10.408582,-75.538003)"
2013,Diciembre,Croacia,191,0,1,1,"(7.818934,-72.453226)"
2018,Enero,Finlandia,246,0,1,1,"(-4.223468,-69.945098)"
2023,Marzo,Hong Kong,344,0,6,6,"(6.171601,-75.427454)"
2019,Mayo,Panamá,591,0,1,1,"(10.971302,-74.765397)"
2017,Marzo,República Democrática del Congo,180,6,14,20,"(4.697144,-74.140516)"
2019,Noviembre,Nepal,524,1,1,2,"(10.445761,-75.516429)"
2016,Mayo,Eslovaquia,703,0,1,1,"(10.445761,-75.516429)"
2015,Diciembre,Nepal,524,2,1,3,"(4.697144,-74.140516)"
2022,Diciembre,Ucrania,804,0,42,42,"(11.247723,-74.213989)"
2014,Junio,Francia,250,69,87,156,"(0.814836,-77.662532)"
2019,Febrero,Bolivia,68,4,0,4,"(4.815061,-75.736532)"
2023,Enero,India,356,0,2,2,"(4.815061,-75.736532)"
2014,Febrero,Francia,250,1,4,5,"(4.815061,-75.736532)"
2014,Octubre,Hong Kong,344,1,0,1,"(4.697144,-74.140516)"
2013,Diciembre,Turquía,792,0,1,1,"(10.445761,-75.516429)"
2017,Mayo,Jordania,400,1,7,8,"(4.697144,-74.140516)"
2014,Diciembre,Montenegro,499,1,0,1,"(4.697144,-74.140516)"
2018,Enero,Indonesia,360,0,3,3,"(10.971302,-74.765397)"
2018,Agosto,Estados Unidos de América,840,1271,1693,2964,"(3.541112,-76.384584)"
2016,Mayo,Santa Lucia,662,0,3,3,"(4.697144,-74.140516)"
2021,Agosto,Estados Unidos de América,840,0,4,4,"(11.117806,-74.232622)"
2022,Diciembre,Estados Unidos de América,840,37,56,93,"(0.814836,-77.662532)"
2012,Octubre,Alemania,276,11,30,41,"(10.445761,-75.516429)"
2017,Septiembre,Pakistán,586,0,1,1,"(3.541112,-76.384584)"
2012,Febrero,México,484,10,9,19,"(10.408582,-75.538003)"
2018,Noviembre,Belice,84,2,0,2,"(12.586067,-81.702563)"
2017,Diciembre,Uruguay,858,334,485,819,"(4.697144,-74.140516)"
2016,Junio,Francia,250,2,1,3,"(11.360009,-72.129330)"
2022,Febrero,Bahamas,44,2,2,4,"(6.171601,-75.427454)"
2023,Enero,Hong Kong,344,1,2,3,"(3.541112,-76.384584)"
2015,Septiembre,Paraguay,600,1,0,1,"(4.815061,-75.736532)"
2021,Mayo,Australia,36,11,37,48,"(4.697144,-74.140516)"
2016,Marzo,Suecia,752,22,25,47,"(0.814836,-77.662532)"
2018,Mayo,España,724,8,15,23,"(12.586067,-81.702563)"
2014,Marzo,Indonesia,360,0,3,3,"(10.445761,-75.516429)"
2013,Mayo,República Democrática del Congo,180,1,2,3,"(4.697144,-74.140516)"
2016,Enero,El Salvador,222,5,1,6,"(12.586067,-81.702563)"
2021,Noviembre,Dinamarca,208,4,4,8,"(11.247723,-74.213989)"
2012,Marzo,Croacia,191,1,0,1,"(0.814836,-77.662532)"
2022,Marzo,Serbia,688,0,1,1,"(10.971302,-74.765397)"
2013,Febrero,Nueva Zelanda,554,2,1,3,"(3.541112,-76.384584)"
2014,Mayo,Trinidad y Tobago,780,0,2,2,"(10.886611,-74.776708)"
2022,Diciembre,Ucrania,804,0,3,3,"(9.402978,-75.681599)"
2021,Enero,Lituania,440,0,1,1,"(3.541112,-76.384584)"
2016,Julio,Bosnia y Herzegovina,70,1,0,1,"(6.171601,-75.427454)"
2019,Septiembre,Francia,250,0,3,3,"(7.818934,-72.453226)"
2016,Marzo,Guatemala,320,4,4,8,"(4.815061,-75.736532)"
2017,Julio,Austria,40,1,0,1,"(-4.197703,-69.941278)"
2022,Septiembre,Bélgica,56,324,430,754,"(4.697144,-74.140516)"
2019,Marzo,Trinidad y Tobago,780,0,1,1,"(12.586067,-81.702563)"
2016,Diciembre,Jamaica,388,2,10,12,"(10.445761,-75.516429)"
2017,Octubre,Cuba,192,8,12,20,"(10.886611,-74.776708)"
2021,Julio,Nigeria,566,0,5,5,"(10.445761,-75.516429)"
2022,Diciembre,Finlandia,246,1,1,2,"(12.586067,-81.702563)"
2013,Agosto,Turquía,792,0,3,3,"(7.818934,-72.453226)"
2017,Diciembre,India,356,1,10,11,"(10.408582,-75.538003)"
2014,Junio,Hungría,348,0,1,1,"(0.25129,-76.875963)"
2017,Septiembre,República de Moldavia,498,0,1,1,"(10.445761,-75.516429)"
2022,Agosto,Suiza,756,81,108,189,"(6.171601,-75.427454)"
2019,Diciembre,Rumania,642,0,2,2,"(3.893038,-77.067921)"
2020,Febrero,Panamá,591,0,8,8,"(10.408582,-75.538003)"
2013,Diciembre,Reino Unido de Gran Bretaña e Irlanda del Norte,826,41,57,98,"(0.814836,-77.662532)"
2012,Noviembre,Reino Unido de Gran Bretaña e Irlanda del Norte,826,6,15,21,"(3.541112,-76.384584)"
2020,Marzo,Ecuador,218,1,0,1,"(4.815061,-75.736532)"
2016,Abril,Brasil,76,0,1,1,"(7.927209,-72.507910)"
2023,Junio,Paraguay,600,0,1,1,"(11.117806,-74.232622)"
2019,Septiembre,Nepal,524,1,0,1,"(10.886611,-74.776708)"
2017,Septiembre,Brasil,76,0,2,2,"(3.866713,-67.927521)"
2019,Julio,Mozambique,508,1,0,1,"(6.171601,-75.427454)"
2013,Mayo,Panamá,591,2,15,17,"(7.927209,-72.507910)"
2023,Enero,Ecuador,218,26,38,64,"(8.364293,-72.405710)"
2013,Diciembre,Suecia,752,29,46,75,"(3.541112,-76.384584)"
2021,Junio,Lituania,440,0,1,1,"(10.445761,-75.516429)"
2016,Mayo,Rumania,642,51,80,131,"(4.697144,-74.140516)"
2019,Octubre,Burundi,108,0,1,1,"(6.171601,-75.427454)"
2012,Mayo,Croacia,191,0,1,1,"(7.818934,-72.453226)"
2012,Noviembre,Italia,380,0,3,3,"(7.128456,-73.183637)"
2019,Abril,Togo,768,0,1,1,"(10.886611,-74.776708)"
2012,Febrero,Suiza,756,21,27,48,"(3.541112,-76.384584)"
2013,Agosto,Sudáfrica,710,4,5,9,"(10.445761,-75.516429)"
2022,Julio,Venezuela,862,21,21,42,"(4.815061,-75.736532)"
2013,Octubre,Gabón,266,0,3,3,"(4.697144,-74.140516)"
2020,Enero,Austria,40,0,1,1,"(11.247723,-74.213989)"
2014,Abril,Austria,40,1,0,1,"(12.586067,-81.702563)"
2017,Septiembre,República Árabe de Yemen,887,0,1,1,"(0.814836,-77.662532)"
2019,Diciembre,Andorra,20,1,2,3,"(4.697144,-74.140516)"
2020,Febrero,Brasil,76,30,41,71,"(0.814836,-77.662532)"
2012,Febrero,Trinidad y Tobago,780,0,1,1,"(12.586067,-81.702563)"
2019,Febrero,Bahamas,44,2,1,3,"(10.445761,-75.516429)"
2022,Octubre,Chile,152,10,22,32,"(10.886611,-74.776708)"
2020,Septiembre,Italia,380,0,5,5,"(10.886611,-74.776708)"
2012,Agosto,Suecia,752,1,0,1,"(-4.197703,-69.941278)"
2022,Julio,Islandia,352,0,1,1,"(10.445761,-75.516429)"
2015,Mayo,India,356,0,3,3,"(10.886611,-74.776708)"
2016,Junio,Paraguay,600,16,19,35,"(3.541112,-76.384584)"
2017,Abril,España,724,0,3,3,"(-4.197703,-69.941278)"
2020,Enero,Venezuela,862,3,9,12,"(7.927209,-72.507910)"
2017,Mayo,Chipre,196,0,1,1,"(3.541112,-76.384584)"
2021,Diciembre,Santa Lucia,662,0,1,1,"(6.171601,-75.427454)"
2014,Enero,Nigeria,566,0,1,1,"(10.445761,-75.516429)"
2017,Junio,Hong Kong,344,1,5,6,"(4.697144,-74.140516)"
2021,Julio,Honduras,340,0,2,2,"(12.586067,-81.702563)"
2015,Diciembre,México,484,15,11,26,"(10.408582,-75.538003)"
2021,Febrero,Filipinas,608,0,1,1,"(3.893038,-77.067921)"
2023,Mayo,Surinam,740,14,24,38,"(4.697144,-74.140516)"
2014,Julio,Cuba,192,26,26,52,"(6.171601,-75.427454)"
2015,Marzo,España,724,13,32,45,"(10.886611,-74.776708)"
2017,Marzo,República de Irlanda,372,109,197,306,"(4.697144,-74.140516)"
2022,Agosto,Guatemala,320,8,14,22,"(4.815061,-75.736532)"
2019,Noviembre,Perú,604,5,5,10,"(4.815061,-75.736532)"
2022,Agosto,Francia,250,2,4,6,"(8.635765,-77.346578)"
2013,Mayo,Bahamas,44,7,8,15,"(3.541112,-76.384584)"
2020,Febrero,Curazao,99999,1,1,2,"(4.697144,-74.140516)"
2016,Abril,India,356,13,64,77,"(6.171601,-75.427454)"
2018,Abril,Perú,604,29,38,67,"(-4.223468,-69.945098)"
2019,Abril,Países Bajos,528,1,0,1,"(8.36068,-72.409396)"
2015,Agosto,Cuba,192,2,2,4,"(7.927209,-72.507910)"
2012,Septiembre,Letonia,428,1,8,9,"(4.697144,-74.140516)"
2019,Septiembre,Países Bajos,528,2,9,11,"(11.360009,-72.129330)"
2021,Agosto,Filipinas,608,0,3,3,"(9.402978,-75.681599)"
2019,Junio,Dinamarca,208,3,5,8,"(4.815061,-75.736532)"
2014,Octubre,Venezuela,862,1,2,3,"(0.25129,-76.875963)"
2019,Diciembre,Australia,36,3,0,3,"(-4.223468,-69.945098)"
2016,Febrero,Surinam,740,22,20,42,"(4.697144,-74.140516)"
2021,Enero,Letonia,428,2,0,2,"(6.171601,-75.427454)"
2022,Junio,Costa Rica,188,12,19,31,"(10.886611,-74.776708)"
2014,Julio,Noruega,578,4,5,9,"(3.541112,-76.384584)"
2013,Junio,Honduras,340,121,206,327,"(4.697144,-74.140516)"
2018,Abril,Estados Unidos de América,840,5,13,18,"(7.818934,-72.453226)"
2013,Mayo,Bután,64,1,1,2,"(4.697144,-74.140516)"
2017,Enero,Turquía,792,197,288,485,"(4.697144,-74.140516)"
2022,Noviembre,Honduras,340,1,2,3,"(4.452882,-75.766298)"
2017,Julio,Chipre,196,5,8,13,"(4.697144,-74.140516)"
2017,Junio,Trinidad y Tobago,780,0,1,1,"(7.818934,-72.453226)"
2019,Febrero,Ecuador,218,41,40,82,"(10.408582,-75.538003)"
2017,Marzo,Paraguay,600,11,8,19,"(3.541112,-76.384584)"
2023,Febrero,Guinea,324,0,1,1,"(10.445761,-75.516429)"
2019,Julio,Ecuador,218,27,22,49,"(1.813928,-78.763924)"
2015,Octubre,Croacia,191,0,1,1,"(3.893038,-77.067921)"
2013,Agosto,Paraguay,600,22,63,85,"(6.171601,-75.427454)"
2022,Octubre,Uruguay,858,4,5,9,"(10.886611,-74.776708)"
2013,Junio,Filipinas,608,0,7,7,"(11.247723,-74.213989)"
2022,Noviembre,Desconocido,99999,0,1,1,"(7.927209,-72.507910)"
2012,Mayo,Australia,36,3,12,15,"(3.541112,-76.384584)"
2022,Enero,Haití,332,11,10,21,"(4.697144,-74.140516)"
2012,Agosto,Ecuador,218,1,3,4,"(10.886611,-74.776708)"
2012,Enero,Federación de Rusia,643,1,0,1,"(10.408582,-75.538003)"
2021,Septiembre,Estados Unidos de América,840,149,206,355,"(4.452882,-75.766298)"
2014,Mayo,Honduras,340,1,2,3,"(0.814836,-77.662532)"
2018,Abril,Finlandia,246,4,5,9,"(0.814836,-77.662532)"
2020,Diciembre,Estados Unidos de América,840,0,1,1,"(12.586067,-81.702563)"
2016,Mayo,Dinamarca,208,3,6,9,"(3.541112,-76.384584)"
2016,Mayo,Perú,604,1,1,2,"(7.927209,-72.507910)"
2022,Enero,Arabia Saudita,682,0,1,1,"(10.886611,-74.776708)"
2019,Diciembre,Polonia,616,0,1,1,"(12.586067,-81.702563)"
2012,Junio,Jamaica,388,1,0,1,"(7.927209,-72.507910)"
2015,Septiembre,Bután,64,1,1,2,"(4.697144,-74.140516)"
2014,Febrero,Finlandia,246,2,0,2,"(10.408582,-75.538003)"
2019,Febrero,Chipre,196,2,5,7,"(4.697144,-74.140516)"
2020,Febrero,España,724,1,1,2,"(11.528919,-72.919681)"
2022,Septiembre,Italia,380,39,37,76,"(7.916725,-72.462544)"
2016,Agosto,Dominica,212,0,2,2,"(6.171601,-75.427454)"
2020,Marzo,Guyana,328,4,11,15,"(4.697144,-74.140516)"
2016,Septiembre,República Dominicana,214,503,651,1154,"(4.697144,-74.140516)"
2012,Diciembre,Honduras,340,0,1,1,"(10.408582,-75.538003)"
2017,Marzo,Portugal,620,5,5,10,"(0.814836,-77.662532)"
2022,Diciembre,Costa Rica,188,1,4,5,"(7.128456,-73.183637)"
2022,Octubre,Federación de Rusia,643,38,32,70,"(6.171601,-75.427454)"
2021,Junio,Brasil,76,73,104,177,"(6.171601,-75.427454)"
2017,Febrero,Guatemala,320,26,30,56,"(12.586067,-81.702563)"
2022,Diciembre,México,484,7,7,14,"(11.360009,-72.129330)"
2019,Marzo,Honduras,340,5,5,10,"(4.815061,-75.736532)"
2015,Febrero,Alemania,276,6,8,14,"(12.586067,-81.702563)"
2016,Mayo,Noruega,578,4,0,4,"(0.814836,-77.662532)"
2017,Junio,Reino Unido de Gran Bretaña e Irlanda del Norte,826,1117,1940,3057,"(4.697144,-74.140516)"
2017,Mayo,Refugiado,99999,2,0,2,"(10.445761,-75.516429)"
2012,Septiembre,Mauricio,480,0,1,1,"(4.697144,-74.140516)"
2015,Agosto,India,356,2,30,32,"(3.541112,-76.384584)"
2012,Abril,China,156,147,509,656,"(4.697144,-74.140516)"
2017,Julio,Rumania,642,0,1,1,"(10.408582,-75.538003)"
2016,Junio,Portugal,620,13,29,42,"(6.171601,-75.427454)"
2020,Marzo,Francia,250,0,2,2,"(11.247723,-74.213989)"
2014,Enero,Reino Unido de Gran Bretaña e Irlanda del Norte,826,1,4,5,"(12.586067,-81.702563)"
2022,Septiembre,Portugal,620,2,4,6,"(4.815061,-75.736532)"
2021,Julio,Bolivia,68,0,3,3,"(10.886611,-74.776708)"
2021,Marzo,Georgia,268,0,3,3,"(10.971302,-74.765397)"
2017,Abril,India,356,0,6,6,"(10.886611,-74.776708)"
2016,Diciembre,Camerún,120,1,2,3,"(4.697144,-74.140516)"
2014,Abril,Perú,604,140,305,445,"(0.814836,-77.662532)"
2021,Noviembre,Mongolia,496,0,1,1,"(4.697144,-74.140516)"
2014,Agosto,Palestina,99999,2,8,10,"(4.697144,-74.140516)"
2021,Junio,Costa Rica,188,13,19,32,"(10.445761,-75.516429)"
2018,Mayo,Perú,604,23,39,62,"(-4.223468,-69.945098)"
2023,Junio,Eslovenia,705,0,2,2,"(10.445761,-75.516429)"
2018,Mayo,Chile,152,133,459,592,"(6.171601,-75.427454)"
2017,Agosto,Paraguay,600,0,1,1,"(7.088729,-70.740253)"
2018,Febrero,Perú,604,3951,4509,8460,"(4.697144,-74.140516)"
2021,Septiembre,Irán,364,0,3,3,"(6.171601,-75.427454)"
2015,Febrero,Letonia,428,9,9,18,"(4.697144,-74.140516)"
2012,Marzo,Belice,84,0,1,1,"(11.360009,-72.129330)"
2017,Julio,Federación de Rusia,643,0,1,1,"(9.402978,-75.681599)"
2012,Febrero,Austria,40,3,5,8,"(8.635765,-77.346578)"
2022,Enero,Sri Lanka,144,0,1,1,"(10.445761,-75.516429)"
2019,Marzo,Uruguay,858,1,2,3,"(11.360009,-72.129330)"
2021,Septiembre,China,156,0,2,2,"(7.818934,-72.453226)"
2022,Febrero,Tailandia,764,5,4,9,"(4.697144,-74.140516)"
2013,Noviembre,México,484,4,8,12,"(7.128456,-73.183637)"
2017,Junio,Argentina,32,6,12,18,"(11.360009,-72.129330)"
2023,Junio,Canadá,124,0,1,1,"(7.927209,-72.507910)"
2013,Septiembre,Surinam,740,0,1,1,"(3.541112,-76.384584)"
2015,Enero,Serbia,688,0,1,1,"(11.360009,-72.129330)"
2016,Julio,Indonesia,360,5,4,9,"(10.445761,-75.516429)"
2013,Noviembre,Costa Rica,188,0,2,2,"(0.814836,-77.662532)"
2012,Diciembre,Honduras,340,26,40,66,"(6.171601,-75.427454)"
2012,Septiembre,Sudáfrica,710,0,3,3,"(10.445761,-75.516429)"
2022,Junio,Francia,250,1,0,1,"(4.452882,-75.766298)"
2012,Marzo,Noruega,578,0,3,3,"(8.635765,-77.346578)"
2013,Junio,Guatemala,320,73,129,202,"(6.171601,-75.427454)"
2016,Febrero,Trinidad y Tobago,780,0,6,6,"(6.171601,-75.427454)"
2014,Diciembre,Uruguay,858,29,25,54,"(12.586067,-81.702563)"
2015,Agosto,Reino Unido de Gran Bretaña e Irlanda del Norte,826,72,128,200,"(6.171601,-75.427454)"
2018,Octubre,Países Bajos,528,0,1,1,"(4.697144,-74.140516)"
2019,Junio,Países Bajos,528,1,1,2,"(7.927209,-72.507910)"
2023,Junio,Madagascar,450,1,0,1,"(6.171601,-75.427454)"
2014,Noviembre,Rumania,642,1,0,1,"(3.541112,-76.384584)"
2012,Octubre,Suecia,752,3,4,7,"(7.818934,-72.453226)"
2019,Diciembre,Trinidad y Tobago,780,13,30,43,"(10.445761,-75.516429)"
2023,Marzo,México,484,9,26,35,"(7.818934,-72.453226)"
2019,Diciembre,Guinea,324,0,1,1,"(6.171601,-75.427454)"
2022,Noviembre,Reino Unido de Gran Bretaña e Irlanda del Norte,826,162,348,510,"(6.171601,-75.427454)"
2015,Abril,Estados Unidos de América,840,1,9,10,"(11.360009,-72.129330)"
2023,Marzo,Alemania,276,2,0,2,"(7.128456,-73.183637)"
2019,Enero,India,356,2,17,19,"(3.541112,-76.384584)"
2018,Mayo,Italia,380,11,33,44,"(10.886611,-74.776708)"
2014,Diciembre,Zambia,894,0,1,1,"(4.697144,-74.140516)"
2013,Enero,Paraguay,600,4,9,13,"(10.445761,-75.516429)"
2020,Febrero,Japón,392,8,17,25,"(10.445761,-75.516429)"
2016,Marzo,Marruecos,504,2,12,14,"(4.697144,-74.140516)"
2019,Febrero,Rumania,642,0,2,2,"(11.247723,-74.213989)"
2012,Diciembre,Bermudas/Territorio Británico de Ultramar,60,0,1,1,"(10.886611,-74.776708)"
2023,Febrero,Bolivia,68,30,22,52,"(3.541112,-76.384584)"
2012,Junio,Uruguay,858,84,71,155,"(10.445761,-75.516429)"
2012,Marzo,Ucrania,804,1,0,1,"(11.360009,-72.129330)"
2023,Febrero,Letonia,428,0,1,1,"(10.408582,-75.538003)"
2015,Enero,Perú,604,0,1,1,"(1.813928,-78.763924)"
2023,Abril,Honduras,340,0,1,1,"(4.452882,-75.766298)"
2012,Octubre,Italia,380,0,4,4,"(7.927209,-72.507910)"
2012,Febrero,Uruguay,858,94,73,167,"(12.586067,-81.702563)"
2016,Mayo,Brasil,76,910,590,1500,"(10.408582,-75.538003)"
2013,Mayo,Venezuela,862,52,67,119,"(7.088729,-70.740253)"
2016,Mayo,República de Corea,410,3,2,5,"(-4.197703,-69.941278)"
2015,Junio,Alemania,276,77,94,171,"(0.814836,-77.662532)"
2014,Junio,Reino Unido de Gran Bretaña e Irlanda del Norte,826,6,13,19,"(8.635765,-77.346578)"
2017,Mayo,Brasil,76,657,460,1117,"(10.408582,-75.538003)"
2022,Diciembre,Georgia,268,6,26,32,"(6.171601,-75.427454)"
2013,Febrero,Israel,376,73,369,442,"(4.697144,-74.140516)"
2016,Diciembre,Guatemala,320,1,1,2,"(7.128456,-73.183637)"
2017,Octubre,España,724,2,4,6,"(7.128456,-73.183637)"
2019,Febrero,Egipto,818,1,2,3,"(0.814836,-77.662532)"
2022,Noviembre,Kenia,404,0,1,1,"(0.25129,-76.875963)"
2014,Abril,Honduras,340,152,233,385,"(4.697144,-74.140516)"
2018,Enero,Japón,392,4,6,10,"(3.541112,-76.384584)"
2012,Octubre,México,484,10,21,31,"(0.814836,-77.662532)"
2021,Diciembre,Serbia,688,1,2,3,"(3.541112,-76.384584)"
2019,Noviembre,El Salvador,222,1,5,6,"(10.408582,-75.538003)"
2022,Marzo,Sri Lanka,144,1,0,1,"(10.445761,-75.516429)"
2015,Septiembre,Bolivia,68,2,1,3,"(4.815061,-75.736532)"
2018,Diciembre,República de Corea,410,0,1,1,"(7.128456,-73.183637)"
2019,Mayo,China,156,13,30,43,"(3.541112,-76.384584)"
2022,Noviembre,Portugal,620,17,25,42,"(7.818934,-72.453226)"
2020,Enero,Barbados,52,5,2,7,"(4.697144,-74.140516)"
2016,Julio,Alemania,276,123,133,256,"(0.814836,-77.662532)"
2022,Marzo,Letonia,428,19,20,39,"(4.697144,-74.140516)"
2014,Abril,República Dominicana,214,30,64,94,"(6.171601,-75.427454)"
2016,Junio,Argentina,32,56,125,181,"(3.541112,-76.384584)"
2020,Diciembre,Francia,250,17,46,63,"(3.541112,-76.384584)"
2014,Febrero,Guatemala,320,1,0,1,"(8.635765,-77.346578)"
2018,Diciembre,India,356,0,2,2,"(3.893038,-77.067921)"
2012,Noviembre,Paraguay,600,122,117,239,"(4.697144,-74.140516)"
2023,Febrero,Trinidad y Tobago,780,12,29,41,"(4.697144,-74.140516)"
2017,Abril,Islandia,352,8,14,22,"(4.697144,-74.140516)"
2018,Septiembre,República Dominicana,214,0,2,2,"(11.360009,-72.129330)"
2017,Diciembre,Japón,392,233,448,681,"(4.697144,-74.140516)"
2012,Marzo,Argentina,32,73,134,207,"(0.814836,-77.662532)"
2018,Septiembre,República Dominicana,214,15,52,67,"(10.886611,-74.776708)"
2014,Diciembre,Países Bajos,528,0,1,1,"(6.171601,-75.427454)"
2018,Febrero,Suecia,752,0,2,2,"(-4.197703,-69.941278)"
2017,Noviembre,Eslovaquia,703,3,4,7,"(6.171601,-75.427454)"
2022,Abril,República de Irlanda,372,1,0,1,"(-4.197703,-69.941278)"
2017,Diciembre,Polonia,616,9,20,29,"(10.445761,-75.516429)"
2016,Enero,Uruguay,858,2,1,3,"(10.408582,-75.538003)"
2017,Noviembre,Perú,604,0,1,1,"(8.635765,-77.346578)"
2014,Abril,Francia,250,43,36,79,"(10.408582,-75.538003)"
2013,Septiembre,Ecuador,218,46,174,220,"(10.445761,-75.516429)"
2014,Mayo,Islas Caimán/Territorio Británico de Ultramar,136,0,1,1,"(3.541112,-76.384584)"
2019,Abril,Italia,380,1,2,3,"(11.247723,-74.213989)"
2023,Marzo,Trinidad y Tobago,780,0,3,3,"(10.886611,-74.776708)"
2017,Marzo,Argentina,32,2,5,7,"(-4.223468,-69.945098)"
2017,Marzo,Sudáfrica,710,3,0,3,"(-4.197703,-69.941278)"
2022,Junio,Estados Unidos de América,840,0,3,3,"(6.17134,-75.427194)"
2017,Enero,Polonia,616,0,1,1,"(7.128456,-73.183637)"
2021,Diciembre,Canadá,124,3,6,9,"(7.927209,-72.507910)"
2022,Mayo,Portugal,620,1,0,1,"(10.408582,-75.538003)"
2016,Agosto,Turquía,792,1,1,2,"(3.541112,-76.384584)"
2012,Octubre,República Dominicana,214,32,55,87,"(6.171601,-75.427454)"
2023,Mayo,México,484,11,20,31,"(7.818934,-72.453226)"
2022,Mayo,Federación de Rusia,643,0,3,3,"(10.886611,-74.776708)"
2015,Abril,Kazajistán,398,1,0,1,"(10.445761,-75.516429)"
2015,Enero,Eslovaquia,703,0,1,1,"(10.445761,-75.516429)"
2022,Abril,Canadá,124,0,2,2,"(7.128456,-73.183637)"
2018,Agosto,Suiza,756,1,0,1,"(12.5744111,-81.703935)"
2018,Diciembre,India,356,130,419,549,"(4.697144,-74.140516)"
2019,Julio,Perú,604,2,14,16,"(0.25129,-76.875963)"
2014,Abril,Reino Unido de Gran Bretaña e Irlanda del Norte,826,2,2,4,"(13.3387613,-81.372937)"
2012,Marzo,Argentina,32,0,1,1,"(7.128456,-73.183637)"
2019,Agosto,Mongolia,496,1,0,1,"(4.697144,-74.140516)"
2019,Julio,Australia,36,2,0,2,"(12.586067,-81.702563)"
2013,Julio,Australia,36,15,62,77,"(6.171601,-75.427454)"
2013,Junio,Ecuador,218,11,12,23,"(11.360009,-72.129330)"
2019,Febrero,Grecia,300,0,1,1,"(3.541112,-76.384584)"
2014,Julio,Irán,364,1,0,1,"(10.445761,-75.516429)"
2013,Enero,Venezuela,862,1,1,2,"(4.452882,-75.766298)"
2017,Enero,Líbano,422,1,0,1,"(10.886611,-74.776708)"
2018,Noviembre,República de Belarús,112,8,7,15,"(4.697144,-74.140516)"
2015,Agosto,Bélgica,56,2,3,5,"(6.185799,-67.483929)"
2019,Febrero,Uruguay,858,0,1,1,"(8.36068,-72.409396)"
2014,Febrero,Sudáfrica,710,23,63,86,"(4.697144,-74.140516)"
2023,Abril,Surinam,740,0,1,1,"(10.445761,-75.516429)"
2021,Diciembre,Croacia,191,0,2,2,"(10.886611,-74.776708)"
2017,Abril,Noruega,578,0,1,1,"(0.25129,-76.875963)"
2023,Abril,Barbados,52,10,10,20,"(4.697144,-74.140516)"
2022,Junio,Suiza,756,1,1,2,"(12.5744111,-81.703935)"
2022,Julio,Australia,36,47,135,182,"(6.171601,-75.427454)"
2019,Mayo,Australia,36,18,15,33,"(0.814836,-77.662532)"
2017,Enero,Reino Unido de Gran Bretaña e Irlanda del Norte,826,11,16,27,"(11.247723,-74.213989)"
2023,Febrero,Brasil,76,199,194,393,"(-4.197703,-69.941278)"
2016,Julio,Grecia,300,1,6,7,"(10.445761,-75.516429)"
2015,Marzo,Paraguay,600,0,1,1,"(4.815061,-75.736532)"
2018,Octubre,San Cristóbal y Nevis,659,1,1,2,"(4.697144,-74.140516)"
2013,Marzo,Canadá,124,2,7,9,"(13.3387613,-81.372937)"
2023,Marzo,Malasia,458,0,1,1,"(3.541112,-76.384584)"
2012,Mayo,Perú,604,2,2,4,"(7.128456,-73.183637)"
2017,Noviembre,República Checa,203,1,1,2,"(12.586067,-81.702563)"
2016,Octubre,Grecia,300,0,1,1,"(7.818934,-72.453226)"
2020,Febrero,Bahamas,44,1,6,7,"(6.171601,-75.427454)"
2018,Mayo,Honduras,340,0,1,1,"(11.360009,-72.129330)"
2012,Enero,Trinidad y Tobago,780,0,1,1,"(4.815061,-75.736532)"
2023,Junio,Zimbabue,716,2,3,5,"(4.697144,-74.140516)"
2021,Marzo,Polonia,616,1,1,2,"(10.971302,-74.765397)"
2023,Enero,Barbados,52,1,0,1,"(10.445761,-75.516429)"
2016,Julio,India,356,0,7,7,"(11.247723,-74.213989)"
2022,Noviembre,Italia,380,8,6,14,"(0.814836,-77.662532)"
2019,Marzo,Líbano,422,15,35,50,"(4.697144,-74.140516)"
2021,Junio,Costa Rica,188,0,7,7,"(10.408582,-75.538003)"
2014,Julio,India,356,6,26,32,"(6.171601,-75.427454)"
2023,Marzo,El Salvador,222,4,3,7,"(4.815061,-75.736532)"
2017,Agosto,Italia,380,1520,2637,4157,"(4.697144,-74.140516)"
2012,Diciembre,Paraguay,600,11,7,18,"(6.171601,-75.427454)"
2013,Octubre,Puerto Rico/Territorio de Estados Unidos,630,0,2,2,"(10.886611,-74.776708)"
2017,Octubre,Chile,152,0,1,1,"(8.635765,-77.346578)"
2014,Marzo,Países Bajos,528,4,4,8,"(8.635765,-77.346578)"
2016,Diciembre,India,356,5,6,11,"(0.814836,-77.662532)"
2021,Agosto,Estados Unidos de América,840,9,10,19,"(-4.197703,-69.941278)"
2016,Agosto,Portugal,620,0,1,1,"(6.185799,-67.483929)"
2013,Septiembre,Cuba,192,0,1,1,"(4.815061,-75.736532)"
2014,Diciembre,Paraguay,600,1,3,4,"(10.886611,-74.776708)"
2018,Julio,Países Bajos,528,4,7,11,"(4.815061,-75.736532)"
2018,Julio,Estados Unidos de América,840,10,15,25,"(7.818934,-72.453226)"
2021,Octubre,India,356,1,12,13,"(10.886611,-74.776708)"
2021,Noviembre,Perú,604,9,7,16,"(7.128456,-73.183637)"
2021,Diciembre,Serbia,688,0,1,1,"(10.408582,-75.538003)"
2022,Diciembre,República Árabe Siria,760,0,12,12,"(10.408582,-75.538003)"
2018,Abril,Italia,380,5,26,31,"(10.886611,-74.776708)"
2014,Octubre,Cuba,192,0,1,1,"(12.5744111,-81.703935)"
2021,Julio,Honduras,340,142,144,286,"(4.697144,-74.140516)"
2018,Marzo,Myanmar,104,1,2,3,"(4.697144,-74.140516)"
2016,Enero,Estados Unidos de América,840,78,99,177,"(10.408582,-75.538003)"
2020,Diciembre,Ecuador,218,11,12,23,"(10.886611,-74.776708)"
2018,Abril,Bélgica,56,34,51,85,"(10.445761,-75.516429)"
2023,Enero,Canadá,124,2,6,8,"(4.452882,-75.766298)"
2016,Agosto,Israel,376,0,1,1,"(4.452882,-75.766298)"
2012,Abril,Burkina Faso,854,0,1,1,"(4.697144,-74.140516)"
2020,Febrero,Francia,250,121,169,290,"(0.814836,-77.662532)"
2012,Diciembre,Polonia,616,2,1,3,"(10.886611,-74.776708)"
2016,Marzo,Bolivia,68,43,44,87,"(10.445761,-75.516429)"
2012,Junio,Brunei Darussalam,96,1,0,1,"(4.697144,-74.140516)"
2019,Febrero,Canadá,124,1,4,5,"(7.818934,-72.453226)"
2015,Enero,Uruguay,858,5,10,15,"(0.814836,-77.662532)"
2014,Agosto,India,356,0,4,4,"(10.886611,-74.776708)"
2017,Junio,Canadá,124,3,6,9,"(-4.197703,-69.941278)"
2017,Febrero,Nigeria,566,0,2,2,"(10.445761,-75.516429)"
2018,Junio,Uruguay,858,29,16,45,"(10.408582,-75.538003)"
2014,Diciembre,Mónaco,492,1,1,2,"(4.697144,-74.140516)"
2014,Marzo,Kenia,404,1,1,2,"(3.541112,-76.384584)"
2012,Noviembre,Dinamarca,208,6,9,15,"(10.445761,-75.516429)"
2018,Junio,México,484,1,1,2,"(8.635765,-77.346578)"
2023,Mayo,Túnez,788,7,7,14,"(4.697144,-74.140516)"
2017,Junio,Portugal,620,6,11,17,"(10.445761,-75.516429)"
2015,Mayo,Singapur,702,0,1,1,"(0.814836,-77.662532)"
2014,Abril,India,356,0,9,9,"(10.408582,-75.538003)"
2018,Abril,Pakistán,586,3,13,16,"(4.697144,-74.140516)"
2014,Agosto,Guyana,328,0,1,1,"(12.586067,-81.702563)"
2016,Marzo,Paraguay,600,87,59,146,"(12.586067,-81.702563)"
2023,Junio,Antigua y Barbuda,28,11,8,19,"(4.697144,-74.140516)"
2016,Abril,Panamá,591,39,82,121,"(10.886611,-74.776708)"
2021,Octubre,Guatemala,320,57,74,131,"(10.445761,-75.516429)"
2018,Junio,Paraguay,600,63,45,108,"(10.445761,-75.516429)"
2016,Noviembre,Turquía,792,1,0,1,"(11.360009,-72.129330)"
2018,Diciembre,Italia,380,1,7,8,"(4.815061,-75.736532)"
2012,Octubre,Suecia,752,1,0,1,"(10.408582,-75.538003)"
2022,Julio,Honduras,340,2,3,5,"(4.452882,-75.766298)"
2021,Enero,Albania,8,1,15,16,"(4.697144,-74.140516)"
2019,Agosto,Alemania,276,4,11,15,"(4.815061,-75.736532)"
2012,Julio,Australia,36,0,1,1,"(13.3387613,-81.372937)"
2021,Junio,Iraq,368,0,1,1,"(4.697144,-74.140516)"
2015,Marzo,Sudáfrica,710,2,4,6,"(0.814836,-77.662532)"
2022,Noviembre,Panamá,591,11,13,24,"(12.586067,-81.702563)"
2021,Julio,Ucrania,804,0,9,9,"(10.408582,-75.538003)"
2015,Febrero,Panamá,591,0,1,1,"(7.088729,-70.740253)"
2017,Marzo,Austria,40,4,2,6,"(-4.197703,-69.941278)"
2012,Marzo,Nueva Zelanda,554,1,1,2,"(7.818934,-72.453226)"
2023,Marzo,Líbano,422,0,1,1,"(4.815061,-75.736532)"
2019,Marzo,Francia,250,14,22,36,"(10.408582,-75.538003)"
2013,Diciembre,Chile,152,11,24,35,"(7.818934,-72.453226)"
2012,Junio,República Democrática del Congo,180,2,5,7,"(4.697144,-74.140516)"
2013,Diciembre,Alemania,276,2,2,4,"(7.128456,-73.183637)"
2013,Septiembre,Panamá,591,1,2,3,"(11.247723,-74.213989)"
2017,Septiembre,Egipto,818,0,6,6,"(10.408582,-75.538003)"
2012,Junio,República Checa,203,0,2,2,"(10.408582,-75.538003)"
2013,Septiembre,República CentroÁfricana,140,0,1,1,"(4.697144,-74.140516)"
2022,Noviembre,Guatemala,320,15,19,34,"(10.886611,-74.776708)"
2022,Octubre,Taiwán,158,48,50,98,"(4.697144,-74.140516)"
2017,Agosto,Cuba,192,16,21,37,"(10.886611,-74.776708)"
2017,Julio,Canadá,124,2,3,5,"(12.586067,-81.702563)"
2019,Octubre,Sudáfrica,710,1,1,2,"(3.541112,-76.384584)"
2016,Febrero,India,356,0,7,7,"(11.247723,-74.213989)"
2014,Agosto,Zambia,894,1,2,3,"(3.541112,-76.384584)"
2022,Mayo,Portugal,620,1,3,4,"(0.814836,-77.662532)"
2017,Abril,Rumania,642,2,1,3,"(7.818934,-72.453226)"
2012,Octubre,Luxemburgo,442,2,13,15,"(4.697144,-74.140516)"
2022,Julio,Australia,36,2,2,4,"(4.452882,-75.766298)"
2014,Abril,Venezuela,862,1,0,1,"(11.528919,-72.919681)"
2019,Abril,Cuba,192,0,1,1,"(7.818934,-72.453226)"
2019,Marzo,Canadá,124,0,1,1,"(7.818934,-72.453226)"
2014,Septiembre,Ecuador,218,1823,2932,4755,"(4.697144,-74.140516)"
2012,Abril,Serbia,688,0,1,1,"(6.171601,-75.427454)"
2018,Junio,El Salvador,222,39,45,84,"(10.445761,-75.516429)"
2014,Septiembre,Honduras,340,1,0,1,"(7.128456,-73.183637)"
2013,Febrero,República Dominicana,214,10,34,44,"(10.886611,-74.776708)"
2017,Abril,Japón,392,10,12,22,"(0.814836,-77.662532)"
2022,Octubre,Vietnam,704,1,1,2,"(10.445761,-75.516429)"
2012,Octubre,Argelia,12,1,2,3,"(4.697144,-74.140516)"
2012,Julio,Isla Johnston,99999,5,0,5,"(4.697144,-74.140516)"
2018,Diciembre,Bolivia,68,1084,983,2073,"(4.697144,-74.140516)"
2014,Abril,China,156,4,4,8,"(0.814836,-77.662532)"
2012,Septiembre,Alemania,276,56,53,109,"(0.814836,-77.662532)"
2016,Agosto,Estados Unidos de América,840,2811,6101,8912,"(6.171601,-75.427454)"
2018,Septiembre,Uruguay,858,12,9,21,"(10.886611,-74.776708)"
2021,Junio,República de Corea,410,0,2,2,"(10.971302,-74.765397)"
2022,Junio,Portugal,620,1,0,1,"(10.408582,-75.538003)"
2022,Mayo,Estados Unidos de América,840,9,12,21,"(11.360009,-72.129330)"
2023,Abril,Federación de Rusia,643,0,2,2,"(7.818934,-72.453226)"
2022,Marzo,Panamá,591,66,89,155,"(4.815061,-75.736532)"
2021,Agosto,España,724,1,0,1,"(6.185799,-67.483929)"
2019,Marzo,Jordania,400,3,15,18,"(4.697144,-74.140516)"
2022,Septiembre,Alemania,276,32,43,75,"(3.541112,-76.384584)"
2013,Agosto,Indonesia,360,0,1,1,"(10.445761,-75.516429)"
2020,Diciembre,Ecuador,218,1000,1220,2220,"(4.697144,-74.140516)"
2013,Agosto,Honduras,340,2,14,16,"(12.5744111,-81.703935)"
2017,Mayo,Vietnam,704,0,1,1,"(6.171601,-75.427454)"
2022,Diciembre,México,484,84,102,186,"(10.886611,-74.776708)"
2014,Mayo,Argentina,32,2656,4294,6950,"(4.697144,-74.140516)"
2012,Julio,Nueva Zelanda,554,40,73,113,"(4.697144,-74.140516)"
2019,Abril,República de Irlanda,372,0,1,1,"(12.5744111,-81.703935)"
2012,Junio,Suiza,756,8,10,18,"(10.445761,-75.516429)"
2014,Noviembre,Cuba,192,25,41,66,"(3.541112,-76.384584)"
2023,Junio,Perú,604,1128,650,1778,"(10.445761,-75.516429)"
2012,Mayo,Honduras,340,4,10,14,"(10.886611,-74.776708)"
2013,Marzo,Guatemala,320,0,1,1,"(11.360009,-72.129330)"
2015,Enero,Nueva Zelanda,554,2,14,16,"(0.814836,-77.662532)"
2012,Marzo,Estados Unidos de América,840,109,150,259,"(4.452882,-75.766298)"
2013,Mayo,Canadá,124,1,6,7,"(12.586067,-81.702563)"
2017,Abril,Tailandia,764,2,0,2,"(6.171601,-75.427454)"
2017,Mayo,Nicaragua,558,3,1,4,"(10.886611,-74.776708)"
2015,Diciembre,Estados Unidos de América,840,5,22,27,"(8.635765,-77.346578)"
2017,Junio,Israel,376,88,145,233,"(0.814836,-77.662532)"
2017,Agosto,Uganda,800,0,1,1,"(4.697144,-74.140516)"
2021,Junio,Eslovaquia,703,1,2,3,"(6.171601,-75.427454)"
2015,Mayo,Sri Lanka,144,0,1,1,"(10.886611,-74.776708)"
2023,Enero,Ecuador,218,0,16,16,"(10.408582,-75.538003)"
2022,Marzo,España,724,43,81,124,"(7.818934,-72.453226)"
2012,Febrero,Guyana,328,2,7,9,"(4.697144,-74.140516)"
2021,Julio,Canadá,124,0,2,2,"(11.117806,-74.232622)"
2015,Octubre,Ucrania,804,0,1,1,"(8.635765,-77.346578)"
2013,Octubre,Austria,40,0,4,4,"(10.408582,-75.538003)"
2013,Enero,Luxemburgo,442,1,1,2,"(6.171601,-75.427454)"
2016,Julio,Suiza,756,32,45,77,"(0.814836,-77.662532)"
2014,Junio,Nigeria,566,0,2,2,"(10.445761,-75.516429)"
2016,Julio,Lituania,440,1,0,1,"(12.586067,-81.702563)"
2023,Junio,Italia,380,0,1,1,"(4.452882,-75.766298)"
2019,Marzo,España,724,4,2,6,"(0.25129,-76.875963)"
2019,Abril,Islandia,352,3,1,4,"(10.445761,-75.516429)"
2012,Abril,Ecuador,218,851,1289,2140,"(0.814836,-77.662532)"
2018,Noviembre,Reino Unido de Gran Bretaña e Irlanda del Norte,826,0,2,2,"(7.818934,-72.453226)"
2020,Febrero,España,724,53,53,106,"(0.814836,-77.662532)"
2018,Febrero,Panamá,591,0,1,1,"(6.228046,-77.404104)"
2014,Junio,Nueva Zelanda,554,33,67,100,"(4.697144,-74.140516)"
2023,Abril,Italia,380,798,1501,2299,"(4.697144,-74.140516)"
2012,Junio,Rumania,642,0,4,4,"(10.408582,-75.538003)"
2021,Septiembre,Estados Unidos de América,840,346,576,922,"(4.815061,-75.736532)"
2022,Marzo,Estados Unidos de América,840,6787,9552,16339,"(10.445761,-75.516429)"
2016,Mayo,República de Irlanda,372,0,1,1,"(7.818934,-72.453226)"
2012,Enero,Brasil,76,0,1,1,"(8.635765,-77.346578)"
2017,Febrero,Australia,36,2,3,5,"(0.25129,-76.875963)"
2017,Julio,Polonia,616,1,10,11,"(10.408582,-75.538003)"
2020,Marzo,India,356,0,1,1,"(7.128456,-73.183637)"
2022,Junio,Omán,512,0,1,1,"(10.886611,-74.776708)"
2014,Junio,Eslovenia,705,1,0,1,"(-4.197703,-69.941278)"
2022,Marzo,Costa Rica,188,1,1,2,"(7.818934,-72.453226)"
2013,Agosto,Guatemala,320,1,1,2,"(7.128456,-73.183637)"
2018,Agosto,Portugal,620,0,1,1,"(12.586067,-81.702563)"
2014,Mayo,Nueva Zelanda,554,38,77,115,"(4.697144,-74.140516)"
2012,Septiembre,Nueva Zelanda,554,2,5,7,"(3.541112,-76.384584)"
2022,Julio,Bélgica,56,0,1,1,"(7.128456,-73.183637)"
2015,Marzo,Países Bajos,528,3,4,7,"(-4.197703,-69.941278)"
2019,Noviembre,Mónaco,492,0,1,1,"(4.697144,-74.140516)"
2020,Septiembre,República Dominicana,214,9,8,17,"(10.445761,-75.516429)"
2015,Julio,Malasia,458,2,1,3,"(10.445761,-75.516429)"
2016,Enero,Trinidad y Tobago,780,16,38,54,"(4.697144,-74.140516)"
2021,Septiembre,Cuba,192,11,34,45,"(6.171601,-75.427454)"
2016,Junio,India,356,1,3,4,"(10.971302,-74.765397)"
2016,Mayo,Argentina,32,369,245,614,"(10.445761,-75.516429)"
2021,Abril,Ecuador,218,19,31,50,"(3.541112,-76.384584)"
2013,Febrero,Grecia,300,1,2,3,"(10.445761,-75.516429)"
2016,Diciembre,Hungría,348,8,5,13,"(10.445761,-75.516429)"
2013,Octubre,Mónaco,492,2,3,5,"(4.697144,-74.140516)"
2023,Marzo,Italia,380,0,9,9,"(3.893038,-77.067921)"
2017,Diciembre,Venezuela,862,10,10,20,"(12.586067,-81.702563)"
2018,Noviembre,Federación de Rusia,643,2,13,15,"(10.408582,-75.538003)"
2022,Marzo,España,724,0,1,1,"(6.228046,-77.404104)"
2018,Febrero,República de Irlanda,372,3,4,7,"(3.541112,-76.384584)"
2022,Agosto,Sri Lanka,144,0,2,2,"(4.697144,-74.140516)"
2017,Julio,Perú,604,0,2,2,"(7.128456,-73.183637)"
2016,Mayo,Bolivia,68,451,514,965,"(4.697144,-74.140516)"
2015,Diciembre,El Salvador,222,18,13,31,"(10.445761,-75.516429)"
2017,Febrero,Reino Unido de Gran Bretaña e Irlanda del Norte,826,17,23,40,"(-4.197703,-69.941278)"
2019,Julio,Bolivia,68,0,1,1,"(4.452882,-75.766298)"
2013,Junio,Nueva Zelanda,554,1,4,5,"(4.697144,-74.140516)"
2013,Enero,Nueva Zelanda,554,7,12,19,"(0.814836,-77.662532)"
2016,Enero,Japón,392,0,1,1,"(8.635765,-77.346578)"
2015,Noviembre,Cuba,192,1,1,2,"(0.25129,-76.875963)"
2017,Junio,Costa Rica,188,2,4,6,"(7.818934,-72.453226)"
2021,Abril,España,724,0,3,3,"(4.815061,-75.736532)"
2016,Diciembre,República Dominicana,214,1,2,3,"(10.408582,-75.538003)"
2021,Agosto,Bahamas,44,3,5,8,"(10.445761,-75.516429)"
2021,Octubre,Estados Unidos de América,840,0,6,6,"(-4.197703,-69.941278)"
2023,Abril,Reino Unido de Gran Bretaña e Irlanda del Norte,826,1,0,1,"(13.3387613,-81.372937)"
2017,Septiembre,Malta,470,0,2,2,"(6.171601,-75.427454)"
2012,Junio,Reino Unido de Gran Bretaña e Irlanda del Norte,826,1,0,1,"(0.814836,-77.662532)"
2020,Enero,Suecia,752,36,62,98,"(10.445761,-75.516429)"
2022,Septiembre,México,484,31,42,73,"(4.815061,-75.736532)"
2023,Junio,Taiwán,158,1,2,3,"(10.445761,-75.516429)"
2012,Abril,Uruguay,858,65,55,120,"(12.586067,-81.702563)"
2023,Febrero,Paraguay,600,1,1,2,"(7.818934,-72.453226)"
2019,Octubre,República de Corea,410,0,1,1,"(10.971302,-74.765397)"
2012,Marzo,Brasil,76,68,65,133,"(10.445761,-75.516429)"
2015,Febrero,Dinamarca,208,0,1,1,"(4.815061,-75.736532)"
2013,Enero,Japón,392,7,36,43,"(6.171601,-75.427454)"
2022,Febrero,Líbano,422,1,1,2,"(11.360009,-72.129330)"
2023,Mayo,Austria,40,1,1,2,"(10.408582,-75.538003)"
2019,Noviembre,Islas Turcas y Caicos/Territorio Británico de Ultramar,796,2,1,3,"(7.128456,-73.183637)"
2015,Abril,India,356,38,315,353,"(4.697144,-74.140516)"
2018,Diciembre,República de Moldavia,498,4,2,6,"(4.697144,-74.140516)"
2013,Febrero,España,724,0,1,1,"(7.927209,-72.507910)"
2023,Abril,España,724,17,34,51,"(8.364293,-72.405710)"
2020,Enero,Dinamarca,208,18,43,61,"(6.171601,-75.427454)"
2013,Abril,Eslovaquia,703,2,1,3,"(0.814836,-77.662532)"
2018,Abril,Togo,768,0,1,1,"(10.445761,-75.516429)"
2023,Junio,Estados Unidos de América,840,383,462,845,"(4.452882,-75.766298)"
2016,Mayo,Honduras,340,0,4,4,"(7.818934,-72.453226)"
2021,Junio,Ucrania,804,2,3,5,"(6.171601,-75.427454)"
2012,Junio,Italia,380,1,4,5,"(11.360009,-72.129330)"
2018,Enero,Israel,376,2,3,5,"(10.886611,-74.776708)"
2017,Septiembre,República Democrática del Congo,180,1,0,1,"(6.171601,-75.427454)"
2017,Noviembre,Belice,84,0,1,1,"(4.452882,-75.766298)"
2018,Marzo,Países Bajos,528,1,3,4,"(11.247723,-74.213989)"
2019,Marzo,República de Kosovo,901,1,3,4,"(4.697144,-74.140516)"
2015,Julio,Nicaragua,558,2,5,7,"(12.586067,-81.702563)"
2023,Marzo,Costa de Marfil,384,0,1,1,"(4.697144,-74.140516)"
2013,Mayo,Francia,250,4,7,11,"(10.408582,-75.538003)"
2022,Marzo,Chile,152,1,2,3,"(8.36068,-72.409396)"
2015,Junio,Bahamas,44,5,5,10,"(6.171601,-75.427454)"
2017,Febrero,Israel,376,0,1,1,"(4.815061,-75.736532)"
2018,Abril,España,724,0,2,2,"(10.433609,-73.247863)"
2019,Septiembre,China,156,21,33,54,"(10.445761,-75.516429)"
2021,Abril,Bolivia,68,11,16,27,"(6.171601,-75.427454)"
2018,Septiembre,Dinamarca,208,0,1,1,"(3.893038,-77.067921)"
2022,Agosto,Ucrania,804,0,5,5,"(10.886611,-74.776708)"
2012,Octubre,Paraguay,600,20,105,125,"(10.886611,-74.776708)"
2015,Mayo,Uruguay,858,171,393,564,"(4.697144,-74.140516)"
2014,Diciembre,República de Corea,410,1,1,2,"(11.360009,-72.129330)"
2015,Julio,Honduras,340,1,0,1,"(7.818934,-72.453226)"
2016,Marzo,Guatemala,320,11,7,18,"(10.408582,-75.538003)"
2018,Septiembre,Malta,470,0,1,1,"(3.541112,-76.384584)"
2014,Abril,Hungría,348,1,0,1,"(10.445761,-75.516429)"
2017,Enero,Reino Unido de Gran Bretaña e Irlanda del Norte,826,25,82,107,"(3.541112,-76.384584)"
2013,Octubre,El Salvador,222,55,95,150,"(3.541112,-76.384584)"
2022,Noviembre,Nicaragua,558,1,1,2,"(7.128456,-73.183637)"
2019,Enero,Afganistán,4,0,1,1,"(4.697144,-74.140516)"
2013,Agosto,Estados Unidos de América,840,0,1,1,"(1.813928,-78.763924)"
2016,Noviembre,Austria,40,6,9,15,"(10.445761,-75.516429)"
2016,Noviembre,India,356,0,1,1,"(7.128456,-73.183637)"
2018,Diciembre,Sri Lanka,144,1,0,1,"(10.445761,-75.516429)"
2018,Julio,República CentroÁfricana,140,0,1,1,"(3.541112,-76.384584)"
2018,Abril,Jamaica,388,3,2,5,"(10.886611,-74.776708)"
2018,Enero,México,484,0,1,1,"(0.25129,-76.875963)"
2017,Diciembre,Suiza,756,29,16,45,"(10.408582,-75.538003)"
2012,Agosto,Estados Unidos de América,840,1,1,2,"(7.088729,-70.740253)"
2013,Septiembre,Ghana,288,1,5,6,"(4.697144,-74.140516)"
2019,Junio,Eslovenia,705,1,0,1,"(10.886611,-74.776708)"
2013,Enero,Portugal,620,0,3,3,"(11.360009,-72.129330)"
2018,Agosto,Reino Unido de Gran Bretaña e Irlanda del Norte,826,113,181,294,"(10.445761,-75.516429)"
2016,Marzo,Mozambique,508,1,2,3,"(4.697144,-74.140516)"
2013,Octubre,Luxemburgo,442,1,0,1,"(10.445761,-75.516429)"
2018,Diciembre,India,356,32,58,90,"(10.445761,-75.516429)"
2018,Abril,México,484,21,19,40,"(10.408582,-75.538003)"
2019,Enero,Ucrania,804,2,2,4,"(8.635765,-77.346578)"
2023,Mayo,Chile,152,2,2,4,"(8.36068,-72.409396)"
2023,Junio,Estados Unidos de América,840,1,3,4,"(13.3387613,-81.372937)"
2019,Diciembre,Bélgica,56,9,14,23,"(0.814836,-77.662532)"
2016,Junio,Bulgaria,100,0,1,1,"(10.408582,-75.538003)"
2021,Febrero,Perú,604,0,7,7,"(10.408582,-75.538003)"
2017,Diciembre,Finlandia,246,1,0,1,"(11.247723,-74.213989)"
2022,Marzo,Filipinas,608,2,13,15,"(10.886611,-74.776708)"
2020,Febrero,Grecia,300,6,19,25,"(10.445761,-75.516429)"
2019,Marzo,República de Irlanda,372,20,39,59,"(10.445761,-75.516429)"
2022,Marzo,Honduras,340,0,1,1,"(8.635765,-77.346578)"
2016,Diciembre,Líbano,422,0,1,1,"(7.128456,-73.183637)"
2019,Agosto,Argentina,32,3,5,8,"(11.360009,-72.129330)"
2014,Marzo,Costa de Marfil,384,0,1,1,"(6.171601,-75.427454)"
2021,Agosto,San  Vicente y las Granadinas,670,2,2,4,"(4.697144,-74.140516)"
2012,Marzo,Grecia,300,0,1,1,"(0.814836,-77.662532)"
2019,Mayo,Italia,380,8,15,23,"(11.360009,-72.129330)"
2021,Abril,Venezuela,862,1,0,1,"(10.408582,-75.538003)"
2022,Octubre,Eslovaquia,703,0,1,1,"(7.916725,-72.462544)"
2012,Noviembre,Polonia,616,2,4,6,"(11.360009,-72.129330)"
2012,Abril,Bélgica,56,0,8,8,"(11.247723,-74.213989)"
2013,Junio,Kirguistán,417,0,1,1,"(4.697144,-74.140516)"
2019,Junio,Ecuador,218,61,218,279,"(0.25129,-76.875963)"
2023,Abril,Noruega,578,7,9,16,"(3.541112,-76.384584)"
2014,Marzo,España,724,10,9,19,"(-4.197703,-69.941278)"
2019,Abril,Malasia,458,1,1,2,"(0.814836,-77.662532)"
2019,Diciembre,India,356,31,60,91,"(10.445761,-75.516429)"
2012,Julio,República de Corea,410,2,2,4,"(-4.197703,-69.941278)"
2021,Octubre,Filipinas,608,0,34,34,"(3.893038,-77.067921)"
2012,Enero,Venezuela,862,1767,1997,3764,"(7.818934,-72.453226)"
2016,Junio,Reino Unido de Gran Bretaña e Irlanda del Norte,826,2,1,3,"(13.3387613,-81.372937)"
2016,Noviembre,Benín,204,1,0,1,"(6.171601,-75.427454)"
2019,Noviembre,Albania,8,3,3,6,"(6.171601,-75.427454)"
2018,Diciembre,Suecia,752,14,13,27,"(10.886611,-74.776708)"
2020,Diciembre,Federación de Rusia,643,22,15,37,"(6.171601,-75.427454)"
2017,Abril,Grecia,300,49,84,133,"(4.697144,-74.140516)"
2019,Agosto,Australia,36,1,4,5,"(-4.223468,-69.945098)"
2012,Diciembre,Alemania,276,7,9,16,"(8.635765,-77.346578)"
2015,Septiembre,República de Irlanda,372,4,8,12,"(0.814836,-77.662532)"
2016,Febrero,Noruega,578,2,9,11,"(3.541112,-76.384584)"
2017,Febrero,México,484,107,197,304,"(10.445761,-75.516429)"
2016,Julio,Italia,380,747,1580,2327,"(4.697144,-74.140516)"
2019,Marzo,Australia,36,1,1,2,"(11.247723,-74.213989)"
2016,Agosto,Portugal,620,1,3,4,"(10.408582,-75.538003)"
2015,Noviembre,Chile,152,32,106,138,"(6.171601,-75.427454)"
2019,Septiembre,Uruguay,858,25,26,51,"(12.586067,-81.702563)"
2019,Enero,Honduras,340,1,3,4,"(12.586067,-81.702563)"
2019,Enero,España,724,3070,5616,8688,"(4.697144,-74.140516)"
2015,Marzo,Turquía,792,3,4,7,"(3.541112,-76.384584)"
2014,Enero,Finlandia,246,0,2,2,"(10.886611,-74.776708)"
2022,Diciembre,Myanmar,104,0,6,6,"(10.971302,-74.765397)"
2016,Julio,Mauricio,480,1,0,1,"(6.171601,-75.427454)"
2014,Octubre,Costa Rica,188,8,12,20,"(10.886611,-74.776708)"
2015,Octubre,Cuba,192,1,2,3,"(0.25129,-76.875963)"
2022,Agosto,Costa Rica,188,1,1,2,"(11.360009,-72.129330)"
2019,Julio,Mongolia,496,1,0,1,"(4.697144,-74.140516)"
2019,Mayo,Portugal,620,0,3,3,"(4.815061,-75.736532)"
2013,Febrero,Venezuela,862,1,3,4,"(4.452882,-75.766298)"
2012,Julio,República de Irlanda,372,11,10,21,"(6.171601,-75.427454)"
2014,Mayo,España,724,33,65,98,"(10.445761,-75.516429)"
2017,Diciembre,España,724,0,1,1,"(10.971302,-74.765397)"
2012,Julio,Honduras,340,1,1,2,"(13.3387613,-81.372937)"
2019,Diciembre,Paraguay,600,2,4,6,"(10.886611,-74.776708)"
2017,Septiembre,Reino Unido de Gran Bretaña e Irlanda del Norte,826,3,2,5,"(7.818934,-72.453226)"
2022,Octubre,Sudáfrica,710,0,1,1,"(10.886611,-74.776708)"
2015,Septiembre,Guatemala,320,0,3,3,"(11.360009,-72.129330)"
2021,Octubre,Suecia,752,2,21,23,"(10.445761,-75.516429)"
2021,Abril,Alemania,276,0,2,2,"(11.247723,-74.213989)"
2020,Enero,Turquía,792,1,0,1,"(10.408582,-75.538003)"
2022,Julio,Alemania,276,0,1,1,"(11.247723,-74.213989)"
2023,Marzo,Hungría,348,76,112,188,"(4.697144,-74.140516)"
2012,Noviembre,Trinidad y Tobago,780,0,10,10,"(6.171601,-75.427454)"
2021,Noviembre,China,156,2,1,3,"(4.815061,-75.736532)"
2017,Noviembre,Bermudas/Territorio Británico de Ultramar,60,0,1,1,"(10.445761,-75.516429)"
2023,Mayo,Santa Lucia,662,1,0,1,"(4.697144,-74.140516)"
2014,Enero,Argentina,32,132,112,244,"(10.408582,-75.538003)"
2014,Noviembre,El Salvador,222,0,2,2,"(10.408582,-75.538003)"
2022,Noviembre,Eslovaquia,703,0,1,1,"(8.635765,-77.346578)"
2022,Junio,Dinamarca,208,0,1,1,"(11.247723,-74.213989)"
2022,Julio,Ecuador,218,1,2,3,"(0.812436,-77.847006)"
2013,Enero,Reino Unido de Gran Bretaña e Irlanda del Norte,826,21,37,58,"(10.445761,-75.516429)"
2019,Octubre,Zimbabue,716,1,1,2,"(10.445761,-75.516429)"
2017,Julio,Venezuela,862,0,2,2,"(1.813928,-78.763924)"
2016,Febrero,Eslovenia,705,0,1,1,"(0.814836,-77.662532)"
2018,Febrero,Ecuador,218,0,3,3,"(3.893038,-77.067921)"
2022,Febrero,República de Moldavia,498,1,0,1,"(10.445761,-75.516429)"
2023,Junio,República Democrática del Congo,180,1,1,2,"(6.171601,-75.427454)"
2019,Octubre,Islas Caimán/Territorio Británico de Ultramar,136,1,0,1,"(4.697144,-74.140516)"
2022,Agosto,Brasil,76,2,2,4,"(7.128456,-73.183637)"
2020,Marzo,Perú,604,2,2,4,"(11.360009,-72.129330)"
2023,Abril,Panamá,591,63,52,115,"(4.452882,-75.766298)"
2019,Noviembre,San Cristóbal y Nevis,659,0,3,3,"(10.445761,-75.516429)"
2012,Septiembre,Isla de Man,833,4,21,25,"(3.541112,-76.384584)"
2022,Diciembre,Rwanda,646,0,1,1,"(10.445761,-75.516429)"
2016,Enero,Portugal,620,363,655,1018,"(4.697144,-74.140516)"
2018,Mayo,República Dominicana,214,4,8,12,"(0.814836,-77.662532)"
2016,Octubre,Venezuela,862,2,0,2,"(4.452882,-75.766298)"
2022,Abril,Argentina,32,1,1,2,"(8.36068,-72.409396)"
2022,Julio,Países Bajos,528,9,6,15,"(-4.197703,-69.941278)"
2022,Marzo,Haití,332,0,6,6,"(10.445761,-75.516429)"
2013,Julio,Islas Salomón,90,1,0,1,"(3.541112,-76.384584)"
2020,Enero,Alemania,276,6,13,19,"(-4.197703,-69.941278)"
2012,Diciembre,República de Corea,410,3,9,12,"(0.814836,-77.662532)"
2017,Enero,Ecuador,218,270,351,621,"(3.541112,-76.384584)"
2013,Septiembre,Austria,40,4,0,4,"(0.814836,-77.662532)"
2017,Abril,Eslovenia,705,0,1,1,"(10.408582,-75.538003)"
2021,Octubre,Hong Kong,344,1,2,3,"(6.171601,-75.427454)"
2022,Febrero,Granada,308,0,1,1,"(6.171601,-75.427454)"
2019,Junio,San  Vicente y las Granadinas,670,1,0,1,"(3.541112,-76.384584)"
2016,Octubre,Portugal,620,7,26,33,"(3.541112,-76.384584)"
2017,Diciembre,Ghana,288,0,1,1,"(10.445761,-75.516429)"
2021,Agosto,Alemania,276,0,2,2,"(11.360009,-72.129330)"
2013,Enero,Croacia,191,4,31,35,"(4.697144,-74.140516)"
2012,Marzo,Perú,604,0,1,1,"(7.088729,-70.740253)"
2012,Marzo,México,484,1,6,7,"(8.635765,-77.346578)"
2014,Diciembre,Polonia,616,2,0,2,"(12.586067,-81.702563)"
2018,Marzo,Ucrania,804,0,4,4,"(11.247723,-74.213989)"
2022,Agosto,Albania,8,0,2,2,"(6.171601,-75.427454)"
2019,Enero,Alemania,276,5,8,13,"(4.815061,-75.736532)"
2013,Enero,Grecia,300,0,1,1,"(10.408582,-75.538003)"
2015,Septiembre,Noruega,578,2,8,10,"(10.445761,-75.516429)"
2014,Octubre,Estados Unidos de América,840,1,0,1,"(0.25129,-76.875963)"
2016,Octubre,Ghana,288,1,4,5,"(4.697144,-74.140516)"
2022,Mayo,Nicaragua,558,17,30,47,"(6.171601,-75.427454)"
2016,Enero,Irán,364,6,9,15,"(4.697144,-74.140516)"
2013,Julio,El Salvador,222,40,63,103,"(3.541112,-76.384584)"
2014,Julio,India,356,0,2,2,"(11.247723,-74.213989)"
2015,Abril,Burundi,108,0,1,1,"(4.697144,-74.140516)"
2019,Agosto,Costa Rica,188,8,13,21,"(4.815061,-75.736532)"
2018,Abril,Estados Unidos de América,840,2,10,12,"(-4.197703,-69.941278)"
2023,Abril,Austria,40,1,2,3,"(10.408582,-75.538003)"
2016,Diciembre,Turquía,792,5,7,12,"(10.445761,-75.516429)"
2013,Mayo,Islas Caimán/Territorio Británico de Ultramar,136,1,1,2,"(4.697144,-74.140516)"
2022,Marzo,México,484,3,4,7,"(7.128456,-73.183637)"
2023,Abril,Argentina,32,2755,3738,6493,"(4.697144,-74.140516)"
2014,Noviembre,Brasil,76,2,6,8,"(4.815061,-75.736532)"
2020,Febrero,Rumania,642,16,37,53,"(6.171601,-75.427454)"
2022,Agosto,Canadá,124,0,1,1,"(10.971302,-74.765397)"
2012,Abril,Níger,562,0,1,1,"(10.408582,-75.538003)"
2021,Marzo,Japón,392,0,1,1,"(4.815061,-75.736532)"
2018,Abril,Malasia,458,1,0,1,"(-4.223468,-69.945098)"
2016,Agosto,Islas Salomón,90,0,2,2,"(10.408582,-75.538003)"
2015,Junio,Nueva Zelanda,554,3,5,8,"(-4.197703,-69.941278)"
2023,Marzo,Portugal,620,1,2,3,"(4.452882,-75.766298)"
2014,Noviembre,Hong Kong,344,0,1,1,"(0.814836,-77.662532)"
2013,Julio,Croacia,191,0,1,1,"(10.445761,-75.516429)"
2014,Julio,Canadá,124,30,22,52,"(0.814836,-77.662532)"
2021,Julio,Surinam,740,0,1,1,"(6.171601,-75.427454)"
2012,Noviembre,Austria,40,5,8,13,"(10.408582,-75.538003)"
2015,Octubre,República Dominicana,214,35,67,102,"(10.445761,-75.516429)"
2017,Julio,España,724,452,753,1205,"(6.171601,-75.427454)"
2017,Septiembre,Grecia,300,0,1,1,"(10.971302,-74.765397)"
2014,Enero,Jamaica,388,0,1,1,"(10.408582,-75.538003)"
2014,Enero,Dominica,212,2,2,4,"(4.697144,-74.140516)"
2012,Julio,Federación de Rusia,643,0,1,1,"(10.886611,-74.776708)"
2017,Diciembre,Georgia,268,0,2,2,"(4.697144,-74.140516)"
2022,Septiembre,Alemania,276,1,1,2,"(4.452882,-75.766298)"
2016,Mayo,Irán,364,3,6,9,"(4.697144,-74.140516)"
2017,Octubre,Trinidad y Tobago,780,6,12,18,"(10.445761,-75.516429)"
2012,Diciembre,Australia,36,8,8,16,"(-4.197703,-69.941278)"
2012,Abril,México,484,14,30,44,"(7.818934,-72.453226)"
2017,Marzo,Bolivia,68,376,495,871,"(4.697144,-74.140516)"
2019,Junio,Austria,40,125,229,354,"(4.697144,-74.140516)"
2020,Octubre,Brasil,76,8,10,18,"(3.541112,-76.384584)"
2022,Enero,Santa Sede/Ciudad del Vaticano,336,0,1,1,"(4.697144,-74.140516)"
2014,Agosto,Mauricio,480,0,1,1,"(4.697144,-74.140516)"
2019,Noviembre,El Salvador,222,0,1,1,"(4.452882,-75.766298)"
2015,Abril,Guatemala,320,31,81,112,"(3.541112,-76.384584)"
2018,Junio,Desconocido,99999,10,21,31,"(10.445761,-75.516429)"
2014,Enero,Sri Lanka,144,0,1,1,"(6.171601,-75.427454)"
2021,Febrero,Reino Unido de Gran Bretaña e Irlanda del Norte,826,0,3,3,"(10.886611,-74.776708)"
2019,Abril,Brasil,76,824,598,1422,"(10.445761,-75.516429)"
2013,Mayo,Ecuador,218,4,6,10,"(12.586067,-81.702563)"
2017,Octubre,Panamá,591,2,11,13,"(10.408582,-75.538003)"
2022,Noviembre,Cuba,192,0,5,5,"(4.815061,-75.736532)"
2019,Marzo,Uganda,800,3,3,6,"(4.697144,-74.140516)"
2017,Febrero,Kenia,404,0,2,2,"(10.445761,-75.516429)"
2018,Noviembre,Canadá,124,2,1,3,"(11.360009,-72.129330)"
2014,Noviembre,Luxemburgo,442,1,0,1,"(8.635765,-77.346578)"
2012,Enero,Belice,84,1,1,2,"(7.128456,-73.183637)"
2019,Junio,Italia,380,14,25,39,"(0.814836,-77.662532)"
2013,Noviembre,Reino Unido de Gran Bretaña e Irlanda del Norte,826,2,1,3,"(12.5744111,-81.703935)"
2014,Junio,Australia,36,30,58,88,"(0.814836,-77.662532)"
2015,Septiembre,Eslovenia,705,19,21,40,"(4.697144,-74.140516)"
2017,Julio,Austria,40,4,7,11,"(3.541112,-76.384584)"
2015,Enero,Filipinas,608,1,44,45,"(10.445761,-75.516429)"
2019,Marzo,Venezuela,862,12,42,54,"(7.927209,-72.507910)"
2013,Febrero,Suiza,756,0,2,2,"(-4.197703,-69.941278)"
2014,Diciembre,República Dominicana,214,1,1,2,"(12.586067,-81.702563)"
2016,Enero,Italia,380,13,37,50,"(10.886611,-74.776708)"
2020,Noviembre,República de Irlanda,372,0,8,8,"(6.171601,-75.427454)"
2012,Febrero,México,484,4,2,6,"(7.128456,-73.183637)"
2022,Noviembre,Jamaica,388,1,0,1,"(10.408582,-75.538003)"
2019,Junio,Nicaragua,558,0,8,8,"(10.886611,-74.776708)"
2022,Agosto,Canadá,124,4,4,8,"(11.117806,-74.232622)"
2012,Septiembre,Perú,604,0,2,2,"(4.815061,-75.736532)"
2012,Mayo,Surinam,740,0,6,6,"(6.171601,-75.427454)"
2016,Mayo,Lituania,440,1,4,5,"(3.541112,-76.384584)"
2023,Junio,Canadá,124,2,6,8,"(11.117806,-74.232622)"
2013,Julio,Albania,8,2,0,2,"(4.697144,-74.140516)"
2022,Marzo,Granada,308,1,4,5,"(4.697144,-74.140516)"
2018,Agosto,Guyana,328,0,1,1,"(10.886611,-74.776708)"
2022,Agosto,Suiza,756,1,1,2,"(10.886611,-74.776708)"
2017,Noviembre,Omán,512,0,2,2,"(4.697144,-74.140516)"
2021,Diciembre,Kazajistán,398,9,13,22,"(4.697144,-74.140516)"
2022,Abril,México,484,9,9,18,"(7.128456,-73.183637)"
2013,Enero,Letonia,428,1,2,3,"(10.445761,-75.516429)"
2022,Mayo,Túnez,788,0,1,1,"(3.541112,-76.384584)"
2019,Mayo,Honduras,340,0,2,2,"(10.971302,-74.765397)"
2014,Noviembre,Honduras,340,52,57,109,"(6.171601,-75.427454)"
2012,Abril,Bélgica,56,3,10,13,"(3.541112,-76.384584)"
2020,Febrero,India,356,21,70,91,"(10.445761,-75.516429)"
2017,Septiembre,Nueva Zelanda,554,68,103,171,"(4.697144,-74.140516)"
2023,Marzo,Austria,40,25,50,75,"(6.171601,-75.427454)"
2017,Julio,Jamaica,388,6,5,11,"(6.171601,-75.427454)"
2017,Septiembre,Eslovaquia,703,1,0,1,"(10.408582,-75.538003)"
2016,Junio,Estonia,233,1,0,1,"(0.814836,-77.662532)"
2019,Agosto,República Dominicana,214,1,9,10,"(11.360009,-72.129330)"
2017,Junio,República Checa,203,2,0,2,"(0.814836,-77.662532)"
2019,Marzo,Grecia,300,0,1,1,"(10.886611,-74.776708)"
2013,Octubre,Croacia,191,0,1,1,"(3.541112,-76.384584)"
2019,Junio,Barbados,52,1,6,7,"(6.171601,-75.427454)"
2019,Noviembre,Portugal,620,22,23,45,"(10.445761,-75.516429)"
2021,Marzo,Santa Lucia,662,1,0,1,"(4.697144,-74.140516)"
2021,Julio,Arabia Saudita,682,0,3,3,"(6.171601,-75.427454)"
2022,Marzo,Cuba,192,0,1,1,"(4.452882,-75.766298)"
2013,Octubre,Canadá,124,4,4,8,"(7.818934,-72.453226)"
2018,Julio,El Salvador,222,0,5,5,"(4.815061,-75.736532)"
2014,Diciembre,San Cristóbal y Nevis,659,1,2,3,"(4.697144,-74.140516)"
2016,Enero,Brasil,76,887,609,1496,"(10.408582,-75.538003)"
2018,Junio,Austria,40,4,5,9,"(0.814836,-77.662532)"
2015,Febrero,Suiza,756,3,4,7,"(12.586067,-81.702563)"
2016,Noviembre,Kenia,404,8,13,21,"(4.697144,-74.140516)"
2016,Agosto,Grecia,300,1,0,1,"(-4.197703,-69.941278)"
2018,Julio,Suiza,756,16,12,28,"(10.408582,-75.538003)"
2022,Noviembre,República de Irlanda,372,0,3,3,"(11.117806,-74.232622)"
2018,Mayo,Kirguistán,417,1,0,1,"(6.171601,-75.427454)"
2018,Junio,Croacia,191,0,1,1,"(10.408582,-75.538003)"
2015,Mayo,Estonia,233,4,7,11,"(4.697144,-74.140516)"
2013,Septiembre,Federación de Rusia,643,2,4,6,"(6.171601,-75.427454)"
2018,Abril,Estados Unidos de América,840,0,4,4,"(6.17134,-75.427194)"
2018,Mayo,Canadá,124,22,17,39,"(4.815061,-75.736532)"
2020,Febrero,República de Irlanda,372,14,42,56,"(6.171601,-75.427454)"
2022,Marzo,Suiza,756,5,3,8,"(8.635765,-77.346578)"
2017,Agosto,Honduras,340,33,34,67,"(3.541112,-76.384584)"
2017,Marzo,Italia,380,701,1896,2597,"(4.697144,-74.140516)"
2022,Octubre,Serbia,688,0,1,1,"(7.128456,-73.183637)"
2021,Junio,El Salvador,222,3,4,7,"(10.886611,-74.776708)"
2021,Agosto,República de Corea,410,0,1,1,"(10.445761,-75.516429)"
2023,Mayo,Suecia,752,99,171,270,"(4.697144,-74.140516)"
2014,Septiembre,Eslovenia,705,8,19,27,"(4.697144,-74.140516)"
2019,Septiembre,Lituania,440,0,1,1,"(4.815061,-75.736532)"
2018,Septiembre,Zambia,894,0,1,1,"(10.445761,-75.516429)"
2012,Junio,Perú,604,1850,2853,4703,"(4.697144,-74.140516)"
2016,Julio,Grecia,300,0,1,1,"(10.971302,-74.765397)"
2015,Abril,Argentina,32,0,2,2,"(8.635765,-77.346578)"
2017,Agosto,Paraguay,600,5,3,8,"(7.818934,-72.453226)"
2015,Febrero,Bolivia,68,9,14,23,"(0.814836,-77.662532)"
2013,Mayo,Togo,768,0,1,1,"(10.445761,-75.516429)"
2013,Noviembre,Japón,392,0,1,1,"(7.927209,-72.507910)"
2018,Octubre,Luxemburgo,442,1,0,1,"(6.171601,-75.427454)"
2017,Agosto,Israel,376,1,1,2,"(4.815061,-75.736532)"
2015,Febrero,Honduras,340,4,13,17,"(10.886611,-74.776708)"
2012,Febrero,El Salvador,222,3,16,19,"(3.541112,-76.384584)"
2023,Enero,Croacia,191,0,3,3,"(1.813928,-78.763924)"
2021,Octubre,Cuba,192,0,2,2,"(4.452882,-75.766298)"
2019,Abril,Venezuela,862,270,329,599,"(10.886611,-74.776708)"
2022,Octubre,Perú,604,0,2,2,"(1.813928,-78.763924)"
2012,Octubre,Venezuela,862,2,7,9,"(11.117806,-74.232622)"
2015,Noviembre,Georgia,268,4,4,8,"(4.697144,-74.140516)"
2019,Julio,Polonia,616,0,1,1,"(3.893038,-77.067921)"
2017,Marzo,Reino Unido de Gran Bretaña e Irlanda del Norte,826,4,3,7,"(7.128456,-73.183637)"
2020,Marzo,Kenia,404,3,4,7,"(4.697144,-74.140516)"
2020,Noviembre,Santa Lucia,662,0,2,2,"(10.445761,-75.516429)"
2013,Septiembre,Bolivia,68,1,0,1,"(11.360009,-72.129330)"
2017,Abril,China,156,320,781,1101,"(4.697144,-74.140516)"
2018,Marzo,Francia,250,0,2,2,"(12.5744111,-81.703935)"
2020,Enero,Albania,8,0,1,1,"(10.886611,-74.776708)"
2016,Septiembre,Guinea Bissau,624,2,0,2,"(4.697144,-74.140516)"
2012,Septiembre,Francia,250,2,7,9,"(8.635765,-77.346578)"
2015,Marzo,Perú,604,94,58,152,"(10.445761,-75.516429)"
2021,Septiembre,Polonia,616,1,4,5,"(3.541112,-76.384584)"
2019,Noviembre,Japón,392,0,1,1,"(-4.197703,-69.941278)"
2019,Mayo,República Dominicana,214,5,3,8,"(4.815061,-75.736532)"
2018,Noviembre,Macedonia,807,3,5,8,"(4.697144,-74.140516)"
2016,Octubre,Guyana,328,0,1,1,"(12.586067,-81.702563)"
2020,Marzo,Kazajistán,398,0,2,2,"(0.814836,-77.662532)"
2018,Enero,Irán,364,9,13,22,"(4.697144,-74.140516)"
2015,Julio,Ecuador,218,18,232,250,"(1.813928,-78.763924)"
2013,Mayo,Alemania,276,56,75,131,"(0.814836,-77.662532)"
2019,Abril,Italia,380,6,10,16,"(12.586067,-81.702563)"
2012,Febrero,Venezuela,862,82,116,198,"(10.886611,-74.776708)"
2017,Abril,República de Corea,410,0,1,1,"(10.408582,-75.538003)"
2022,Febrero,Venezuela,862,208,193,401,"(10.445761,-75.516429)"
2014,Septiembre,Venezuela,862,2685,3269,5954,"(7.818934,-72.453226)"
2023,Febrero,Argentina,32,2,2,4,"(7.927209,-72.507910)"
2021,Julio,Perú,604,10,13,23,"(7.818934,-72.453226)"
2018,Septiembre,Letonia,428,17,13,30,"(4.697144,-74.140516)"
2012,Mayo,Guyana,328,0,1,1,"(6.171601,-75.427454)"
2022,Febrero,Vietnam,704,3,2,5,"(6.171601,-75.427454)"
2016,Febrero,Reino Unido de Gran Bretaña e Irlanda del Norte,826,54,80,134,"(0.814836,-77.662532)"
2018,Abril,Indonesia,360,2,2,4,"(6.171601,-75.427454)"
2022,Mayo,Honduras,340,0,3,3,"(10.408582,-75.538003)"
2012,Junio,República de Irlanda,372,47,90,137,"(4.697144,-74.140516)"
2017,Noviembre,España,724,6,16,22,"(4.815061,-75.736532)"
2023,Junio,República Checa,203,7,12,19,"(6.171601,-75.427454)"
2023,Marzo,Nueva Zelanda,554,0,1,1,"(-4.197703,-69.941278)"
2019,Abril,Egipto,818,2,2,4,"(10.445761,-75.516429)"
2017,Febrero,Belice,84,0,1,1,"(7.818934,-72.453226)"
2014,Junio,Haití,332,7,11,18,"(4.697144,-74.140516)"
2014,Agosto,Cuba,192,11,22,33,"(6.171601,-75.427454)"
2021,Noviembre,Cuba,192,149,290,439,"(3.541112,-76.384584)"
2013,Agosto,Turquía,792,1,0,1,"(10.886611,-74.776708)"
2019,Diciembre,Suecia,752,2,3,5,"(11.247723,-74.213989)"
2014,Septiembre,Panamá,591,0,2,2,"(12.5744111,-81.703935)"
2019,Abril,Panamá,591,1,0,1,"(10.433609,-73.247863)"
2012,Julio,Australia,36,0,1,1,"(7.927209,-72.507910)"
2015,Diciembre,Francia,250,0,1,1,"(3.893038,-77.067921)"
2018,Marzo,Francia,250,1,3,4,"(7.128456,-73.183637)"
2017,Junio,Federación de Rusia,643,1,1,2,"(3.541112,-76.384584)"
2014,Agosto,Estados Unidos de América,840,3,11,14,"(12.5744111,-81.703935)"
2018,Agosto,Filipinas,608,0,42,42,"(10.408582,-75.538003)"
2012,Octubre,Guatemala,320,0,1,1,"(11.360009,-72.129330)"
2016,Abril,Reino Unido de Gran Bretaña e Irlanda del Norte,826,3,4,7,"(11.360009,-72.129330)"
2019,Noviembre,Uruguay,858,0,1,1,"(4.452882,-75.766298)"
2017,Agosto,Eslovenia,705,5,3,8,"(10.445761,-75.516429)"
2019,Abril,Perú,604,49,89,138,"(-0.193180,-74.784874)"
2022,Octubre,Brasil,76,59,103,162,"(3.541112,-76.384584)"
2018,Junio,Francia,250,0,4,4,"(7.128456,-73.183637)"
2014,Diciembre,Suiza,756,6,7,13,"(12.586067,-81.702563)"
2015,Junio,República Checa,203,1,0,1,"(11.360009,-72.129330)"
2022,Junio,Pakistán,586,1,6,7,"(4.697144,-74.140516)"
2019,Diciembre,Taiwán,158,2,3,5,"(3.541112,-76.384584)"
2016,Diciembre,España,724,14,55,69,"(10.886611,-74.776708)"
2023,Febrero,Chipre,196,9,11,20,"(4.697144,-74.140516)"
2022,Septiembre,República Dominicana,214,1,0,1,"(4.452882,-75.766298)"
2014,Septiembre,Países Bajos,528,2,2,4,"(4.815061,-75.736532)"
2023,Febrero,Turquía,792,1,0,1,"(0.25129,-76.875963)"
2012,Junio,Israel,376,27,97,124,"(0.814836,-77.662532)"
2017,Noviembre,Jamaica,388,2,0,2,"(7.818934,-72.453226)"
2014,Octubre,Nueva Zelanda,554,0,1,1,"(7.818934,-72.453226)"
2014,Septiembre,Ecuador,218,3,227,230,"(1.813928,-78.763924)"
2023,Abril,República de Moldavia,498,1,0,1,"(6.171601,-75.427454)"
2016,Marzo,España,724,1,1,2,"(12.5744111,-81.703935)"
2012,Agosto,Chile,152,1,2,3,"(7.128456,-73.183637)"
2017,Abril,Anguila/Territorio Británico de Ultramar,660,1,0,1,"(4.697144,-74.140516)"
2021,Diciembre,República Checa,203,1,1,2,"(4.815061,-75.736532)"
2020,Agosto,Albania,8,0,1,1,"(11.360009,-72.129330)"
2012,Octubre,Perú,604,1,1,2,"(4.815061,-75.736532)"
2013,Diciembre,Alemania,276,44,52,96,"(0.814836,-77.662532)"
2016,Diciembre,Brasil,76,0,1,1,"(8.36068,-72.409396)"
2014,Julio,Brasil,76,9,27,36,"(0.814836,-77.662532)"
2018,Enero,Ghana,288,0,6,6,"(0.814836,-77.662532)"
2018,Enero,Islandia,352,7,8,15,"(4.697144,-74.140516)"
2019,Julio,Nueva Zelanda,554,1,1,2,"(10.886611,-74.776708)"
2019,Junio,Antigua y Barbuda,28,0,2,2,"(10.886611,-74.776708)"
2023,Marzo,Taiwán,158,8,7,15,"(6.171601,-75.427454)"
2012,Enero,India,356,0,1,1,"(10.408582,-75.538003)"
2016,Enero,Nicaragua,558,9,7,16,"(3.541112,-76.384584)"
2018,Agosto,Mauricio,480,0,1,1,"(10.408582,-75.538003)"
2014,Diciembre,Cuba,192,14,20,34,"(3.541112,-76.384584)"
2021,Marzo,Haití,332,18,14,32,"(4.697144,-74.140516)"
2017,Abril,Francia,250,1830,2661,4491,"(4.697144,-74.140516)"
2019,Septiembre,El Salvador,222,0,3,3,"(4.452882,-75.766298)"
2012,Noviembre,Guatemala,320,2,3,5,"(0.814836,-77.662532)"
2013,Febrero,Ecuador,218,6,34,40,"(10.408582,-75.538003)"
2016,Julio,Honduras,340,3,21,24,"(12.5744111,-81.703935)"
2018,Enero,Belice,84,0,1,1,"(3.541112,-76.384584)"
2014,Junio,Turquía,792,0,6,6,"(10.408582,-75.538003)"
2012,Septiembre,México,484,0,1,1,"(7.088729,-70.740253)"
2012,Febrero,Francia,250,4,7,11,"(8.635765,-77.346578)"
2022,Octubre,Rumania,642,16,19,35,"(6.171601,-75.427454)"
2019,Mayo,India,356,0,4,4,"(0.814836,-77.662532)"
2017,Mayo,Filipinas,608,1,14,15,"(3.541112,-76.384584)"
2021,Mayo,Perú,604,0,1,1,"(7.128456,-73.183637)"
2019,Mayo,Alemania,276,4,5,9,"(12.586067,-81.702563)"
2017,Abril,Nueva Zelanda,554,2,11,13,"(6.171601,-75.427454)"
2016,Julio,Santa Lucia,662,0,1,1,"(4.697144,-74.140516)"
2021,Noviembre,Filipinas,608,2,38,40,"(10.445761,-75.516429)"
2018,Abril,Uruguay,858,0,1,1,"(8.36068,-72.409396)"
2012,Enero,China,156,0,2,2,"(8.635765,-77.346578)"
2022,Junio,España,724,0,1,1,"(6.185799,-67.483929)"
2023,Marzo,Francia,250,3,5,8,"(8.364293,-72.405710)"
2013,Marzo,Isla de Man,833,9,22,31,"(6.171601,-75.427454)"
2018,Septiembre,Costa Rica,188,144,220,364,"(6.171601,-75.427454)"
2015,Agosto,Ucrania,804,0,1,1,"(10.971302,-74.765397)"
2019,Diciembre,Albania,8,0,2,2,"(0.814836,-77.662532)"
2018,Junio,Suiza,756,1,0,1,"(0.25129,-76.875963)"
2020,Diciembre,Brasil,76,2,3,5,"(7.128456,-73.183637)"
2018,Mayo,Venezuela,862,6,5,11,"(11.528919,-72.919681)"
2014,Julio,Chile,152,67,133,200,"(6.171601,-75.427454)"
2015,Febrero,Estados Unidos de América,840,0,2,2,"(0.25129,-76.875963)"
2019,Agosto,Grecia,300,0,2,2,"(10.408582,-75.538003)"
2023,Abril,Luxemburgo,442,1,1,2,"(3.541112,-76.384584)"
2023,Marzo,República Dominicana,214,1,2,3,"(8.364293,-72.405710)"
2016,Junio,Chile,152,2,2,4,"(11.360009,-72.129330)"
2021,Octubre,Panamá,591,1038,1270,2308,"(4.697144,-74.140516)"
2015,Septiembre,Filipinas,608,30,52,82,"(4.697144,-74.140516)"
2019,Abril,Surinam,740,0,9,9,"(6.171601,-75.427454)"
2022,Febrero,Federación de Rusia,643,1,0,1,"(4.452882,-75.766298)"
2015,Noviembre,Austria,40,1,0,1,"(7.927209,-72.507910)"
2021,Junio,Francia,250,6,5,11,"(10.886611,-74.776708)"
2013,Febrero,Jamaica,388,0,1,1,"(3.893038,-77.067921)"
2021,Octubre,Eslovaquia,703,6,3,9,"(6.171601,-75.427454)"
2018,Julio,República Dominicana,214,29,55,84,"(10.886611,-74.776708)"
2014,Julio,España,724,0,3,3,"(7.088729,-70.740253)"
2022,Marzo,Panamá,591,1,17,18,"(10.408582,-75.538003)"
2012,Julio,Países Bajos,528,1,8,9,"(11.360009,-72.129330)"
2017,Enero,Noruega,578,4,7,11,"(10.886611,-74.776708)"
2018,Septiembre,Reino Unido de Gran Bretaña e Irlanda del Norte,826,0,1,1,"(4.452882,-75.766298)"
2012,Noviembre,Lituania,440,2,2,4,"(4.697144,-74.140516)"
2017,Abril,Lituania,440,0,1,1,"(11.528919,-72.919681)"
2020,Enero,Bolivia,68,21,20,41,"(12.586067,-81.702563)"
2015,Enero,Filipinas,608,1,6,7,"(10.886611,-74.776708)"
2019,Marzo,España,724,8,8,16,"(12.586067,-81.702563)"
2018,Agosto,Perú,604,1,2,3,"(7.088729,-70.740253)"
2015,Enero,Marruecos,504,0,1,1,"(6.171601,-75.427454)"
2017,Enero,Eslovaquia,703,3,3,6,"(10.445761,-75.516429)"
2015,Julio,Jordania,400,3,2,5,"(4.697144,-74.140516)"
2016,Noviembre,Costa Rica,188,1072,1444,2516,"(4.697144,-74.140516)"
2019,Noviembre,Bulgaria,100,3,8,11,"(6.171601,-75.427454)"
2021,Septiembre,Suecia,752,8,24,32,"(6.171601,-75.427454)"
2023,Mayo,Israel,376,1,1,2,"(11.247723,-74.213989)"
2012,Marzo,Noruega,578,0,1,1,"(7.927209,-72.507910)"
2022,Julio,Estados Unidos de América,840,0,3,3,"(6.17134,-75.427194)"
2020,Febrero,Serbia,688,0,1,1,"(10.886611,-74.776708)"
2022,Abril,Guyana,328,0,3,3,"(3.541112,-76.384584)"
2012,Abril,Túnez,788,0,1,1,"(3.541112,-76.384584)"
2020,Septiembre,España,724,0,4,4,"(10.886611,-74.776708)"
2014,Mayo,Países Bajos,528,2,4,6,"(11.360009,-72.129330)"
2022,Abril,Marruecos,504,1,4,5,"(6.171601,-75.427454)"
2012,Marzo,Perú,604,0,1,1,"(9.402978,-75.681599)"
2020,Enero,China,156,8,6,14,"(0.814836,-77.662532)"
2015,Mayo,Irán,364,4,16,20,"(4.697144,-74.140516)"
2017,Noviembre,Kenia,404,9,10,19,"(4.697144,-74.140516)"
2018,Junio,República de Irlanda,372,1,1,2,"(10.886611,-74.776708)"
2018,Mayo,Noruega,578,8,18,26,"(6.171601,-75.427454)"
2015,Diciembre,El Salvador,222,2,6,8,"(10.886611,-74.776708)"
2018,Diciembre,Macedonia,807,1,11,12,"(4.697144,-74.140516)"
2021,Mayo,Chile,152,1,1,2,"(-4.197703,-69.941278)"
2021,Agosto,Italia,380,1,2,3,"(7.128456,-73.183637)"
2013,Marzo,Trinidad y Tobago,780,2,3,5,"(10.886611,-74.776708)"
2023,Enero,Guyana,328,3,9,12,"(4.697144,-74.140516)"
2015,Julio,Belice,84,0,1,1,"(4.815061,-75.736532)"
2021,Julio,Argentina,32,11,33,44,"(10.445761,-75.516429)"
2022,Abril,San Cristóbal y Nevis,659,0,1,1,"(0.814836,-77.662532)"
2019,Mayo,Finlandia,246,1,0,1,"(-4.223468,-69.945098)"
2013,Marzo,Nueva Zelanda,554,1,2,3,"(10.408582,-75.538003)"
2012,Enero,Mónaco,492,0,1,1,"(4.697144,-74.140516)"
2021,Octubre,Malí,466,0,2,2,"(4.697144,-74.140516)"
2012,Abril,Alemania,276,9,17,26,"(-4.197703,-69.941278)"
2020,Enero,Alemania,276,185,268,453,"(10.445761,-75.516429)"
2018,Octubre,Trinidad y Tobago,780,1,0,1,"(7.818934,-72.453226)"
2015,Octubre,República de Irlanda,372,14,7,21,"(0.814836,-77.662532)"
2016,Abril,Sudáfrica,710,1,1,2,"(10.408582,-75.538003)"
2014,Septiembre,Cuba,192,1,2,3,"(4.815061,-75.736532)"
2017,Agosto,Desconocido,99999,2,2,4,"(10.445761,-75.516429)"
2016,Septiembre,República Democrática del Congo,180,1,3,4,"(4.697144,-74.140516)"
2018,Septiembre,Antigua y Barbuda,28,2,2,4,"(6.171601,-75.427454)"
2012,Diciembre,Australia,36,0,1,1,"(7.128456,-73.183637)"
2012,Julio,España,724,0,1,1,"(13.3387613,-81.372937)"
2012,Septiembre,Madagascar,450,1,0,1,"(4.697144,-74.140516)"
2019,Noviembre,Uruguay,858,238,370,608,"(4.697144,-74.140516)"
2015,Abril,Federación de Rusia,643,2,1,3,"(-4.197703,-69.941278)"
2018,Febrero,México,484,152,212,364,"(10.445761,-75.516429)"
2017,Julio,Argentina,32,12,19,31,"(10.886611,-74.776708)"
2018,Julio,Costa Rica,188,1,5,6,"(7.818934,-72.453226)"
2015,Agosto,China,156,1,0,1,"(7.128456,-73.183637)"
2022,Mayo,España,724,5,8,13,"(-4.197703,-69.941278)"
2013,Mayo,España,724,6,7,13,"(11.360009,-72.129330)"
2022,Agosto,Panamá,591,5,5,10,"(12.586067,-81.702563)"
2019,Febrero,Arabia Saudita,682,1,3,4,"(4.697144,-74.140516)"
2013,Julio,Ecuador,218,12,15,27,"(12.586067,-81.702563)"
2019,Agosto,Nicaragua,558,9,10,19,"(3.541112,-76.384584)"
2016,Mayo,Austria,40,1,5,6,"(10.886611,-74.776708)"
2015,Febrero,Bélgica,56,4,16,20,"(10.445761,-75.516429)"
2017,Abril,Bangladesh,50,1,4,5,"(4.697144,-74.140516)"
2012,Octubre,Santa Lucia,662,6,1,7,"(7.128456,-73.183637)"
2018,Agosto,Argentina,32,43,90,133,"(3.541112,-76.384584)"
2012,Marzo,Yugoslavia,99999,1,0,1,"(4.697144,-74.140516)"
2012,Agosto,Federación de Rusia,643,0,1,1,"(6.171601,-75.427454)"
2019,Junio,El Salvador,222,0,4,4,"(10.408582,-75.538003)"
2017,Noviembre,Portugal,620,300,542,842,"(4.697144,-74.140516)"
2016,Marzo,Paraguay,600,1,1,2,"(7.927209,-72.507910)"
2021,Agosto,Austria,40,2,6,8,"(3.541112,-76.384584)"
2017,Agosto,Argentina,32,94,158,252,"(0.814836,-77.662532)"
2014,Octubre,Desconocido,99999,0,1,1,"(7.128456,-73.183637)"
2020,Octubre,Chile,152,134,289,423,"(4.697144,-74.140516)"
2019,Marzo,Camerún,120,1,3,4,"(10.445761,-75.516429)"
2013,Abril,Guatemala,320,156,418,574,"(4.697144,-74.140516)"
2022,Mayo,Etiopia,231,4,36,40,"(4.697144,-74.140516)"
2018,Marzo,República Dominicana,214,99,98,197,"(6.171601,-75.427454)"
2020,Diciembre,Dinamarca,208,0,3,3,"(10.445761,-75.516429)"
2012,Julio,Estados Unidos de América,840,0,4,4,"(0.25129,-76.875963)"
2017,Noviembre,Belice,84,1,2,3,"(10.886611,-74.776708)"
2015,Mayo,República Dominicana,214,43,79,122,"(6.171601,-75.427454)"
2018,Agosto,Hungría,348,0,1,1,"(0.25129,-76.875963)"
2022,Junio,Cuba,192,22,41,63,"(6.171601,-75.427454)"
2022,Agosto,Cabo Verde,132,0,1,1,"(10.408582,-75.538003)"
2021,Diciembre,Polonia,616,8,3,11,"(3.541112,-76.384584)"
2023,Febrero,España,724,2,5,7,"(7.128456,-73.183637)"
2018,Julio,Singapur,702,2,1,3,"(10.445761,-75.516429)"
2017,Febrero,Países Bajos,528,0,1,1,"(4.697144,-74.140516)"
2019,Octubre,Rumania,642,5,7,12,"(10.445761,-75.516429)"
2018,Junio,República de Belarús,112,1,0,1,"(10.445761,-75.516429)"
2015,Julio,Uzbekistán,860,4,5,9,"(3.541112,-76.384584)"
2022,Agosto,Turquía,792,2,9,11,"(3.541112,-76.384584)"
2014,Agosto,Eslovenia,705,0,2,2,"(10.408582,-75.538003)"
2015,Agosto,Venezuela,862,613,536,1149,"(10.445761,-75.516429)"
2014,Mayo,Estados Unidos de América,840,39,59,98,"(12.586067,-81.702563)"
2019,Junio,Albania,8,2,13,15,"(4.697144,-74.140516)"
2017,Diciembre,Croacia,191,1,0,1,"(12.586067,-81.702563)"
2015,Agosto,Omán,512,0,1,1,"(9.402978,-75.681599)"
2013,Julio,Nueva Zelanda,554,11,14,25,"(0.814836,-77.662532)"
2014,Marzo,Francia,250,2,7,9,"(7.818934,-72.453226)"
2015,Julio,Croacia,191,0,1,1,"(10.886611,-74.776708)"
2014,Septiembre,Francia,250,2,1,3,"(7.927209,-72.507910)"
2014,Diciembre,Estados Unidos de América,840,98,166,264,"(4.452882,-75.766298)"
2019,Noviembre,Venezuela,862,16,17,33,"(3.866713,-67.927521)"
2018,Octubre,Argentina,32,7,14,21,"(0.25129,-76.875963)"
2022,Septiembre,Austria,40,13,11,24,"(10.445761,-75.516429)"
2012,Agosto,Países Bajos,528,145,282,427,"(4.697144,-74.140516)"
2020,Enero,Argentina,32,1,2,3,"(-4.197703,-69.941278)"
2018,Diciembre,Estados Unidos de América,840,0,4,4,"(10.971302,-74.765397)"
2022,Agosto,Panamá,591,0,1,1,"(-4.197703,-69.941278)"
2016,Enero,Sudáfrica,710,43,73,116,"(4.697144,-74.140516)"
2019,Enero,Ecuador,218,2720,3570,6291,"(4.697144,-74.140516)"
2022,Enero,Nicaragua,558,0,6,6,"(12.5744111,-81.703935)"
2014,Septiembre,Venezuela,862,79,161,240,"(10.445761,-75.516429)"
2018,Enero,Federación de Rusia,643,1,1,2,"(-4.197703,-69.941278)"
2020,Enero,Guatemala,320,0,3,3,"(11.360009,-72.129330)"
2018,Febrero,San Marino,674,0,1,1,"(-4.197703,-69.941278)"
2014,Agosto,República Árabe de Yemen,887,0,1,1,"(4.697144,-74.140516)"
2016,Febrero,Argentina,32,1,7,8,"(4.815061,-75.736532)"
2020,Febrero,Emiratos Árabes,784,0,2,2,"(6.171601,-75.427454)"
2021,Julio,Indonesia,360,0,1,1,"(10.971302,-74.765397)"
2021,Noviembre,Finlandia,246,12,42,54,"(4.697144,-74.140516)"
2017,Marzo,Bolivia,68,1,1,2,"(4.452882,-75.766298)"
2023,Mayo,Japón,392,1,0,1,"(12.586067,-81.702563)"
2014,Junio,Alemania,276,4,13,17,"(8.635765,-77.346578)"
2015,Junio,Argelia,12,2,8,10,"(4.697144,-74.140516)"
2016,Mayo,Senegal,686,1,1,2,"(6.171601,-75.427454)"
2013,Octubre,Filipinas,608,0,45,45,"(10.445761,-75.516429)"
2016,Agosto,Federación de Rusia,643,0,1,1,"(9.402978,-75.681599)"
2017,Marzo,Perú,604,0,1,1,"(1.813928,-78.763924)"
2019,Agosto,Grecia,300,1,0,1,"(-4.223468,-69.945098)"
2015,Noviembre,Canadá,124,109,272,381,"(6.171601,-75.427454)"
2015,Julio,Pakistán,586,0,1,1,"(0.814836,-77.662532)"
2014,Octubre,Paraguay,600,4,4,8,"(10.886611,-74.776708)"
2012,Septiembre,Estados Unidos de América,840,4141,9719,13860,"(4.697144,-74.140516)"
2022,Enero,Italia,380,26,30,56,"(7.916725,-72.462544)"
2019,Marzo,Guyana,328,17,15,32,"(4.697144,-74.140516)"
2022,Octubre,República Árabe Siria,760,1,83,84,"(10.408582,-75.538003)"
2017,Junio,Jamaica,388,1,1,2,"(6.171601,-75.427454)"
2022,Noviembre,República de Corea,410,0,5,5,"(10.971302,-74.765397)"
2016,Marzo,Islandia,352,1,0,1,"(6.171601,-75.427454)"
2015,Septiembre,Paraguay,600,0,1,1,"(0.814836,-77.662532)"
2019,Enero,Nueva Zelanda,554,0,2,2,"(-4.197703,-69.941278)"
2015,Abril,India,356,8,23,31,"(3.541112,-76.384584)"
2013,Octubre,República de Corea,410,3,13,16,"(3.541112,-76.384584)"
2014,Junio,Guyana,328,0,2,2,"(6.171601,-75.427454)"
2017,Diciembre,Argentina,32,5,3,8,"(11.247723,-74.213989)"
2015,Noviembre,Costa Rica,188,4,0,4,"(7.128456,-73.183637)"
2012,Mayo,Estados Unidos de América,840,13,20,33,"(7.927209,-72.507910)"
2023,Abril,Italia,380,27,32,59,"(8.364293,-72.405710)"
2023,Enero,Argelia,12,1,0,1,"(10.445761,-75.516429)"
2015,Febrero,Islandia,352,0,5,5,"(10.445761,-75.516429)"
2016,Julio,Antigua y Barbuda,28,0,2,2,"(4.697144,-74.140516)"
2017,Marzo,Suiza,756,0,1,1,"(9.402978,-75.681599)"
2018,Septiembre,Dominica,212,2,1,3,"(3.541112,-76.384584)"
2012,Octubre,Alemania,276,0,2,2,"(4.815061,-75.736532)"
2015,Junio,Bélgica,56,0,1,1,"(11.247723,-74.213989)"
2023,Junio,China,156,1,6,7,"(8.364293,-72.405710)"
2019,Mayo,Sudáfrica,710,0,3,3,"(3.541112,-76.384584)"
2012,Octubre,Brasil,76,6,20,26,"(0.814836,-77.662532)"
2018,Mayo,Canadá,124,208,224,432,"(10.445761,-75.516429)"
2018,Enero,Suiza,756,24,13,37,"(10.408582,-75.538003)"
2015,Septiembre,Honduras,340,0,2,2,"(12.5744111,-81.703935)"
2012,Agosto,Austria,40,15,12,27,"(0.814836,-77.662532)"
2021,Abril,Marruecos,504,0,1,1,"(6.171601,-75.427454)"
2014,Abril,Nueva Zelanda,554,4,12,16,"(0.814836,-77.662532)"
2020,Septiembre,Bosnia y Herzegovina,70,1,0,1,"(3.541112,-76.384584)"
2018,Noviembre,Portugal,620,1,3,4,"(10.408582,-75.538003)"
2021,Diciembre,Bermudas/Territorio Británico de Ultramar,60,0,1,1,"(10.445761,-75.516429)"
2021,Febrero,Irán,364,0,2,2,"(6.171601,-75.427454)"
2018,Julio,San Cristóbal y Nevis,659,4,7,11,"(10.886611,-74.776708)"
2013,Agosto,Guatemala,320,168,378,546,"(4.697144,-74.140516)"
2019,Julio,China,156,1,1,2,"(11.360009,-72.129330)"
2020,Noviembre,Filipinas,608,1,6,7,"(3.541112,-76.384584)"
2020,Enero,Arabia Saudita,682,0,1,1,"(0.814836,-77.662532)"
2016,Marzo,Japón,392,10,28,38,"(0.814836,-77.662532)"
2013,Abril,Chile,152,0,1,1,"(7.128456,-73.183637)"
2022,Octubre,India,356,0,58,58,"(10.408582,-75.538003)"
2013,Octubre,Jordania,400,0,2,2,"(3.541112,-76.384584)"
2019,Mayo,Alemania,276,0,1,1,"(7.128456,-73.183637)"
2012,Junio,Cuba,192,1,0,1,"(11.360009,-72.129330)"
2016,Octubre,República Dominicana,214,35,57,92,"(3.541112,-76.384584)"
2022,Octubre,Perú,604,1,5,6,"(7.128456,-73.183637)"
2013,Noviembre,China,156,12,26,38,"(6.171601,-75.427454)"
2018,Noviembre,Portugal,620,3,2,5,"(11.360009,-72.129330)"
2015,Julio,Portugal,620,23,42,65,"(6.171601,-75.427454)"
2021,Septiembre,Federación de Rusia,643,0,11,11,"(10.886611,-74.776708)"
2022,Julio,Austria,40,0,1,1,"(0.814836,-77.662532)"
2022,Enero,Honduras,340,55,40,95,"(10.445761,-75.516429)"
2016,Junio,Lituania,440,0,1,1,"(-4.197703,-69.941278)"
2015,Diciembre,Japón,392,1,4,5,"(8.635765,-77.346578)"
2016,Octubre,Santa Sede/Ciudad del Vaticano,336,0,2,2,"(4.697144,-74.140516)"
2013,Marzo,Estados Unidos de América,840,1,0,1,"(1.813928,-78.763924)"
2012,Marzo,España,724,1,0,1,"(0.25129,-76.875963)"
2018,Agosto,Bahamas,44,3,8,11,"(6.171601,-75.427454)"
2022,Octubre,Japón,392,1,0,1,"(7.128456,-73.183637)"
2021,Octubre,Guatemala,320,1,0,1,"(7.818934,-72.453226)"
2014,Febrero,Haití,332,0,2,2,"(10.886611,-74.776708)"
2017,Julio,Taiwán,158,64,94,158,"(4.697144,-74.140516)"
2016,Mayo,Austria,40,0,1,1,"(11.247723,-74.213989)"
2016,Diciembre,Países Bajos,528,3,8,11,"(11.360009,-72.129330)"
2012,Abril,Reino Unido de Gran Bretaña e Irlanda del Norte,826,3,10,13,"(4.697144,-74.140516)"
2016,Noviembre,Perú,604,155,115,270,"(10.445761,-75.516429)"
2017,Octubre,Italia,380,1,1,2,"(-4.223468,-69.945098)"
2018,Junio,Dominica,212,1,1,2,"(10.445761,-75.516429)"
2022,Septiembre,Venezuela,862,783,660,1443,"(8.36068,-72.409396)"
2015,Mayo,Finlandia,246,0,3,3,"(3.541112,-76.384584)"
2018,Octubre,Paraguay,600,2,1,3,"(10.408582,-75.538003)"
2023,Marzo,Vietnam,704,0,5,5,"(10.408582,-75.538003)"
2014,Junio,Países Bajos,528,706,1079,1785,"(4.697144,-74.140516)"
2012,Abril,Panamá,591,2,3,5,"(11.360009,-72.129330)"
2019,Agosto,Grecia,300,34,83,117,"(4.697144,-74.140516)"
2017,Octubre,Suiza,756,8,10,18,"(10.886611,-74.776708)"
2013,Noviembre,República de Corea,410,157,448,605,"(4.697144,-74.140516)"
2018,Junio,Panamá,591,1351,1508,2859,"(4.697144,-74.140516)"
2016,Diciembre,Honduras,340,241,256,497,"(4.697144,-74.140516)"
2016,Agosto,Egipto,818,0,1,1,"(3.541112,-76.384584)"
2012,Julio,Santa Lucia,662,2,0,2,"(7.128456,-73.183637)"
2012,Septiembre,República Dominicana,214,24,76,100,"(6.171601,-75.427454)"
2018,Junio,Suecia,752,22,32,54,"(10.445761,-75.516429)"
2022,Noviembre,Alemania,276,2,2,4,"(12.586067,-81.702563)"
2018,Marzo,Lituania,440,2,1,3,"(6.171601,-75.427454)"
2017,Diciembre,Guatemala,320,11,17,28,"(4.815061,-75.736532)"
2017,Diciembre,Brasil,76,28,41,69,"(0.814836,-77.662532)"
2018,Agosto,Túnez,788,5,7,12,"(4.697144,-74.140516)"
2015,Marzo,China,156,0,1,1,"(11.247723,-74.213989)"
2013,Marzo,República de Irlanda,372,0,1,1,"(7.818934,-72.453226)"
2022,Noviembre,Barbados,52,3,2,5,"(10.445761,-75.516429)"
2015,Febrero,Federación de Rusia,643,0,1,1,"(7.927209,-72.507910)"
2020,Noviembre,Nigeria,566,0,1,1,"(3.541112,-76.384584)"
2017,Mayo,Perú,604,1,3,4,"(8.36068,-72.409396)"
2018,Diciembre,Polonia,616,2,3,5,"(-4.197703,-69.941278)"
2014,Febrero,España,724,157,289,446,"(3.541112,-76.384584)"
2021,Junio,Uzbekistán,860,0,1,1,"(4.697144,-74.140516)"
2015,Enero,El Salvador,222,1,2,3,"(10.886611,-74.776708)"
2023,Abril,Serbia,688,0,1,1,"(3.541112,-76.384584)"
2014,Agosto,Italia,380,0,6,6,"(7.128456,-73.183637)"
2012,Febrero,India,356,23,284,307,"(4.697144,-74.140516)"
2018,Marzo,México,484,31,40,71,"(10.408582,-75.538003)"
2017,Junio,Guatemala,320,1,3,4,"(7.818934,-72.453226)"
2022,Agosto,Canadá,124,255,567,822,"(6.171601,-75.427454)"
2019,Marzo,Filipinas,608,1,24,25,"(10.971302,-74.765397)"
2012,Mayo,Singapur,702,9,15,24,"(4.697144,-74.140516)"
2015,Febrero,Portugal,620,209,487,696,"(4.697144,-74.140516)"
2015,Septiembre,Países Bajos,528,204,366,570,"(6.171601,-75.427454)"
2018,Diciembre,Honduras,340,1,1,2,"(0.25129,-76.875963)"
2018,Enero,España,724,2814,5473,8287,"(4.697144,-74.140516)"
2022,Octubre,Kuwait,414,0,4,4,"(4.697144,-74.140516)"
2018,Agosto,Marruecos,504,12,26,38,"(4.697144,-74.140516)"
2015,Octubre,Taiwán,158,3,11,14,"(6.171601,-75.427454)"
2023,Mayo,Angola,24,0,5,5,"(4.697144,-74.140516)"
2022,Febrero,Suecia,752,12,21,33,"(10.445761,-75.516429)"
2019,Diciembre,Taiwán,158,1,1,2,"(8.635765,-77.346578)"
2022,Marzo,Nepal,524,2,11,13,"(4.697144,-74.140516)"
2022,Julio,Guyana,328,11,14,25,"(4.697144,-74.140516)"
2018,Marzo,Albania,8,1,0,1,"(10.445761,-75.516429)"
2022,Mayo,Noruega,578,9,11,20,"(6.171601,-75.427454)"
2015,Agosto,Italia,380,0,7,7,"(10.408582,-75.538003)"
2023,Marzo,Vietnam,704,0,3,3,"(11.247723,-74.213989)"
2019,Octubre,Suecia,752,16,31,47,"(6.171601,-75.427454)"
2023,Junio,Bulgaria,100,41,41,82,"(4.697144,-74.140516)"
2022,Enero,Santa Lucia,662,0,1,1,"(3.541112,-76.384584)"
2013,Septiembre,Sudáfrica,710,0,3,3,"(3.541112,-76.384584)"
2019,Septiembre,Canadá,124,123,164,287,"(10.445761,-75.516429)"
2016,Mayo,Túnez,788,2,9,11,"(4.697144,-74.140516)"
2019,Julio,Costa Rica,188,191,121,312,"(12.586067,-81.702563)"
2021,Septiembre,Federación de Rusia,643,1,0,1,"(4.452882,-75.766298)"
2014,Febrero,Portugal,620,2,1,3,"(-4.197703,-69.941278)"
2020,Enero,Macedonia,807,1,0,1,"(4.452882,-75.766298)"
2017,Febrero,Perú,604,549,411,960,"(12.586067,-81.702563)"
2017,Junio,Liechtenstein,438,0,1,1,"(6.171601,-75.427454)"
2014,Diciembre,Egipto,818,5,14,19,"(4.697144,-74.140516)"
2016,Mayo,Ecuador,218,0,3,3,"(11.360009,-72.129330)"
2012,Julio,Rumania,642,0,1,1,"(10.445761,-75.516429)"
2023,Junio,Ghana,288,0,3,3,"(10.445761,-75.516429)"
2019,Noviembre,Paraguay,600,27,12,39,"(3.541112,-76.384584)"
2013,Julio,Federación de Rusia,643,4,3,7,"(6.171601,-75.427454)"
2017,Marzo,Filipinas,608,6,55,61,"(10.445761,-75.516429)"
2013,Marzo,Dinamarca,208,2,4,6,"(11.360009,-72.129330)"
2013,Noviembre,Lituania,440,1,1,2,"(3.541112,-76.384584)"
2015,Octubre,Filipinas,608,4,8,12,"(6.171601,-75.427454)"
2022,Abril,República Checa,203,1,0,1,"(4.815061,-75.736532)"
2012,Agosto,Venezuela,862,5,1,6,"(0.25129,-76.875963)"
2020,Noviembre,Grecia,300,0,1,1,"(12.165168,-71.983761)"
2015,Abril,Ucrania,804,13,13,26,"(0.814836,-77.662532)"
2014,Octubre,Belice,84,0,3,3,"(6.171601,-75.427454)"
2018,Febrero,Reino Unido de Gran Bretaña e Irlanda del Norte,826,0,1,1,"(11.360009,-72.129330)"
2012,Julio,Nicaragua,558,5,4,9,"(3.541112,-76.384584)"
2012,Abril,Guatemala,320,2,12,14,"(10.886611,-74.776708)"
2017,Marzo,Perú,604,2,1,3,"(4.815061,-75.736532)"
2016,Diciembre,Noruega,578,0,2,2,"(11.247723,-74.213989)"
2017,Diciembre,Rumania,642,1,3,4,"(0.814836,-77.662532)"
2020,Agosto,India,356,1,1,2,"(4.697144,-74.140516)"
2018,Julio,San Cristóbal y Nevis,659,3,14,17,"(4.697144,-74.140516)"
2016,Enero,Filipinas,608,5,39,44,"(10.445761,-75.516429)"
2016,Febrero,México,484,52,154,206,"(3.541112,-76.384584)"
2013,Enero,Francia,250,0,1,1,"(7.088729,-70.740253)"
2013,Noviembre,Haití,332,0,3,3,"(3.541112,-76.384584)"
2022,Enero,Portugal,620,0,1,1,"(4.452882,-75.766298)"
2013,Mayo,Tailandia,764,1,1,2,"(0.814836,-77.662532)"
2017,Octubre,Francia,250,116,240,356,"(6.171601,-75.427454)"
2022,Abril,Italia,380,37,41,78,"(7.818934,-72.453226)"
2022,Abril,Azerbaiyán,31,6,10,16,"(6.171601,-75.427454)"
2013,Enero,Lituania,440,1,0,1,"(10.445761,-75.516429)"
2018,Noviembre,Alemania,276,18,17,35,"(-4.197703,-69.941278)"
2019,Septiembre,San  Vicente y las Granadinas,670,0,1,1,"(11.247723,-74.213989)"
2017,Julio,Argentina,32,99,164,263,"(0.814836,-77.662532)"
2017,Abril,Sudán,736,0,1,1,"(10.445761,-75.516429)"
2022,Diciembre,Costa Rica,188,1,1,2,"(7.916725,-72.462544)"
2016,Agosto,Suiza,756,379,515,894,"(4.697144,-74.140516)"
2013,Diciembre,Chile,152,0,2,2,"(7.128456,-73.183637)"
2012,Noviembre,Alemania,276,7,11,18,"(10.886611,-74.776708)"
2015,Diciembre,Ecuador,218,34,58,92,"(1.813928,-78.763924)"
2014,Agosto,Taiwán,158,1,0,1,"(-4.197703,-69.941278)"
2016,Abril,Perú,604,0,6,6,"(4.815061,-75.736532)"
2023,Marzo,Perú,604,30,13,43,"(11.117806,-74.232622)"
2016,Enero,Aruba,533,1,0,1,"(3.541112,-76.384584)"
2019,Agosto,Francia,250,181,294,476,"(10.445761,-75.516429)"
2016,Abril,Lituania,440,15,10,25,"(4.697144,-74.140516)"
2019,Mayo,Cuba,192,0,5,5,"(4.815061,-75.736532)"
2019,Agosto,República Checa,203,0,1,1,"(10.971302,-74.765397)"
2021,Junio,Bolivia,68,1,1,2,"(10.886611,-74.776708)"
2023,Mayo,Reino Unido de Gran Bretaña e Irlanda del Norte,826,0,1,1,"(0.25129,-76.875963)"
2014,Abril,México,484,20,32,52,"(0.814836,-77.662532)"
2012,Abril,República de Corea,410,7,20,27,"(6.171601,-75.427454)"
2017,Diciembre,Palestina,99999,2,0,2,"(4.697144,-74.140516)"
2016,Octubre,República Dominicana,214,10,13,23,"(0.814836,-77.662532)"
2015,Marzo,Perú,604,122,171,293,"(7.818934,-72.453226)"
2020,Septiembre,Cuba,192,1,3,4,"(6.171601,-75.427454)"
2013,Marzo,Bahamas,44,0,1,1,"(6.171601,-75.427454)"
2016,Enero,Albania,8,1,1,2,"(10.445761,-75.516429)"
2023,Enero,Letonia,428,0,1,1,"(4.452882,-75.766298)"
2013,Noviembre,Canadá,124,1,1,2,"(7.927209,-72.507910)"
2013,Agosto,Honduras,340,2,2,4,"(10.886611,-74.776708)"
2016,Agosto,Paraguay,600,28,18,46,"(3.541112,-76.384584)"
2018,Febrero,Costa Rica,188,1010,1223,2233,"(4.697144,-74.140516)"
2022,Septiembre,Israel,376,18,35,53,"(0.814836,-77.662532)"
2021,Octubre,Turquía,792,197,357,554,"(4.697144,-74.140516)"
2015,Noviembre,Dominica,212,0,1,1,"(10.886611,-74.776708)"
2022,Enero,Macedonia,807,1,1,2,"(10.445761,-75.516429)"
2017,Diciembre,República Checa,203,1,0,1,"(7.128456,-73.183637)"
2012,Marzo,Isla de Man,833,1,38,39,"(10.886611,-74.776708)"
2014,Febrero,Eslovenia,705,0,1,1,"(4.815061,-75.736532)"
2020,Junio,Sri Lanka,144,0,1,1,"(4.697144,-74.140516)"
2019,Octubre,Costa Rica,188,0,6,6,"(1.813928,-78.763924)"
2012,Octubre,Hungría,348,11,22,33,"(4.697144,-74.140516)"
2017,Noviembre,Hungría,348,2,0,2,"(0.814836,-77.662532)"
2018,Septiembre,Egipto,818,0,2,2,"(3.541112,-76.384584)"
2019,Septiembre,Ghana,288,0,1,1,"(9.402978,-75.681599)"
2017,Septiembre,Sri Lanka,144,0,1,1,"(10.445761,-75.516429)"
2023,Abril,Argentina,32,514,435,949,"(10.445761,-75.516429)"
2023,Marzo,Panamá,591,48,38,86,"(11.117806,-74.232622)"
2018,Mayo,Antigua y Barbuda,28,0,1,1,"(10.445761,-75.516429)"
2018,Abril,Santa Lucia,662,3,8,11,"(4.697144,-74.140516)"
2013,Marzo,Eslovaquia,703,1,1,2,"(10.886611,-74.776708)"
2016,Julio,Australia,36,1,1,2,"(4.815061,-75.736532)"
2017,Abril,Guinea Bissau,624,1,0,1,"(4.697144,-74.140516)"
2023,Enero,Malta,470,8,13,21,"(4.697144,-74.140516)"
2013,Octubre,Marruecos,504,1,0,1,"(6.171601,-75.427454)"
2016,Marzo,El Salvador,222,26,29,55,"(12.586067,-81.702563)"
2015,Mayo,Suecia,752,1,1,2,"(-4.223468,-69.945098)"
2022,Octubre,Venezuela,862,12,7,19,"(0.25129,-76.875963)"
2020,Enero,Luxemburgo,442,2,3,5,"(6.171601,-75.427454)"
2017,Enero,Singapur,702,1,2,3,"(6.171601,-75.427454)"
2015,Marzo,Francia,250,3,2,5,"(-4.223468,-69.945098)"
2015,Enero,España,724,1,1,2,"(12.5744111,-81.703935)"
2022,Abril,Sri Lanka,144,0,3,3,"(10.445761,-75.516429)"
2015,Junio,Panamá,591,2,5,7,"(7.818934,-72.453226)"
2016,Enero,Paraguay,600,13,6,19,"(3.541112,-76.384584)"
2014,Septiembre,Grecia,300,20,49,69,"(4.697144,-74.140516)"
2016,Abril,Bangladesh,50,0,1,1,"(0.814836,-77.662532)"
2012,Septiembre,Irán,364,3,12,15,"(4.697144,-74.140516)"
2019,Enero,México,484,11,6,17,"(-4.223468,-69.945098)"
2022,Enero,México,484,0,1,1,"(12.5744111,-81.703935)"
2017,Abril,Nigeria,566,0,11,11,"(4.697144,-74.140516)"
2019,Septiembre,Guyana,328,9,1,10,"(3.541112,-76.384584)"
2012,Octubre,Estados Unidos de América,840,11,15,26,"(-4.197703,-69.941278)"
2021,Octubre,Guyana,328,0,6,6,"(10.445761,-75.516429)"
2017,Marzo,Dinamarca,208,15,11,26,"(0.814836,-77.662532)"
2019,Noviembre,Noruega,578,2,13,15,"(10.408582,-75.538003)"
2019,Enero,Eslovaquia,703,50,95,145,"(4.697144,-74.140516)"
2013,Enero,Chipre,196,1,3,4,"(4.697144,-74.140516)"
2012,Febrero,Islandia,352,6,8,14,"(4.697144,-74.140516)"
2016,Agosto,Australia,36,5,11,16,"(3.541112,-76.384584)"
2018,Agosto,Estonia,233,1,6,7,"(4.697144,-74.140516)"
2021,Febrero,Japón,392,1,3,4,"(6.171601,-75.427454)"
2022,Diciembre,Honduras,340,109,90,199,"(10.445761,-75.516429)"
2012,Marzo,Jamaica,388,1,2,3,"(3.541112,-76.384584)"
2018,Enero,Costa Rica,188,4,2,6,"(7.128456,-73.183637)"
2018,Agosto,Costa Rica,188,1,0,1,"(10.408582,-75.538003)"
2022,Mayo,Guatemala,320,35,64,99,"(3.541112,-76.384584)"
2022,Junio,República de Tayikistán,762,1,0,1,"(6.171601,-75.427454)"
2019,Junio,Reino Unido de Gran Bretaña e Irlanda del Norte,826,0,6,6,"(12.586067,-81.702563)"
2014,Octubre,Chile,152,0,1,1,"(7.927209,-72.507910)"
2015,Febrero,Ecuador,218,1,2,3,"(4.815061,-75.736532)"
2022,Agosto,Países Bajos,528,1,4,5,"(11.247723,-74.213989)"
2014,Mayo,Francia,250,15,44,59,"(3.541112,-76.384584)"
2022,Mayo,Reino Unido de Gran Bretaña e Irlanda del Norte,826,1,3,4,"(11.360009,-72.129330)"
2014,Marzo,Argentina,32,236,158,394,"(10.408582,-75.538003)"
2018,Mayo,Túnez,788,0,1,1,"(3.541112,-76.384584)"
2015,Mayo,Taiwán,158,5,2,7,"(0.814836,-77.662532)"
2020,Marzo,Canadá,124,8,17,25,"(0.814836,-77.662532)"
2023,Abril,Albania,8,3,0,3,"(10.445761,-75.516429)"
2020,Diciembre,Japón,392,0,14,14,"(10.408582,-75.538003)"
2019,Abril,Israel,376,0,2,2,"(0.25129,-76.875963)"
2019,Julio,Turquía,792,160,348,508,"(4.697144,-74.140516)"
2018,Mayo,Surinam,740,0,1,1,"(0.814836,-77.662532)"
2017,Septiembre,Eslovaquia,703,1,1,2,"(-4.197703,-69.941278)"
2023,Junio,Guyana,328,9,11,20,"(10.445761,-75.516429)"
2023,Junio,Francia,250,1,1,2,"(13.3387613,-81.372937)"
2016,Marzo,Estados Unidos de América,840,1103,1363,2466,"(3.541112,-76.384584)"
2015,Mayo,Austria,40,1,6,7,"(10.445761,-75.516429)"
2013,Junio,India,356,33,220,253,"(4.697144,-74.140516)"
2019,Agosto,Bulgaria,100,1,1,2,"(3.541112,-76.384584)"
2019,Agosto,República de Corea,410,11,11,22,"(0.814836,-77.662532)"
2017,Junio,Cuba,192,17,36,53,"(6.171601,-75.427454)"
2022,Diciembre,Canadá,124,1,3,4,"(11.360009,-72.129330)"
2022,Enero,República de Corea,410,73,136,209,"(4.697144,-74.140516)"
2021,Septiembre,Polonia,616,0,3,3,"(10.971302,-74.765397)"
2012,Septiembre,Isla de Man,833,3,6,9,"(0.814836,-77.662532)"
2018,Junio,Vietnam,704,2,0,2,"(6.171601,-75.427454)"
2019,Octubre,México,484,4,2,6,"(12.586067,-81.702563)"
2016,Agosto,Bolivia,68,53,38,91,"(10.445761,-75.516429)"
2013,Octubre,Filipinas,608,1,78,79,"(10.408582,-75.538003)"
2015,Noviembre,Alemania,276,14,16,30,"(10.886611,-74.776708)"
2016,Agosto,Bélgica,56,0,7,7,"(10.971302,-74.765397)"
2022,Noviembre,Ecuador,218,4,6,10,"(4.815061,-75.736532)"
2016,Mayo,El Salvador,222,1,0,1,"(4.815061,-75.736532)"
2021,Marzo,Honduras,340,18,15,33,"(3.541112,-76.384584)"
2013,Mayo,Noruega,578,1,8,9,"(6.171601,-75.427454)"
2016,Febrero,República Dominicana,214,1,2,3,"(7.927209,-72.507910)"
2018,Enero,El Salvador,222,1,1,2,"(0.25129,-76.875963)"
2016,Mayo,Francia,250,1,2,3,"(4.452882,-75.766298)"
2012,Abril,Estados Unidos de América,840,551,1010,1561,"(3.541112,-76.384584)"
2017,Septiembre,Perú,604,5,13,18,"(11.360009,-72.129330)"
2018,Enero,Nicaragua,558,21,10,31,"(3.541112,-76.384584)"
2017,Agosto,Italia,380,9,35,44,"(10.886611,-74.776708)"
2013,Febrero,Turquía,792,17,56,73,"(4.697144,-74.140516)"
2023,Enero,Luxemburgo,442,0,1,1,"(-4.197703,-69.941278)"
2015,Febrero,Chile,152,4,0,4,"(8.635765,-77.346578)"
2023,Mayo,Australia,36,1,3,4,"(7.128456,-73.183637)"
2021,Marzo,Federación de Rusia,643,0,1,1,"(10.971302,-74.765397)"
2012,Noviembre,Noruega,578,5,4,9,"(3.541112,-76.384584)"
2015,Octubre,Zambia,894,2,0,2,"(10.445761,-75.516429)"
2012,Mayo,México,484,1,8,9,"(10.408582,-75.538003)"
2017,Febrero,Alemania,276,1,1,2,"(1.813928,-78.763924)"
2022,Agosto,Países Bajos,528,11,6,17,"(7.128456,-73.183637)"
2023,Enero,Alemania,276,68,69,137,"(0.814836,-77.662532)"
2019,Noviembre,Haití,332,1,1,2,"(3.541112,-76.384584)"
2015,Octubre,República Árabe de Yemen,887,0,1,1,"(4.697144,-74.140516)"
2020,Febrero,Argentina,32,4755,6067,10822,"(4.697144,-74.140516)"
2014,Marzo,Finlandia,246,2,2,4,"(6.171601,-75.427454)"
2019,Enero,Hungría,348,0,1,1,"(12.586067,-81.702563)"
2017,Octubre,Países Bajos,528,6,3,9,"(4.815061,-75.736532)"
2012,Agosto,Venezuela,862,462,289,751,"(10.445761,-75.516429)"
2014,Mayo,Bahamas,44,0,2,2,"(4.697144,-74.140516)"
2019,Marzo,Luxemburgo,442,0,3,3,"(10.445761,-75.516429)"
2012,Agosto,Croacia,191,6,27,33,"(4.697144,-74.140516)"
2015,Agosto,Federación de Rusia,643,0,7,7,"(10.408582,-75.538003)"
2020,Enero,Lituania,440,0,2,2,"(0.814836,-77.662532)"
2021,Octubre,Cuba,192,99,104,204,"(4.697144,-74.140516)"
2022,Agosto,Noruega,578,5,2,7,"(3.541112,-76.384584)"
2019,Abril,Dinamarca,208,2,2,4,"(4.815061,-75.736532)"
2013,Mayo,Reino Unido de Gran Bretaña e Irlanda del Norte,826,13,38,51,"(10.445761,-75.516429)"
2015,Abril,México,484,22,36,58,"(0.814836,-77.662532)"
2022,Marzo,Ucrania,804,0,2,2,"(9.402978,-75.681599)"
2014,Octubre,Níger,562,0,2,2,"(4.697144,-74.140516)"
2013,Enero,Dominica,212,0,1,1,"(3.541112,-76.384584)"
2015,Mayo,Panamá,591,0,1,1,"(0.812436,-77.847006)"
2018,Mayo,Canadá,124,0,1,1,"(0.25129,-76.875963)"
2021,Noviembre,Jordania,400,1,4,5,"(4.697144,-74.140516)"
2018,Febrero,Japón,392,18,52,70,"(6.171601,-75.427454)"
2015,Abril,Nueva Zelanda,554,0,1,1,"(13.3387613,-81.372937)"
2017,Abril,Italia,380,2,16,18,"(7.818934,-72.453226)"
2021,Enero,Desconocido,99999,22,33,55,"(4.697144,-74.140516)"
2019,Mayo,Ucrania,804,0,1,1,"(0.814836,-77.662532)"
2018,Mayo,Estados Unidos de América,840,0,6,6,"(12.5744111,-81.703935)"
2020,Agosto,Austria,40,1,0,1,"(4.697144,-74.140516)"
2019,Agosto,Estados Unidos de América,840,20,36,56,"(-4.197703,-69.941278)"
2017,Agosto,China,156,1,2,3,"(4.815061,-75.736532)"
2018,Agosto,Alemania,276,14,12,26,"(-4.197703,-69.941278)"
2023,Marzo,Ecuador,218,35,32,67,"(7.818934,-72.453226)"
2012,Marzo,Finlandia,246,0,1,1,"(11.360009,-72.129330)"
2012,Octubre,San  Vicente y las Granadinas,670,1,0,1,"(0.814836,-77.662532)"
2016,Abril,México,484,1,2,3,"(8.635765,-77.346578)"
2016,Agosto,Uruguay,858,0,1,1,"(0.25129,-76.875963)"
2015,Agosto,Letonia,428,2,0,2,"(10.445761,-75.516429)"
2020,Noviembre,Polonia,616,0,5,5,"(10.408582,-75.538003)"
2019,Abril,República Checa,203,2,1,3,"(3.541112,-76.384584)"
2020,Julio,Chile,152,0,1,1,"(0.814836,-77.662532)"
2019,Febrero,Desconocido,99999,0,1,1,"(7.818934,-72.453226)"
2016,Octubre,Hungría,348,0,2,2,"(0.814836,-77.662532)"
2018,Agosto,Vietnam,704,6,4,10,"(4.697144,-74.140516)"
2012,Mayo,Ecuador,218,4,10,14,"(10.886611,-74.776708)"
2012,Abril,España,724,7,18,25,"(10.886611,-74.776708)"
2017,Noviembre,Turquía,792,2,14,16,"(6.171601,-75.427454)"
2022,Noviembre,India,356,114,484,598,"(4.697144,-74.140516)"
2023,Abril,Bolivia,68,37,31,68,"(6.171601,-75.427454)"
2015,Septiembre,Bélgica,56,0,4,4,"(10.886611,-74.776708)"
2018,Diciembre,Perú,604,3,4,7,"(7.088729,-70.740253)"
2022,Junio,Nicaragua,558,11,4,15,"(10.886611,-74.776708)"
2015,Octubre,Ecuador,218,544,592,1136,"(3.541112,-76.384584)"
2012,Marzo,Perú,604,43,65,108,"(7.818934,-72.453226)"
2013,Septiembre,Bolivia,68,20,36,56,"(10.445761,-75.516429)"
2017,Abril,Dominica,212,2,0,2,"(4.697144,-74.140516)"
2020,Febrero,Alemania,276,382,500,882,"(6.171601,-75.427454)"
2015,Agosto,República Checa,203,1,1,2,"(7.128456,-73.183637)"
2023,Marzo,Países Bajos,528,38,49,87,"(10.408582,-75.538003)"
2022,Octubre,Italia,380,4,2,6,"(0.25129,-76.875963)"
2022,Junio,Vietnam,704,1,2,3,"(6.171601,-75.427454)"
2012,Agosto,Costa Rica,188,0,2,2,"(0.814836,-77.662532)"
2015,Octubre,Japón,392,0,4,4,"(7.818934,-72.453226)"
2015,Enero,Perú,604,0,1,1,"(10.971302,-74.765397)"
2022,Junio,Países Bajos,528,59,117,176,"(10.886611,-74.776708)"
2019,Diciembre,República de Kosovo,901,0,1,1,"(4.697144,-74.140516)"
2017,Febrero,China,156,27,52,79,"(6.171601,-75.427454)"
2018,Marzo,Noruega,578,0,1,1,"(11.247723,-74.213989)"
2022,Agosto,Argentina,32,14,19,33,"(7.916725,-72.462544)"
2017,Agosto,India,356,0,2,2,"(11.247723,-74.213989)"
2015,Septiembre,Uruguay,858,23,56,79,"(6.171601,-75.427454)"
2021,Mayo,Reino Unido de Gran Bretaña e Irlanda del Norte,826,2,0,2,"(7.818934,-72.453226)"
2018,Diciembre,Perú,604,206,360,566,"(0.814836,-77.662532)"
2021,Agosto,Bulgaria,100,16,17,33,"(4.697144,-74.140516)"
2013,Febrero,Japón,392,153,415,568,"(4.697144,-74.140516)"
2019,Septiembre,Ucrania,804,0,1,1,"(3.893038,-77.067921)"
2012,Abril,Estados Unidos de América,840,38,68,106,"(4.815061,-75.736532)"
2019,Octubre,Venezuela,862,0,3,3,"(12.165168,-71.983761)"
2023,Mayo,Emiratos Árabes,784,0,5,5,"(6.171601,-75.427454)"
2015,Noviembre,México,484,7,11,18,"(7.128456,-73.183637)"
2012,Febrero,Uganda,800,0,3,3,"(4.697144,-74.140516)"
2013,Junio,Kazajistán,398,4,1,5,"(4.697144,-74.140516)"
2016,Junio,Argentina,32,275,207,482,"(10.445761,-75.516429)"
2018,Mayo,Francia,250,8,11,19,"(8.635765,-77.346578)"
2022,Noviembre,Canadá,124,0,1,1,"(0.25129,-76.875963)"
2016,Diciembre,Ecuador,218,2942,3386,6328,"(4.697144,-74.140516)"
2014,Febrero,Desconocido,99999,36,61,97,"(4.697144,-74.140516)"
2014,Octubre,Ucrania,804,0,4,4,"(10.971302,-74.765397)"
2022,Abril,Portugal,620,1,1,2,"(12.5744111,-81.703935)"
2017,Septiembre,Bahamas,44,13,9,22,"(10.445761,-75.516429)"
2019,Febrero,España,724,24,39,63,"(10.408582,-75.538003)"
2014,Abril,Japón,392,12,57,69,"(6.171601,-75.427454)"
2020,Marzo,India,356,1,9,10,"(3.541112,-76.384584)"
2016,Abril,Croacia,191,1,7,8,"(6.171601,-75.427454)"
2017,Junio,Israel,376,0,1,1,"(0.25129,-76.875963)"
2017,Enero,Chile,152,4468,5100,9568,"(4.697144,-74.140516)"
2021,Noviembre,República Checa,203,1,1,2,"(3.541112,-76.384584)"
2018,Noviembre,Taiwán,158,12,8,20,"(6.171601,-75.427454)"
2013,Octubre,Países Bajos,528,0,2,2,"(10.886611,-74.776708)"
2016,Julio,República de Irlanda,372,9,7,16,"(10.408582,-75.538003)"
2013,Septiembre,Líbano,422,3,5,8,"(11.360009,-72.129330)"
2019,Agosto,Malasia,458,15,12,27,"(4.697144,-74.140516)"
2022,Abril,Bermudas/Territorio Británico de Ultramar,60,0,4,4,"(10.445761,-75.516429)"
2023,Enero,República Dominicana,214,1,8,9,"(10.408582,-75.538003)"
2012,Mayo,Uruguay,858,71,40,111,"(12.586067,-81.702563)"
2013,Julio,Taiwán,158,7,10,17,"(6.171601,-75.427454)"
2023,Junio,Polonia,616,1,0,1,"(0.25129,-76.875963)"
2018,Mayo,Azerbaiyán,31,0,2,2,"(6.171601,-75.427454)"
2012,Febrero,Canadá,124,2,8,10,"(11.360009,-72.129330)"
2012,Enero,Surinam,740,0,3,3,"(3.541112,-76.384584)"
2020,Octubre,Honduras,340,4,1,5,"(10.886611,-74.776708)"
2013,Junio,Grecia,300,0,1,1,"(10.445761,-75.516429)"
2016,Septiembre,Malí,466,0,1,1,"(4.697144,-74.140516)"
2021,Septiembre,España,724,0,2,2,"(8.36068,-72.409396)"
2022,Diciembre,Portugal,620,11,16,27,"(7.916725,-72.462544)"
2018,Enero,Desconocido,99999,0,4,4,"(7.818934,-72.453226)"
2018,Abril,Jamaica,388,0,1,1,"(0.814836,-77.662532)"
2012,Noviembre,Austria,40,5,6,11,"(6.171601,-75.427454)"
2017,Junio,República Dominicana,214,56,67,123,"(6.171601,-75.427454)"
2019,Mayo,Venezuela,862,0,2,2,"(11.247723,-74.213989)"
2016,Julio,Malta,470,0,1,1,"(10.445761,-75.516429)"
2019,Marzo,Ecuador,218,0,1,1,"(11.117806,-74.232622)"
2013,Febrero,Rumania,642,1,1,2,"(10.408582,-75.538003)"
2019,Enero,Montenegro,499,1,2,3,"(10.445761,-75.516429)"
2013,Noviembre,Ecuador,218,1,43,44,"(10.408582,-75.538003)"
2022,Febrero,Honduras,340,48,60,108,"(6.171601,-75.427454)"
2023,Febrero,Finlandia,246,0,1,1,"(11.117806,-74.232622)"
2019,Mayo,Brasil,76,648,494,1142,"(10.445761,-75.516429)"
2012,Marzo,Barbados,52,0,1,1,"(6.171601,-75.427454)"
2017,Diciembre,Rumania,642,1,3,4,"(10.408582,-75.538003)"
2019,Abril,Bahamas,44,0,4,4,"(6.171601,-75.427454)"
2013,Diciembre,Uganda,800,0,1,1,"(10.445761,-75.516429)"
2022,Noviembre,Suecia,752,3,2,5,"(11.247723,-74.213989)"
2019,Julio,Noruega,578,5,5,10,"(3.541112,-76.384584)"
2013,Noviembre,Brasil,76,0,1,1,"(8.635765,-77.346578)"
2015,Junio,Bolivia,68,15,11,26,"(10.445761,-75.516429)"
2015,Febrero,Granada,308,1,1,2,"(4.697144,-74.140516)"
2022,Junio,Lituania,440,0,1,1,"(10.408582,-75.538003)"
2020,Diciembre,República de Irlanda,372,0,13,13,"(6.171601,-75.427454)"
2022,Febrero,Japón,392,0,1,1,"(7.916725,-72.462544)"
2015,Mayo,México,484,8,10,18,"(10.408582,-75.538003)"
2018,Marzo,Serbia,688,11,21,32,"(4.697144,-74.140516)"
2022,Septiembre,Nueva Zelanda,554,0,1,1,"(7.128456,-73.183637)"
2014,Mayo,Polonia,616,1,2,3,"(3.541112,-76.384584)"
2022,Febrero,Estados Unidos de América,840,4620,10691,15311,"(6.171601,-75.427454)"
2012,Noviembre,Panamá,591,221,381,602,"(6.171601,-75.427454)"
2022,Mayo,República Dominicana,214,1573,1552,3125,"(4.697144,-74.140516)"
2019,Septiembre,República de Irlanda,372,0,1,1,"(4.452882,-75.766298)"
2023,Enero,Alemania,276,4,2,6,"(4.452882,-75.766298)"
2016,Marzo,Rwanda,646,1,0,1,"(6.171601,-75.427454)"
2023,Enero,Francia,250,0,1,1,"(10.971302,-74.765397)"
2013,Febrero,Reino Unido de Gran Bretaña e Irlanda del Norte,826,7,22,29,"(6.171601,-75.427454)"
2021,Diciembre,Bélgica,56,1,1,2,"(0.814836,-77.662532)"
2017,Septiembre,Estados Unidos de América,840,6467,11449,17916,"(4.697144,-74.140516)"
2016,Noviembre,Senegal,686,2,5,7,"(4.697144,-74.140516)"
2018,Enero,Venezuela,862,214,332,546,"(10.445761,-75.516429)"
2017,Septiembre,Polonia,616,14,18,32,"(6.171601,-75.427454)"
2019,Enero,Estados Unidos de América,840,2,4,6,"(8.36068,-72.409396)"
2012,Septiembre,Islandia,352,1,2,3,"(7.818934,-72.453226)"
2012,Diciembre,Uruguay,858,50,46,96,"(10.445761,-75.516429)"
2017,Octubre,Venezuela,862,5,10,15,"(7.128456,-73.183637)"
2015,Junio,República de Corea,410,0,1,1,"(0.25129,-76.875963)"
2019,Octubre,Francia,250,1869,2744,4613,"(4.697144,-74.140516)"
2021,Agosto,Costa Rica,188,2,1,3,"(7.128456,-73.183637)"
2016,Mayo,Rwanda,646,1,2,3,"(4.697144,-74.140516)"
2018,Septiembre,República de Corea,410,1,0,1,"(0.25129,-76.875963)"
2017,Noviembre,Etiopia,231,0,2,2,"(6.171601,-75.427454)"
2018,Septiembre,Costa de Marfil,384,0,1,1,"(4.815061,-75.736532)"
2020,Febrero,Costa Rica,188,37,24,61,"(12.586067,-81.702563)"
2017,Marzo,Reino Unido de Gran Bretaña e Irlanda del Norte,826,0,2,2,"(0.25129,-76.875963)"
2013,Enero,Ucrania,804,0,1,1,"(10.408582,-75.538003)"
2019,Junio,Tanzania,834,1,0,1,"(3.541112,-76.384584)"
2019,Febrero,Venezuela,862,6002,5983,11986,"(4.697144,-74.140516)"
2016,Agosto,Níger,562,1,0,1,"(4.697144,-74.140516)"
2023,Febrero,Dinamarca,208,0,1,1,"(7.818934,-72.453226)"
2019,Septiembre,Croacia,191,5,8,13,"(6.171601,-75.427454)"
2016,Agosto,Desconocido,99999,2,1,3,"(6.171601,-75.427454)"
2015,Junio,Portugal,620,213,506,719,"(4.697144,-74.140516)"
2016,Enero,Chile,152,13,20,33,"(10.886611,-74.776708)"
2023,Marzo,Jamaica,388,0,2,2,"(7.128456,-73.183637)"
2019,Septiembre,Croacia,191,1,1,2,"(0.25129,-76.875963)"
2014,Febrero,Cuba,192,0,1,1,"(4.452882,-75.766298)"
2013,Enero,Taiwán,158,0,2,2,"(0.814836,-77.662532)"
2012,Junio,Lituania,440,3,1,4,"(3.541112,-76.384584)"
2020,Febrero,Noruega,578,0,1,1,"(0.25129,-76.875963)"
2017,Mayo,Filipinas,608,0,3,3,"(10.971302,-74.765397)"
2018,Septiembre,Belice,84,0,1,1,"(11.360009,-72.129330)"
2019,Septiembre,Desconocido,99999,118,140,258,"(4.697144,-74.140516)"
2020,Febrero,Venezuela,862,178,190,368,"(3.541112,-76.384584)"
2017,Marzo,Venezuela,862,4146,5199,9345,"(4.697144,-74.140516)"
2017,Octubre,India,356,2,12,14,"(10.886611,-74.776708)"
2013,Abril,Kenia,404,2,0,2,"(3.541112,-76.384584)"
2016,Mayo,Desconocido,99999,0,5,5,"(3.541112,-76.384584)"
2012,Julio,Brasil,76,124,130,254,"(10.445761,-75.516429)"
2023,Abril,Portugal,620,0,3,3,"(4.815061,-75.736532)"
2023,Junio,Bolivia,68,0,1,1,"(0.25129,-76.875963)"
2014,Agosto,China,156,8,9,17,"(6.171601,-75.427454)"
2021,Agosto,Letonia,428,6,11,17,"(4.697144,-74.140516)"
2022,Diciembre,Bolivia,68,89,73,162,"(10.445761,-75.516429)"
2014,Noviembre,República Dominicana,214,46,51,97,"(6.171601,-75.427454)"
2021,Agosto,Brasil,76,165,120,285,"(10.445761,-75.516429)"
2015,Marzo,Luxemburgo,442,6,8,14,"(4.697144,-74.140516)"
2013,Abril,Bélgica,56,2,15,17,"(3.541112,-76.384584)"
2018,Junio,Perú,604,40,51,91,"(-4.223468,-69.945098)"
2019,Noviembre,Panamá,591,0,1,1,"(4.452882,-75.766298)"
2022,Julio,Ghana,288,0,1,1,"(7.818934,-72.453226)"
2013,Mayo,Alemania,276,1,2,3,"(12.586067,-81.702563)"
2018,Enero,Etiopia,231,0,1,1,"(10.445761,-75.516429)"
2019,Febrero,Francia,250,3,20,23,"(4.815061,-75.736532)"
2019,Julio,China,156,513,1096,1610,"(4.697144,-74.140516)"
2015,Marzo,Senegal,686,0,1,1,"(4.697144,-74.140516)"
2012,Septiembre,Chile,152,4,8,12,"(11.360009,-72.129330)"
2015,Diciembre,Venezuela,862,334,388,722,"(7.927209,-72.507910)"
2014,Septiembre,Portugal,620,0,1,1,"(12.586067,-81.702563)"
2023,Mayo,Austria,40,0,1,1,"(4.815061,-75.736532)"
2023,Enero,Francia,250,2,8,10,"(11.360009,-72.129330)"
2021,Octubre,Alemania,276,75,186,261,"(6.171601,-75.427454)"
2016,Mayo,Perú,604,4,10,14,"(0.25129,-76.875963)"
2013,Abril,Uruguay,858,0,1,1,"(-4.197703,-69.941278)"
2019,Mayo,Trinidad y Tobago,780,1,1,2,"(12.586067,-81.702563)"
2022,Diciembre,Perú,604,5,11,16,"(11.360009,-72.129330)"
2019,Octubre,República Dominicana,214,82,74,156,"(10.445761,-75.516429)"
2017,Marzo,Noruega,578,3,2,5,"(0.814836,-77.662532)"
2016,Febrero,Noruega,578,1,1,2,"(0.25129,-76.875963)"
2017,Noviembre,Ecuador,218,0,3,3,"(8.635765,-77.346578)"
2018,Abril,México,484,1,4,5,"(11.360009,-72.129330)"
2018,Agosto,Panamá,591,18,31,49,"(4.815061,-75.736532)"
2014,Julio,Burundi,108,1,0,1,"(4.697144,-74.140516)"
2018,Mayo,República Democrática del Congo,180,1,0,1,"(6.171601,-75.427454)"
2020,Diciembre,Panamá,591,3,9,12,"(7.128456,-73.183637)"
2020,Agosto,España,724,0,1,1,"(6.171601,-75.427454)"
2012,Abril,Noruega,578,2,3,5,"(3.541112,-76.384584)"
2017,Noviembre,Singapur,702,5,2,7,"(6.171601,-75.427454)"
2022,Diciembre,Burkina Faso,854,2,1,3,"(10.445761,-75.516429)"
2017,Agosto,República de Corea,410,1,1,2,"(-4.197703,-69.941278)"
2015,Mayo,Alemania,276,1,0,1,"(11.247723,-74.213989)"
2018,Marzo,República Dominicana,214,4,5,9,"(4.815061,-75.736532)"
2018,Septiembre,Bosnia y Herzegovina,70,0,1,1,"(3.541112,-76.384584)"
2015,Marzo,Croacia,191,13,30,43,"(4.697144,-74.140516)"
2012,Agosto,Perú,604,0,2,2,"(10.971302,-74.765397)"
2013,Junio,España,724,20,33,53,"(0.814836,-77.662532)"
2015,Abril,Honduras,340,0,4,4,"(10.886611,-74.776708)"
2013,Julio,Letonia,428,0,1,1,"(10.408582,-75.538003)"
2019,Abril,España,724,11,15,26,"(-4.223468,-69.945098)"
2022,Julio,Antigua y Barbuda,28,1,1,2,"(4.697144,-74.140516)"
2022,Julio,Francia,250,7,11,18,"(10.408582,-75.538003)"
2012,Septiembre,República Dominicana,214,0,1,1,"(12.586067,-81.702563)"
2015,Junio,República de Irlanda,372,1,1,2,"(7.818934,-72.453226)"
2017,Mayo,Guatemala,320,0,1,1,"(-4.223468,-69.945098)"
2022,Septiembre,Rumania,642,0,1,1,"(10.886611,-74.776708)"
2016,Noviembre,Canadá,124,934,1772,2706,"(4.697144,-74.140516)"
2016,Junio,Francia,250,2,0,2,"(7.927209,-72.507910)"
2019,Marzo,Venezuela,862,0,16,16,"(1.813928,-78.763924)"
2019,Enero,Japón,392,4,9,13,"(3.541112,-76.384584)"
2015,Mayo,Bélgica,56,1,1,2,"(12.586067,-81.702563)"
2019,Diciembre,Kazajistán,398,0,2,2,"(10.445761,-75.516429)"
2022,Septiembre,Vanuatu,548,0,1,1,"(3.541112,-76.384584)"
2015,Enero,Dinamarca,208,2,3,5,"(7.818934,-72.453226)"
2012,Abril,Perú,604,247,177,424,"(12.586067,-81.702563)"
2020,Marzo,México,484,14,25,39,"(10.886611,-74.776708)"
2015,Enero,España,724,6,15,21,"(11.360009,-72.129330)"
2019,Enero,Perú,604,3730,4145,7875,"(4.697144,-74.140516)"
2012,Noviembre,Rumania,642,5,6,11,"(6.171601,-75.427454)"
2022,Marzo,Bélgica,56,3,3,6,"(12.5744111,-81.703935)"
2021,Septiembre,Alemania,276,633,1182,1817,"(4.697144,-74.140516)"
2014,Mayo,Kazajistán,398,1,0,1,"(6.171601,-75.427454)"
2014,Noviembre,Nicaragua,558,7,13,20,"(6.171601,-75.427454)"
2018,Abril,Seychelles,690,0,1,1,"(4.697144,-74.140516)"
2014,Septiembre,Alemania,276,4,2,6,"(8.635765,-77.346578)"
2015,Diciembre,Polonia,616,9,15,24,"(6.171601,-75.427454)"
2012,Septiembre,Rumania,642,0,3,3,"(10.408582,-75.538003)"
2018,Septiembre,Paraguay,600,5,5,10,"(3.541112,-76.384584)"
2021,Noviembre,Venezuela,862,175,128,303,"(10.445761,-75.516429)"
2014,Agosto,Canadá,124,46,71,117,"(3.541112,-76.384584)"
2018,Octubre,República Dominicana,214,65,100,165,"(10.445761,-75.516429)"
2022,Abril,Dominica,212,0,1,1,"(10.408582,-75.538003)"
2022,Mayo,Italia,380,28,57,85,"(7.818934,-72.453226)"
2021,Junio,Tailandia,764,2,0,2,"(10.445761,-75.516429)"
2016,Diciembre,Rumania,642,1,1,2,"(0.814836,-77.662532)"
2019,Octubre,Países Bajos,528,3,18,21,"(4.815061,-75.736532)"
2016,Julio,Barbados,52,0,1,1,"(7.128456,-73.183637)"
2016,Septiembre,Guatemala,320,161,216,377,"(10.445761,-75.516429)"
2016,Octubre,Perú,604,62,60,122,"(10.408582,-75.538003)"
2022,Julio,Belice,84,5,14,19,"(4.697144,-74.140516)"
2014,Octubre,España,724,2198,5548,7746,"(4.697144,-74.140516)"
2018,Junio,Serbia,688,2,5,7,"(10.445761,-75.516429)"
2018,Enero,Costa Rica,188,32,32,64,"(10.886611,-74.776708)"
2015,Enero,Argentina,32,2,2,4,"(8.635765,-77.346578)"
2015,Octubre,Italia,380,0,1,1,"(11.247723,-74.213989)"
2015,Enero,Estados Unidos de América,840,64,93,157,"(4.452882,-75.766298)"
2016,Julio,Líbano,422,2,1,3,"(11.360009,-72.129330)"
2017,Agosto,Francia,250,73,132,205,"(3.541112,-76.384584)"
2019,Abril,Suecia,752,5,6,11,"(10.886611,-74.776708)"
2012,Junio,República Dominicana,214,3,0,3,"(7.128456,-73.183637)"
2014,Mayo,Honduras,340,1,0,1,"(4.815061,-75.736532)"
2013,Marzo,Italia,380,17,83,100,"(6.171601,-75.427454)"
2018,Julio,Estonia,233,6,3,9,"(4.697144,-74.140516)"
2013,Septiembre,Nicaragua,558,1,0,1,"(7.927209,-72.507910)"
2017,Abril,España,724,5,6,11,"(12.586067,-81.702563)"
2012,Noviembre,Bélgica,56,2,6,8,"(11.247723,-74.213989)"
2021,Agosto,Guyana,328,1,0,1,"(10.886611,-74.776708)"
2021,Julio,Honduras,340,39,37,76,"(10.445761,-75.516429)"
2018,Mayo,Líbano,422,1,0,1,"(3.541112,-76.384584)"
2020,Noviembre,Ecuador,218,8,14,22,"(0.814836,-77.662532)"
2018,Noviembre,Turquía,792,7,17,24,"(6.171601,-75.427454)"
2016,Julio,Dominica,212,0,1,1,"(6.171601,-75.427454)"
2020,Diciembre,Estados Unidos de América,840,131,265,396,"(4.815061,-75.736532)"
2012,Septiembre,México,484,2,1,3,"(-4.197703,-69.941278)"
2019,Abril,Ucrania,804,3,11,14,"(10.445761,-75.516429)"
2018,Abril,Filipinas,608,4,8,12,"(3.541112,-76.384584)"
2016,Julio,Chile,152,263,190,453,"(10.445761,-75.516429)"
2021,Noviembre,Japón,392,0,1,1,"(8.36068,-72.409396)"
2023,Mayo,Portugal,620,0,1,1,"(12.586067,-81.702563)"
2021,Julio,Portugal,620,2,3,5,"(11.360009,-72.129330)"
2018,Enero,Perú,604,0,2,2,"(3.893038,-77.067921)"
2012,Noviembre,Libia,434,0,1,1,"(4.697144,-74.140516)"
2017,Septiembre,Turquía,792,2,1,3,"(-4.197703,-69.941278)"
2013,Agosto,Reino Unido de Gran Bretaña e Irlanda del Norte,826,26,13,39,"(10.408582,-75.538003)"
2016,Junio,Haití,332,3,5,8,"(10.445761,-75.516429)"
2020,Marzo,República Árabe Siria,760,0,1,1,"(4.697144,-74.140516)"
2022,Enero,Perú,604,3084,3933,7018,"(4.697144,-74.140516)"
2014,Marzo,Francia,250,4,14,18,"(11.360009,-72.129330)"
2022,Marzo,México,484,0,4,4,"(1.813928,-78.763924)"
2014,Julio,Nicaragua,558,1,1,2,"(4.815061,-75.736532)"
2013,Octubre,Estados Unidos de América,840,7,27,34,"(7.927209,-72.507910)"
2020,Enero,Chad,148,0,1,1,"(4.697144,-74.140516)"
2018,Enero,China,156,13,27,40,"(10.445761,-75.516429)"
2015,Septiembre,Federación de Rusia,643,8,7,15,"(6.171601,-75.427454)"
2017,Febrero,República de Armenia,51,0,1,1,"(6.171601,-75.427454)"
2012,Julio,Portugal,620,80,235,315,"(4.697144,-74.140516)"
2019,Noviembre,Venezuela,862,376,368,744,"(7.088729,-70.740253)"
2017,Octubre,Noruega,578,0,1,1,"(4.815061,-75.736532)"
2016,Febrero,Honduras,340,22,30,52,"(10.445761,-75.516429)"
2012,Noviembre,Islas del Canal,238,1,0,1,"(4.697144,-74.140516)"
2012,Abril,Federación de Rusia,643,2,1,3,"(6.171601,-75.427454)"
2021,Febrero,Ecuador,218,0,1,1,"(10.408582,-75.538003)"
2018,Mayo,República Checa,203,12,12,24,"(10.445761,-75.516429)"
2013,Enero,Ecuador,218,10,12,22,"(10.886611,-74.776708)"
2019,Marzo,Etiopia,231,2,34,36,"(4.697144,-74.140516)"
2022,Febrero,Grecia,300,0,2,2,"(10.408582,-75.538003)"
2016,Noviembre,Panamá,591,269,314,583,"(10.445761,-75.516429)"
2018,Junio,Austria,40,1,1,2,"(8.635765,-77.346578)"
2021,Noviembre,China,156,1,3,4,"(3.541112,-76.384584)"
2019,Agosto,Italia,380,57,92,149,"(3.541112,-76.384584)"
2016,Diciembre,República Dominicana,214,5,10,15,"(4.815061,-75.736532)"
2014,Octubre,Bélgica,56,1,2,3,"(11.360009,-72.129330)"
2022,Julio,Venezuela,862,5805,5441,11247,"(4.697144,-74.140516)"
2017,Septiembre,Rwanda,646,0,1,1,"(6.171601,-75.427454)"
2019,Enero,Japón,392,185,456,641,"(4.697144,-74.140516)"
2022,Septiembre,Sri Lanka,144,0,2,2,"(3.893038,-77.067921)"
2012,Enero,República Checa,203,40,50,90,"(4.697144,-74.140516)"
2013,Marzo,Haití,332,1,2,3,"(3.541112,-76.384584)"
2017,Marzo,Islandia,352,1,0,1,"(3.541112,-76.384584)"
2019,Enero,Federación de Rusia,643,1,1,2,"(7.128456,-73.183637)"
2012,Agosto,México,484,82,153,235,"(10.445761,-75.516429)"
2016,Julio,Bulgaria,100,3,2,5,"(10.445761,-75.516429)"
2018,Diciembre,Perú,604,4,2,6,"(4.815061,-75.736532)"
2022,Febrero,Suecia,752,0,1,1,"(11.360009,-72.129330)"
2016,Julio,Malasia,458,10,14,24,"(4.697144,-74.140516)"
2012,Enero,Sierra Leona,694,0,1,1,"(4.697144,-74.140516)"
2019,Noviembre,Estonia,233,0,1,1,"(3.541112,-76.384584)"
2016,Diciembre,Italia,380,0,1,1,"(0.25129,-76.875963)"
2022,Septiembre,Chipre,196,2,2,4,"(3.541112,-76.384584)"
2017,Julio,Reino Unido de Gran Bretaña e Irlanda del Norte,826,51,97,148,"(3.541112,-76.384584)"
2014,Julio,Eslovenia,705,2,2,4,"(-4.197703,-69.941278)"
2016,Enero,Países Bajos,528,8,10,18,"(8.635765,-77.346578)"
2021,Septiembre,Filipinas,608,0,6,6,"(3.893038,-77.067921)"
2019,Mayo,Sudán,736,1,1,2,"(4.697144,-74.140516)"
2016,Febrero,República CentroÁfricana,140,0,1,1,"(4.697144,-74.140516)"
2023,Enero,Estados Unidos de América,840,5,21,26,"(0.25129,-76.875963)"
2013,Febrero,Venezuela,862,15,10,25,"(7.128456,-73.183637)"
2018,Abril,Nepal,524,2,4,6,"(4.697144,-74.140516)"
2021,Julio,Italia,380,3,1,4,"(8.36068,-72.409396)"
2022,Mayo,República de Irlanda,372,2,3,5,"(8.635765,-77.346578)"
2015,Diciembre,Puerto Rico/Territorio de Estados Unidos,630,0,1,1,"(3.541112,-76.384584)"
2018,Septiembre,San  Vicente y las Granadinas,670,1,1,2,"(4.815061,-75.736532)"
2019,Mayo,Ucrania,804,0,4,4,"(10.971302,-74.765397)"
2015,Septiembre,Estados Unidos de América,840,1,3,4,"(11.247723,-74.213989)"
2022,Agosto,Canadá,124,3,0,3,"(12.586067,-81.702563)"
2022,Octubre,Filipinas,608,0,11,11,"(1.813928,-78.763924)"
2022,Agosto,Turquía,792,0,7,7,"(9.402978,-75.681599)"
2018,Abril,Canadá,124,39,61,100,"(3.541112,-76.384584)"
2015,Marzo,Bulgaria,100,0,1,1,"(-4.223468,-69.945098)"
2020,Enero,Chile,152,75,62,137,"(10.408582,-75.538003)"
2019,Julio,Federación de Rusia,643,143,167,310,"(4.697144,-74.140516)"
2023,Abril,Ecuador,218,10,13,23,"(11.360009,-72.129330)"
2017,Mayo,Desconocido,99999,80,139,219,"(4.697144,-74.140516)"
2016,Junio,Finlandia,246,1,2,3,"(0.814836,-77.662532)"
2022,Julio,Bolivia,68,5,5,10,"(10.886611,-74.776708)"
2012,Febrero,Nueva Zelanda,554,5,4,9,"(0.814836,-77.662532)"
2023,Mayo,Túnez,788,0,1,1,"(3.893038,-77.067921)"
2016,Enero,Uruguay,858,0,3,3,"(7.818934,-72.453226)"
2018,Septiembre,Francia,250,6,9,15,"(4.815061,-75.736532)"
2012,Noviembre,Israel,376,34,289,323,"(4.697144,-74.140516)"
2017,Diciembre,Rumania,642,4,3,7,"(3.541112,-76.384584)"
2016,Mayo,Perú,604,0,1,1,"(7.088729,-70.740253)"
2019,Enero,Jamaica,388,6,3,9,"(3.541112,-76.384584)"
2012,Diciembre,Ecuador,218,47,70,117,"(0.25129,-76.875963)"
2013,Septiembre,Cuba,192,7,14,21,"(10.445761,-75.516429)"
2022,Julio,España,724,324,484,808,"(3.541112,-76.384584)"
2022,Abril,Costa Rica,188,934,766,1700,"(10.445761,-75.516429)"
2012,Septiembre,Suecia,752,0,2,2,"(7.818934,-72.453226)"
2016,Noviembre,Brasil,76,5207,6501,11708,"(4.697144,-74.140516)"
2021,Diciembre,Panamá,591,1052,1231,2283,"(4.697144,-74.140516)"
2019,Febrero,Venezuela,862,4402,4159,8562,"(11.360009,-72.129330)"
2012,Abril,Portugal,620,0,3,3,"(10.408582,-75.538003)"
2020,Diciembre,Santa Lucia,662,1,0,1,"(10.445761,-75.516429)"
2022,Septiembre,Japón,392,0,1,1,"(10.408582,-75.538003)"
2018,Julio,Líbano,422,1,0,1,"(11.360009,-72.129330)"
2016,Marzo,España,724,6,15,21,"(10.408582,-75.538003)"
2022,Noviembre,Cuba,192,1,0,1,"(7.927209,-72.507910)"
2019,Julio,Argentina,32,1645,1248,2893,"(10.445761,-75.516429)"
2022,Marzo,Albania,8,4,28,32,"(4.697144,-74.140516)"
2012,Junio,Aruba,533,0,1,1,"(3.541112,-76.384584)"
2014,Mayo,Ucrania,804,0,1,1,"(3.893038,-77.067921)"
2019,Noviembre,Grecia,300,53,102,155,"(4.697144,-74.140516)"
2019,Mayo,Francia,250,1,0,1,"(13.3387613,-81.372937)"
2021,Abril,Nicaragua,558,43,41,84,"(4.697144,-74.140516)"
2018,Marzo,España,724,4,4,8,"(11.360009,-72.129330)"
2016,Marzo,Eslovaquia,703,23,26,49,"(4.697144,-74.140516)"
2018,Agosto,Sudán,736,0,1,1,"(4.697144,-74.140516)"
2013,Abril,Venezuela,862,84,112,196,"(10.445761,-75.516429)"
2020,Febrero,Malta,470,0,2,2,"(6.171601,-75.427454)"
2012,Octubre,Federación de Rusia,643,2,5,7,"(0.814836,-77.662532)"
2012,Marzo,Islas Caimán/Territorio Británico de Ultramar,136,0,1,1,"(3.541112,-76.384584)"
2019,Agosto,Argentina,32,21,23,44,"(8.36068,-72.409396)"
2018,Febrero,Canadá,124,2,6,8,"(11.360009,-72.129330)"
2023,Junio,Venezuela,862,338,303,641,"(10.445761,-75.516429)"
2016,Junio,Perú,604,2,5,7,"(4.815061,-75.736532)"
2016,Marzo,Bélgica,56,1,1,2,"(11.360009,-72.129330)"
2016,Septiembre,Guyana,328,0,2,2,"(7.818934,-72.453226)"
2012,Junio,Jamaica,388,0,2,2,"(3.541112,-76.384584)"
2019,Diciembre,Hong Kong,344,34,28,63,"(4.697144,-74.140516)"
2018,Marzo,Surinam,740,1,1,2,"(7.128456,-73.183637)"
2018,Mayo,España,724,0,1,1,"(7.088729,-70.740253)"
2021,Septiembre,Nicaragua,558,0,1,1,"(1.813928,-78.763924)"
2018,Junio,Australia,36,0,1,1,"(11.360009,-72.129330)"
2022,Enero,Portugal,620,25,50,75,"(6.171601,-75.427454)"
2014,Septiembre,México,484,15,20,35,"(0.814836,-77.662532)"
2022,Julio,El Salvador,222,1,0,1,"(11.117806,-74.232622)"
2022,Septiembre,Finlandia,246,3,0,3,"(10.886611,-74.776708)"
2019,Noviembre,Uganda,800,1,6,7,"(4.697144,-74.140516)"
2022,Agosto,India,356,1,2,3,"(4.815061,-75.736532)"
2016,Diciembre,Cuba,192,16,41,57,"(6.171601,-75.427454)"
2019,Marzo,Honduras,340,3,8,11,"(7.927209,-72.507910)"
2017,Enero,Bélgica,56,0,8,8,"(3.893038,-77.067921)"
2014,Febrero,Filipinas,608,0,7,7,"(3.893038,-77.067921)"
2015,Diciembre,Argentina,32,403,361,764,"(10.445761,-75.516429)"
2019,Febrero,Lituania,440,3,8,11,"(6.171601,-75.427454)"
2017,Julio,Nicaragua,558,3,3,6,"(10.886611,-74.776708)"
2015,Marzo,Dinamarca,208,1,0,1,"(7.927209,-72.507910)"
2019,Junio,Malasia,458,1,0,1,"(0.814836,-77.662532)"
2018,Agosto,Brasil,76,8,12,20,"(7.818934,-72.453226)"
2012,Mayo,Reino Unido de Gran Bretaña e Irlanda del Norte,826,0,1,1,"(8.635765,-77.346578)"
2012,Octubre,Brasil,76,6,11,17,"(11.360009,-72.129330)"
2016,Enero,Serbia,688,12,21,33,"(4.697144,-74.140516)"
2016,Febrero,Argentina,32,10,20,30,"(7.818934,-72.453226)"
2022,Julio,Desconocido,99999,45,76,121,"(4.697144,-74.140516)"
2015,Abril,Uruguay,858,3,6,9,"(10.886611,-74.776708)"
2019,Septiembre,Italia,380,6,16,22,"(10.408582,-75.538003)"
2019,Febrero,Dinamarca,208,0,5,5,"(12.586067,-81.702563)"
2015,Octubre,Bolivia,68,27,19,46,"(12.586067,-81.702563)"
2016,Noviembre,Suiza,756,391,642,1033,"(4.697144,-74.140516)"
2021,Junio,Sudáfrica,710,6,12,18,"(4.697144,-74.140516)"
2016,Septiembre,Bahamas,44,0,1,1,"(10.886611,-74.776708)"
2016,Enero,Cuba,192,15,18,33,"(3.541112,-76.384584)"
2014,Junio,Costa Rica,188,0,1,1,"(8.635765,-77.346578)"
2018,Enero,Países Bajos,528,2,7,9,"(-4.223468,-69.945098)"
2022,Febrero,Haití,332,1,1,2,"(3.541112,-76.384584)"
2012,Marzo,Ucrania,804,0,1,1,"(10.408582,-75.538003)"
2022,Marzo,Argentina,32,2,3,5,"(7.916725,-72.462544)"
2023,Marzo,Antigua y Barbuda,28,0,1,1,"(3.541112,-76.384584)"
2021,Octubre,Dinamarca,208,36,66,102,"(4.697144,-74.140516)"
2017,Abril,Ecuador,218,5,6,11,"(10.886611,-74.776708)"
2015,Mayo,República de Belarús,112,2,0,2,"(7.818934,-72.453226)"
2013,Marzo,Grecia,300,0,1,1,"(12.586067,-81.702563)"
2016,Septiembre,Eslovaquia,703,15,28,43,"(4.697144,-74.140516)"
2018,Agosto,Turquía,792,0,2,2,"(-4.223468,-69.945098)"
2018,Enero,República de Armenia,51,2,2,4,"(4.697144,-74.140516)"
2020,Marzo,México,484,24,66,90,"(3.541112,-76.384584)"
2012,Junio,Venezuela,862,59,110,169,"(7.088729,-70.740253)"
2014,Octubre,Países Bajos,528,24,60,84,"(10.445761,-75.516429)"
2018,Agosto,Brasil,76,999,706,1706,"(10.445761,-75.516429)"
2017,Febrero,Paraguay,600,11,43,54,"(3.541112,-76.384584)"
2017,Febrero,Países Bajos,528,0,1,1,"(4.452882,-75.766298)"
2022,Noviembre,Panamá,591,0,1,1,"(10.971302,-74.765397)"
2018,Junio,Perú,604,232,154,386,"(12.586067,-81.702563)"
2015,Junio,Países Bajos,528,0,2,2,"(7.927209,-72.507910)"
2017,Diciembre,Sudáfrica,710,1,0,1,"(7.818934,-72.453226)"
2018,Agosto,Turkmenistán,795,1,0,1,"(4.697144,-74.140516)"
2014,Octubre,Canadá,124,654,1262,1916,"(4.697144,-74.140516)"
2020,Marzo,Cuba,192,0,1,1,"(11.360009,-72.129330)"
2012,Diciembre,Panamá,591,515,835,1350,"(4.697144,-74.140516)"
2021,Septiembre,Reino Unido de Gran Bretaña e Irlanda del Norte,826,2,2,4,"(10.886611,-74.776708)"
2015,Agosto,Suecia,752,3,4,7,"(10.408582,-75.538003)"
2012,Septiembre,Túnez,788,0,1,1,"(4.697144,-74.140516)"
2021,Abril,Grecia,300,0,1,1,"(4.815061,-75.736532)"
2012,Marzo,Japón,392,0,1,1,"(8.635765,-77.346578)"
2018,Agosto,Iraq,368,0,1,1,"(6.171601,-75.427454)"
2016,Enero,Rumania,642,0,1,1,"(11.247723,-74.213989)"
2012,Septiembre,Italia,380,0,3,3,"(4.815061,-75.736532)"
2017,Septiembre,Nueva Zelanda,554,4,6,10,"(8.635765,-77.346578)"
2023,Mayo,México,484,2,3,5,"(12.586067,-81.702563)"
2019,Julio,El Salvador,222,96,130,226,"(6.171601,-75.427454)"
2016,Febrero,México,484,100,152,252,"(10.445761,-75.516429)"
2018,Octubre,España,724,1,1,2,"(7.088729,-70.740253)"
2013,Noviembre,Portugal,620,5,20,25,"(6.171601,-75.427454)"
2016,Noviembre,Ucrania,804,23,31,54,"(4.697144,-74.140516)"
2013,Diciembre,Federación de Rusia,643,3,7,10,"(0.814836,-77.662532)"
2023,Enero,Suiza,756,0,1,1,"(7.818934,-72.453226)"
2012,Marzo,Francia,250,7,22,29,"(8.635765,-77.346578)"
2020,Marzo,Estados Unidos de América,840,14,35,49,"(0.814836,-77.662532)"
2012,Julio,India,356,24,244,268,"(4.697144,-74.140516)"
2016,Octubre,San  Vicente y las Granadinas,670,3,4,7,"(4.697144,-74.140516)"
2017,Mayo,Suiza,756,18,19,37,"(10.408582,-75.538003)"
2023,Abril,Brasil,76,14,12,26,"(11.117806,-74.232622)"
2012,Mayo,Nicaragua,558,7,4,11,"(10.445761,-75.516429)"
2022,Septiembre,Trinidad y Tobago,780,10,14,24,"(10.445761,-75.516429)"
2012,Enero,México,484,0,2,2,"(12.586067,-81.702563)"
2018,Julio,Mozambique,508,1,1,2,"(6.171601,-75.427454)"
2015,Mayo,Suecia,752,6,0,6,"(-4.197703,-69.941278)"
2023,Enero,Puerto Rico/Territorio de Estados Unidos,630,0,1,1,"(4.697144,-74.140516)"
2012,Junio,República Checa,203,0,2,2,"(6.171601,-75.427454)"
2018,Febrero,Noruega,578,1,1,2,"(13.3387613,-81.372937)"
2018,Agosto,Noruega,578,5,10,15,"(6.171601,-75.427454)"
2023,Enero,Turquía,792,9,55,64,"(6.171601,-75.427454)"
2017,Enero,Marruecos,504,2,4,6,"(6.171601,-75.427454)"
2015,Abril,Rumania,642,0,2,2,"(7.818934,-72.453226)"
2017,Enero,Ecuador,218,2,1,3,"(12.586067,-81.702563)"
2017,Diciembre,Italia,380,1006,2132,3138,"(4.697144,-74.140516)"
2018,Noviembre,Malasia,458,20,35,56,"(4.697144,-74.140516)"
2021,Agosto,México,484,0,3,3,"(8.36068,-72.409396)"
2017,Agosto,Uruguay,858,1,0,1,"(8.36068,-72.409396)"
2017,Octubre,Chile,152,71,50,121,"(10.408582,-75.538003)"
2015,Diciembre,Federación de Rusia,643,19,13,32,"(0.814836,-77.662532)"
2014,Abril,Venezuela,862,4929,5242,10171,"(4.697144,-74.140516)"
2018,Octubre,Italia,380,0,1,1,"(8.066966,-76.735404)"
2012,Diciembre,Nicaragua,558,0,2,2,"(12.5744111,-81.703935)"
2012,Agosto,Estonia,233,1,0,1,"(-4.197703,-69.941278)"
2019,Agosto,El Salvador,222,1,1,2,"(4.452882,-75.766298)"
2022,Enero,Albania,8,3,16,19,"(4.697144,-74.140516)"
2015,Enero,Grecia,300,17,51,68,"(4.697144,-74.140516)"
2023,Mayo,Marruecos,504,0,4,4,"(-4.197703,-69.941278)"
2014,Junio,Reino Unido de Gran Bretaña e Irlanda del Norte,826,1,2,3,"(11.360009,-72.129330)"
2021,Diciembre,Francia,250,4,8,12,"(10.408582,-75.538003)"
2020,Noviembre,Turquía,792,0,7,7,"(10.445761,-75.516429)"
2022,Octubre,Serbia,688,6,5,11,"(6.171601,-75.427454)"
2019,Marzo,Cuba,192,0,1,1,"(4.452882,-75.766298)"
2017,Febrero,Turquía,792,0,1,1,"(12.586067,-81.702563)"
2018,Octubre,Argentina,32,1,0,1,"(8.36068,-72.409396)"
2021,Febrero,Suiza,756,64,135,199,"(4.697144,-74.140516)"
2022,Junio,Eslovaquia,703,0,1,1,"(3.541112,-76.384584)"
2014,Junio,Países Bajos,528,0,1,1,"(11.247723,-74.213989)"
2015,Febrero,Noruega,578,4,17,21,"(6.171601,-75.427454)"
2019,Diciembre,China,156,1,0,1,"(6.185799,-67.483929)"
2018,Octubre,Ecuador,218,0,1,1,"(3.866713,-67.927521)"
2015,Enero,Hungría,348,3,5,8,"(10.445761,-75.516429)"
2017,Abril,El Salvador,222,952,1000,1952,"(4.697144,-74.140516)"
2015,Enero,Perú,604,3,3,6,"(7.128456,-73.183637)"
2013,Diciembre,Croacia,191,0,6,6,"(11.247723,-74.213989)"
2014,Octubre,Israel,376,5,31,36,"(0.814836,-77.662532)"
2017,Mayo,Honduras,340,0,5,5,"(12.5744111,-81.703935)"
2018,Febrero,Noruega,578,1,0,1,"(8.635765,-77.346578)"
2014,Julio,Portugal,620,4,4,8,"(11.360009,-72.129330)"
2017,Octubre,China,156,1,3,4,"(4.815061,-75.736532)"
2021,Octubre,Estonia,233,0,1,1,"(10.445761,-75.516429)"
2022,Diciembre,El Salvador,222,0,4,4,"(4.815061,-75.736532)"
2020,Septiembre,Paraguay,600,0,2,2,"(10.445761,-75.516429)"
2014,Enero,Japón,392,0,2,2,"(10.408582,-75.538003)"
2019,Mayo,Estados Unidos de América,840,27,55,82,"(10.408582,-75.538003)"
2019,Mayo,Italia,380,3,6,9,"(-4.223468,-69.945098)"
2022,Febrero,Uruguay,858,3,1,4,"(7.818934,-72.453226)"
2020,Marzo,Surinam,740,1,0,1,"(7.128456,-73.183637)"
2016,Mayo,Guatemala,320,2,8,10,"(4.815061,-75.736532)"
2017,Mayo,Ecuador,218,3231,4001,7232,"(4.697144,-74.140516)"
2021,Mayo,Bélgica,56,3,6,9,"(3.541112,-76.384584)"
2015,Octubre,Eslovenia,705,0,1,1,"(3.541112,-76.384584)"
2015,Marzo,Rumania,642,2,3,5,"(10.408582,-75.538003)"
2020,Enero,Ucrania,804,38,54,92,"(4.697144,-74.140516)"
2016,Noviembre,República de Irlanda,372,6,14,20,"(8.635765,-77.346578)"
2012,Abril,Nigeria,566,0,6,6,"(4.697144,-74.140516)"
2014,Diciembre,Grecia,300,0,2,2,"(3.541112,-76.384584)"
2016,Septiembre,Guatemala,320,0,1,1,"(1.813928,-78.763924)"
2017,Abril,India,356,2,6,8,"(4.815061,-75.736532)"
2018,Septiembre,Bolivia,68,1,0,1,"(4.815061,-75.736532)"
2017,Noviembre,Suecia,752,8,3,11,"(10.408582,-75.538003)"
2019,Agosto,Noruega,578,1,2,3,"(8.635765,-77.346578)"
2022,Febrero,Mauricio,480,0,1,1,"(4.697144,-74.140516)"
2018,Mayo,Italia,380,10,8,18,"(12.586067,-81.702563)"
2017,Febrero,Noruega,578,15,21,36,"(10.445761,-75.516429)"
2021,Febrero,Japón,392,22,23,45,"(4.697144,-74.140516)"
2012,Agosto,Australia,36,198,363,561,"(4.697144,-74.140516)"
2023,Abril,Taiwán,158,1,0,1,"(10.886611,-74.776708)"
2017,Octubre,Montenegro,499,0,3,3,"(10.408582,-75.538003)"
2015,Noviembre,Malasia,458,0,1,1,"(7.818934,-72.453226)"
2020,Marzo,Ecuador,218,0,1,1,"(8.635765,-77.346578)"
2018,Octubre,Georgia,268,0,2,2,"(3.541112,-76.384584)"
2021,Abril,Polonia,616,0,5,5,"(10.408582,-75.538003)"
2017,Agosto,Bulgaria,100,1,2,3,"(6.171601,-75.427454)"
2013,Marzo,Chile,152,0,2,2,"(3.893038,-77.067921)"
2017,Octubre,Madagascar,450,1,0,1,"(3.541112,-76.384584)"
2018,Octubre,Reino Unido de Gran Bretaña e Irlanda del Norte,826,0,1,1,"(4.452882,-75.766298)"
2017,Octubre,Países Bajos,528,46,57,103,"(10.886611,-74.776708)"
2012,Enero,Guatemala,320,13,7,20,"(10.886611,-74.776708)"
2014,Junio,República de Belarús,112,5,2,7,"(4.697144,-74.140516)"
2021,Noviembre,Israel,376,2,4,6,"(10.408582,-75.538003)"
2023,Mayo,República Árabe de Yemen,887,1,3,4,"(4.697144,-74.140516)"
2017,Diciembre,Honduras,340,225,226,451,"(4.697144,-74.140516)"
2019,Octubre,Paraguay,600,420,307,727,"(4.697144,-74.140516)"
2016,Diciembre,México,484,0,2,2,"(4.452882,-75.766298)"
2014,Enero,Turquía,792,3,3,6,"(3.541112,-76.384584)"
2019,Abril,Dinamarca,208,5,8,13,"(3.541112,-76.384584)"
2021,Noviembre,Perú,604,0,3,3,"(10.408582,-75.538003)"
2014,Agosto,Bolivia,68,34,19,53,"(12.586067,-81.702563)"
2018,Enero,Bélgica,56,4,6,10,"(10.886611,-74.776708)"
2017,Abril,República Checa,203,47,64,111,"(4.697144,-74.140516)"
2019,Noviembre,Cuba,192,1,2,3,"(4.452882,-75.766298)"
2014,Diciembre,Suiza,756,2,1,3,"(8.635765,-77.346578)"
2015,Septiembre,Alemania,276,64,137,201,"(6.171601,-75.427454)"
2022,Enero,Grecia,300,0,1,1,"(4.815061,-75.736532)"
2023,Marzo,Irán,364,0,1,1,"(6.171601,-75.427454)"
2019,Marzo,Bermudas/Territorio Británico de Ultramar,60,2,2,4,"(10.445761,-75.516429)"
2019,Marzo,Georgia,268,0,1,1,"(10.408582,-75.538003)"
2017,Julio,Italia,380,6,7,13,"(10.408582,-75.538003)"
2021,Agosto,Hungría,348,1,0,1,"(3.541112,-76.384584)"
2012,Junio,Francia,250,0,2,2,"(7.927209,-72.507910)"
2020,Febrero,Reino Unido de Gran Bretaña e Irlanda del Norte,826,196,392,588,"(6.171601,-75.427454)"
2016,Diciembre,Guyana,328,1,1,2,"(-4.197703,-69.941278)"
2019,Diciembre,Argentina,32,210,359,569,"(6.171601,-75.427454)"
2016,Octubre,Italia,380,5,30,35,"(10.886611,-74.776708)"
2020,Febrero,El Salvador,222,28,39,67,"(10.445761,-75.516429)"
2014,Mayo,Suiza,756,16,51,67,"(6.171601,-75.427454)"
2018,Febrero,Indonesia,360,1,1,2,"(3.541112,-76.384584)"
2018,Octubre,Paraguay,600,5,3,8,"(4.815061,-75.736532)"
2013,Febrero,Trinidad y Tobago,780,4,10,14,"(10.445761,-75.516429)"
2019,Septiembre,Dinamarca,208,0,1,1,"(11.247723,-74.213989)"
2013,Febrero,Cuba,192,2,1,3,"(4.815061,-75.736532)"
2013,Noviembre,Italia,380,0,1,1,"(7.128456,-73.183637)"
2018,Abril,Venezuela,862,2660,2901,5561,"(8.36068,-72.409396)"
2013,Julio,Taiwán,158,2,2,4,"(10.886611,-74.776708)"
2013,Agosto,Israel,376,0,1,1,"(10.886611,-74.776708)"
2018,Junio,Ucrania,804,0,1,1,"(10.971302,-74.765397)"
2015,Septiembre,Israel,376,13,72,85,"(6.171601,-75.427454)"
2018,Mayo,Estonia,233,2,1,3,"(6.171601,-75.427454)"
2013,Marzo,Grecia,300,17,46,63,"(4.697144,-74.140516)"
2013,Mayo,Estados Unidos de América,840,340,574,914,"(10.886611,-74.776708)"
2016,Abril,Austria,40,8,4,12,"(10.445761,-75.516429)"
2023,Mayo,Australia,36,14,8,22,"(8.635765,-77.346578)"
2022,Diciembre,Estados Unidos de América,840,14826,24249,39081,"(4.697144,-74.140516)"
2014,Octubre,Japón,392,1,4,5,"(8.635765,-77.346578)"
2018,Octubre,Camerún,120,0,1,1,"(3.541112,-76.384584)"
2021,Diciembre,Turquía,792,12,11,23,"(10.445761,-75.516429)"
2019,Enero,República Dominicana,214,4,5,9,"(7.818934,-72.453226)"
2022,Agosto,Filipinas,608,5,22,27,"(3.541112,-76.384584)"
2020,Enero,Portugal,620,3,6,9,"(10.408582,-75.538003)"
2021,Febrero,Federación de Rusia,643,1,1,2,"(3.541112,-76.384584)"
2014,Noviembre,Trinidad y Tobago,780,1,5,6,"(3.541112,-76.384584)"
2022,Septiembre,Líbano,422,0,1,1,"(3.541112,-76.384584)"
2014,Julio,San Cristóbal y Nevis,659,0,1,1,"(3.541112,-76.384584)"
2013,Noviembre,Ucrania,804,0,3,3,"(11.247723,-74.213989)"
2014,Mayo,Nueva Zelanda,554,1,4,5,"(10.445761,-75.516429)"
2019,Marzo,Perú,604,0,1,1,"(11.117806,-74.232622)"
2022,Junio,Australia,36,17,35,52,"(10.445761,-75.516429)"
2014,Noviembre,Chile,152,69,57,126,"(12.586067,-81.702563)"
2012,Junio,Venezuela,862,3,1,4,"(11.528919,-72.919681)"
2012,Noviembre,España,724,0,8,8,"(4.815061,-75.736532)"
2020,Noviembre,República de Moldavia,498,2,0,2,"(6.171601,-75.427454)"
2019,Febrero,España,724,2,4,6,"(-4.197703,-69.941278)"
2013,Diciembre,Cuba,192,11,44,55,"(3.541112,-76.384584)"
2019,Octubre,Filipinas,608,0,1,1,"(4.452882,-75.766298)"
2018,Noviembre,México,484,2,3,5,"(11.360009,-72.129330)"
2021,Diciembre,Letonia,428,0,1,1,"(11.247723,-74.213989)"
2016,Octubre,Alemania,276,16,23,39,"(10.886611,-74.776708)"
2018,Octubre,República de Belarús,112,5,3,8,"(4.697144,-74.140516)"
2019,Julio,Cuba,192,32,31,63,"(10.445761,-75.516429)"
2018,Noviembre,Eslovenia,705,1,9,10,"(6.171601,-75.427454)"
2015,Mayo,Australia,36,6,15,21,"(10.886611,-74.776708)"
2013,Febrero,Brasil,76,32,20,52,"(12.586067,-81.702563)"
2017,Julio,Georgia,268,0,1,1,"(9.402978,-75.681599)"
2013,Diciembre,Singapur,702,13,28,41,"(4.697144,-74.140516)"
2014,Agosto,El Salvador,222,649,798,1447,"(4.697144,-74.140516)"
2012,Mayo,República de Corea,410,6,18,24,"(6.171601,-75.427454)"
2015,Diciembre,Croacia,191,2,0,2,"(10.445761,-75.516429)"
2019,Octubre,Granada,308,2,1,3,"(6.171601,-75.427454)"
2019,Septiembre,Filipinas,608,0,8,8,"(11.247723,-74.213989)"
2016,Septiembre,Cuba,192,26,236,262,"(10.445761,-75.516429)"
2018,Enero,Indonesia,360,0,2,2,"(10.886611,-74.776708)"
2021,Noviembre,Brasil,76,2,2,4,"(7.128456,-73.183637)"
2022,Septiembre,República de Armenia,51,2,4,6,"(4.697144,-74.140516)"
2015,Marzo,Argentina,32,1,5,6,"(0.25129,-76.875963)"
2013,Diciembre,Kazajistán,398,4,1,5,"(4.697144,-74.140516)"
2018,Febrero,Nueva Zelanda,554,1,2,3,"(4.815061,-75.736532)"
2016,Febrero,Eslovenia,705,3,1,4,"(6.171601,-75.427454)"
2013,Mayo,Uruguay,858,25,40,65,"(6.171601,-75.427454)"
2021,Agosto,Singapur,702,1,8,9,"(4.697144,-74.140516)"
2018,Julio,Perú,604,6,8,14,"(10.886611,-74.776708)"
2016,Marzo,Surinam,740,0,1,1,"(10.445761,-75.516429)"
2014,Febrero,Brasil,76,9,35,44,"(7.818934,-72.453226)"
2023,Mayo,Guyana,328,13,19,32,"(4.697144,-74.140516)"
2019,Julio,Egipto,818,8,28,36,"(4.697144,-74.140516)"
2013,Febrero,Federación de Rusia,643,0,1,1,"(9.402978,-75.681599)"
2017,Octubre,México,484,649,1463,2112,"(6.171601,-75.427454)"
2015,Octubre,Venezuela,862,0,3,3,"(12.586067,-81.702563)"
2014,Diciembre,Nepal,524,0,5,5,"(10.408582,-75.538003)"
2022,Marzo,Venezuela,862,239,169,408,"(10.445761,-75.516429)"
2022,Abril,Luxemburgo,442,1,0,1,"(0.814836,-77.662532)"
2019,Septiembre,Australia,36,53,71,124,"(10.445761,-75.516429)"
2013,Agosto,Japón,392,6,8,14,"(10.445761,-75.516429)"
2021,Junio,Panamá,591,117,147,264,"(10.445761,-75.516429)"
2021,Junio,Turquía,792,104,199,303,"(4.697144,-74.140516)"
2023,Marzo,Estados Unidos de América,840,1,7,8,"(0.25129,-76.875963)"
2019,Enero,Kazajistán,398,7,7,14,"(4.697144,-74.140516)"
2023,Enero,Estonia,233,13,16,29,"(6.171601,-75.427454)"
2022,Junio,Francia,250,2,3,5,"(10.971302,-74.765397)"
2016,Julio,India,356,1,10,11,"(10.886611,-74.776708)"
2013,Abril,Perú,604,2871,3834,6705,"(4.697144,-74.140516)"
2013,Octubre,Portugal,620,0,2,2,"(10.408582,-75.538003)"
2012,Marzo,Alemania,276,11,19,30,"(-4.197703,-69.941278)"
2020,Febrero,Irán,364,1,1,2,"(10.445761,-75.516429)"
2019,Enero,Malta,470,2,2,4,"(10.445761,-75.516429)"
2013,Septiembre,Alemania,276,5,6,11,"(8.635765,-77.346578)"
2020,Octubre,Chipre,196,0,1,1,"(6.171601,-75.427454)"
2018,Noviembre,Lituania,440,4,10,14,"(10.445761,-75.516429)"
2014,Septiembre,Chile,152,3,2,5,"(7.927209,-72.507910)"
2012,Junio,España,724,0,1,1,"(0.25129,-76.875963)"
2022,Junio,Perú,604,0,1,1,"(10.971302,-74.765397)"
2017,Agosto,Perú,604,157,205,362,"(3.541112,-76.384584)"
2016,Julio,Mónaco,492,2,1,3,"(4.697144,-74.140516)"
2019,Septiembre,Perú,604,0,2,2,"(1.813928,-78.763924)"
2022,Julio,Guatemala,320,167,149,316,"(10.445761,-75.516429)"
2019,Agosto,Desconocido,99999,0,2,2,"(3.541112,-76.384584)"
2021,Agosto,Países Bajos,528,0,1,1,"(4.697144,-74.140516)"
2012,Marzo,China,156,0,1,1,"(10.886611,-74.776708)"
2019,Febrero,Cuba,192,0,2,2,"(7.128456,-73.183637)"
2012,Mayo,Surinam,740,7,21,28,"(4.697144,-74.140516)"
2019,Septiembre,República CentroÁfricana,140,0,1,1,"(4.697144,-74.140516)"
2020,Enero,Egipto,818,0,1,1,"(10.886611,-74.776708)"
2022,Noviembre,Cuba,192,3,11,14,"(10.886611,-74.776708)"
2022,Enero,Suiza,756,1,7,8,"(4.815061,-75.736532)"
2018,Diciembre,Hungría,348,2,2,4,"(0.814836,-77.662532)"
2016,Agosto,Argelia,12,0,1,1,"(3.541112,-76.384584)"
2014,Mayo,Chile,152,31,53,84,"(0.814836,-77.662532)"
2016,Septiembre,España,724,12,45,57,"(10.886611,-74.776708)"
2015,Septiembre,San Marino,674,0,1,1,"(6.171601,-75.427454)"
2013,Febrero,Suiza,756,19,38,57,"(10.445761,-75.516429)"
2012,Febrero,República de Corea,410,0,11,11,"(6.171601,-75.427454)"
2015,Abril,Jamaica,388,5,16,21,"(4.697144,-74.140516)"
2016,Mayo,Jamaica,388,0,1,1,"(12.586067,-81.702563)"
2013,Junio,Canadá,124,6,10,16,"(7.818934,-72.453226)"
2019,Septiembre,República Dominicana,214,1,2,3,"(0.25129,-76.875963)"
2015,Julio,Granada,308,0,2,2,"(10.408582,-75.538003)"
2014,Agosto,Trinidad y Tobago,780,5,2,7,"(7.128456,-73.183637)"
2017,Febrero,Turquía,792,1,0,1,"(-4.197703,-69.941278)"
2019,Febrero,Hong Kong,344,17,24,42,"(4.697144,-74.140516)"
2012,Julio,Panamá,591,0,1,1,"(-4.197703,-69.941278)"
2014,Abril,Singapur,702,7,15,22,"(4.697144,-74.140516)"
2018,Junio,Canadá,124,57,52,109,"(3.541112,-76.384584)"
2019,Marzo,Suiza,756,1,0,1,"(9.402978,-75.681599)"
2018,Diciembre,Líbano,422,0,1,1,"(10.445761,-75.516429)"
2022,Abril,India,356,1,1,2,"(10.971302,-74.765397)"
2016,Noviembre,Montenegro,499,0,3,3,"(10.408582,-75.538003)"
2013,Agosto,República de Irlanda,372,0,1,1,"(10.886611,-74.776708)"
2012,Julio,Francia,250,1,3,4,"(7.927209,-72.507910)"
2016,Octubre,Suecia,752,0,2,2,"(11.247723,-74.213989)"
2018,Junio,Federación de Rusia,643,1,0,1,"(4.815061,-75.736532)"
2018,Febrero,República Checa,203,0,1,1,"(-4.223468,-69.945098)"
2012,Agosto,Croacia,191,0,1,1,"(7.818934,-72.453226)"
2022,Octubre,España,724,3044,5142,8187,"(4.697144,-74.140516)"
2019,Enero,San Cristóbal y Nevis,659,3,3,6,"(4.697144,-74.140516)"
2022,Abril,Italia,380,36,59,95,"(3.541112,-76.384584)"
2017,Mayo,Cuba,192,0,1,1,"(7.818934,-72.453226)"
2016,Marzo,Ghana,288,0,1,1,"(10.408582,-75.538003)"
2014,Diciembre,Francia,250,1,6,7,"(7.927209,-72.507910)"
2022,Julio,Madagascar,450,4,0,4,"(4.697144,-74.140516)"
2022,Septiembre,Dinamarca,208,2,1,3,"(0.814836,-77.662532)"
2015,Septiembre,México,484,1,1,2,"(0.25129,-76.875963)"
2019,Agosto,Sudáfrica,710,1,0,1,"(0.814836,-77.662532)"
2018,Junio,Croacia,191,1,0,1,"(-4.223468,-69.945098)"
2020,Febrero,Trinidad y Tobago,780,3,6,9,"(3.541112,-76.384584)"
2019,Febrero,El Salvador,222,480,678,1158,"(4.697144,-74.140516)"
2020,Marzo,Nicaragua,558,1,0,1,"(12.586067,-81.702563)"
2019,Enero,Ecuador,218,0,1,1,"(7.128456,-73.183637)"
2012,Septiembre,Afganistán,4,0,1,1,"(0.814836,-77.662532)"
2013,Junio,Nepal,524,0,1,1,"(6.171601,-75.427454)"
2019,Enero,España,724,1,4,5,"(7.128456,-73.183637)"
2013,Octubre,Francia,250,0,1,1,"(7.927209,-72.507910)"
2016,Enero,Tailandia,764,1,0,1,"(3.541112,-76.384584)"
2016,Julio,Eslovenia,705,2,0,2,"(10.445761,-75.516429)"
2017,Mayo,Suiza,756,1,1,2,"(7.818934,-72.453226)"
2022,Septiembre,Paraguay,600,1,0,1,"(7.927209,-72.507910)"
2023,Febrero,Chile,152,24,40,64,"(0.814836,-77.662532)"
2014,Octubre,Japón,392,1,1,2,"(11.360009,-72.129330)"
2022,Marzo,Ucrania,804,82,38,120,"(4.697144,-74.140516)"
2022,Diciembre,Luxemburgo,442,1,1,2,"(3.541112,-76.384584)"
2017,Junio,India,356,1,3,4,"(-4.223468,-69.945098)"
2020,Noviembre,Costa Rica,188,2,5,7,"(10.445761,-75.516429)"
2012,Agosto,Dominica,212,0,1,1,"(11.360009,-72.129330)"
2015,Febrero,México,484,0,9,9,"(7.128456,-73.183637)"
2023,Marzo,Ecuador,218,0,1,1,"(3.866713,-67.927521)"
2022,Junio,Honduras,340,3,3,6,"(7.818934,-72.453226)"
2012,Febrero,Austria,40,2,5,7,"(10.445761,-75.516429)"
2018,Noviembre,Georgia,268,2,3,5,"(4.697144,-74.140516)"
2016,Abril,Vietnam,704,0,1,1,"(6.171601,-75.427454)"
2022,Agosto,Ecuador,218,1681,1210,2892,"(10.445761,-75.516429)"
2015,Mayo,España,724,19,43,62,"(7.818934,-72.453226)"
2019,Febrero,Togo,768,0,2,2,"(4.697144,-74.140516)"
2017,Enero,Finlandia,246,6,5,11,"(6.171601,-75.427454)"
2017,Julio,Cuba,192,0,1,1,"(7.088729,-70.740253)"
2019,Julio,India,356,25,61,86,"(10.445761,-75.516429)"
2013,Julio,Nicaragua,558,0,1,1,"(0.814836,-77.662532)"
2020,Diciembre,Indonesia,360,1,9,10,"(4.697144,-74.140516)"
2013,Mayo,Países Bajos,528,1,1,2,"(13.3387613,-81.372937)"
2020,Marzo,Estados Unidos de América,840,58,103,161,"(4.452882,-75.766298)"
2012,Enero,Francia,250,21,29,50,"(11.360009,-72.129330)"
2017,Enero,Francia,250,2,8,10,"(4.815061,-75.736532)"
2015,Junio,Estonia,233,0,2,2,"(10.445761,-75.516429)"
2017,Abril,Eslovaquia,703,1,0,1,"(10.886611,-74.776708)"
2019,Julio,Francia,250,3,4,7,"(11.247723,-74.213989)"
2013,Noviembre,Nueva Zelanda,554,8,8,16,"(0.814836,-77.662532)"
2015,Mayo,Haití,332,0,2,2,"(0.814836,-77.662532)"
2017,Diciembre,Rumania,642,1,1,2,"(-4.223468,-69.945098)"
2014,Abril,Canadá,124,82,176,258,"(6.171601,-75.427454)"
2015,Febrero,Australia,36,17,30,47,"(0.814836,-77.662532)"
2021,Abril,Haití,332,5,10,15,"(4.697144,-74.140516)"
2017,Octubre,Taiwán,158,2,1,3,"(7.818934,-72.453226)"
2014,Agosto,Países Bajos,528,7,41,48,"(10.445761,-75.516429)"
2015,Octubre,Brasil,76,1,35,36,"(4.815061,-75.736532)"
2018,Febrero,Turquía,792,0,1,1,"(11.360009,-72.129330)"
2016,Abril,Pakistán,586,3,10,13,"(4.697144,-74.140516)"
2013,Enero,Rumania,642,2,3,5,"(10.445761,-75.516429)"
2022,Junio,Georgia,268,0,1,1,"(10.886611,-74.776708)"
2014,Octubre,Países Bajos,528,2,12,14,"(4.815061,-75.736532)"
2022,Noviembre,Andorra,20,0,4,4,"(4.697144,-74.140516)"
2016,Noviembre,Ucrania,804,0,1,1,"(0.814836,-77.662532)"
2021,Diciembre,Francia,250,1,0,1,"(12.586067,-81.702563)"
2013,Febrero,Honduras,340,12,18,30,"(3.541112,-76.384584)"
2019,Febrero,Australia,36,10,11,21,"(10.408582,-75.538003)"
2015,Julio,Ecuador,218,167,217,384,"(7.818934,-72.453226)"
2014,Noviembre,Federación de Rusia,643,1,4,5,"(-4.197703,-69.941278)"
2022,Febrero,Austria,40,1,0,1,"(8.635765,-77.346578)"
2012,Mayo,Panamá,591,1,0,1,"(0.814836,-77.662532)"
2017,Febrero,Ecuador,218,8,21,29,"(10.408582,-75.538003)"
2016,Agosto,Bulgaria,100,0,1,1,"(10.445761,-75.516429)"
2023,Abril,Bélgica,56,1,7,8,"(10.886611,-74.776708)"
2022,Noviembre,Estonia,233,3,7,10,"(10.445761,-75.516429)"
2019,Agosto,Australia,36,0,1,1,"(4.452882,-75.766298)"
2014,Agosto,Reino Unido de Gran Bretaña e Irlanda del Norte,826,25,49,74,"(3.541112,-76.384584)"
2013,Enero,Países Bajos,528,0,1,1,"(-4.197703,-69.941278)"
2013,Noviembre,Federación de Rusia,643,0,1,1,"(12.586067,-81.702563)"
2018,Octubre,Bélgica,56,0,2,2,"(0.25129,-76.875963)"
2016,Mayo,Estados Unidos de América,840,7,6,13,"(8.635765,-77.346578)"
2022,Septiembre,España,724,5,15,20,"(8.36068,-72.409396)"
2021,Julio,Australia,36,0,4,4,"(10.886611,-74.776708)"
2020,Octubre,Guyana,328,1,0,1,"(4.697144,-74.140516)"
2020,Marzo,Argentina,32,0,2,2,"(10.971302,-74.765397)"
2019,Febrero,Polonia,616,1,0,1,"(10.971302,-74.765397)"
2013,Octubre,República de Irlanda,372,5,3,8,"(3.541112,-76.384584)"
2018,Enero,Australia,36,25,52,77,"(0.814836,-77.662532)"
2012,Julio,República de Corea,410,0,1,1,"(8.635765,-77.346578)"
2019,Septiembre,India,356,75,449,528,"(4.697144,-74.140516)"
2014,Febrero,Omán,512,0,1,1,"(4.697144,-74.140516)"
2014,Septiembre,Polonia,616,0,2,2,"(10.886611,-74.776708)"
2013,Febrero,Polonia,616,3,11,14,"(10.445761,-75.516429)"
2016,Junio,Bélgica,56,0,1,1,"(6.185799,-67.483929)"
2013,Febrero,Federación de Rusia,643,0,9,9,"(10.408582,-75.538003)"
2019,Enero,Indonesia,360,0,1,1,"(10.971302,-74.765397)"
2014,Agosto,Austria,40,8,4,12,"(3.541112,-76.384584)"
2012,Mayo,España,724,1,0,1,"(7.088729,-70.740253)"
2022,Julio,Afganistán,4,0,1,1,"(4.697144,-74.140516)"
2018,Febrero,España,724,0,1,1,"(6.17134,-75.427194)"
2023,Junio,Uruguay,858,1,0,1,"(-4.223468,-69.945098)"
2017,Julio,Guatemala,320,1,4,5,"(7.818934,-72.453226)"
2018,Mayo,El Salvador,222,4,2,6,"(4.815061,-75.736532)"
2012,Septiembre,Nueva Zelanda,554,9,9,18,"(0.814836,-77.662532)"
2014,Julio,Ecuador,218,56,106,162,"(0.25129,-76.875963)"
2020,Febrero,México,484,12,29,41,"(7.818934,-72.453226)"
2023,Enero,Barbados,52,1,0,1,"(10.886611,-74.776708)"
2014,Agosto,Italia,380,3,4,7,"(8.635765,-77.346578)"
2014,Enero,Países Bajos,528,0,2,2,"(7.088729,-70.740253)"
2016,Julio,Ucrania,804,22,8,30,"(4.697144,-74.140516)"
2017,Enero,Dominica,212,0,3,3,"(6.171601,-75.427454)"
2018,Octubre,Italia,380,0,7,7,"(11.360009,-72.129330)"
2020,Marzo,Estados Unidos de América,840,43,91,134,"(10.408582,-75.538003)"
2018,Abril,Brasil,76,0,1,1,"(11.117806,-74.232622)"
2013,Marzo,China,156,7,7,14,"(10.445761,-75.516429)"
2017,Diciembre,Canadá,124,1,2,3,"(-4.223468,-69.945098)"
2013,Agosto,Ecuador,218,1,143,144,"(1.813928,-78.763924)"
2016,Diciembre,Chile,152,1,2,3,"(7.128456,-73.183637)"
2012,Septiembre,Ecuador,218,0,109,109,"(1.813928,-78.763924)"
2020,Marzo,Panamá,591,15,28,43,"(7.128456,-73.183637)"
2023,Abril,Bélgica,56,3,1,4,"(8.635765,-77.346578)"
2012,Septiembre,Ecuador,218,802,1276,2078,"(0.814836,-77.662532)"
2014,Noviembre,Santa Lucia,662,1,0,1,"(10.445761,-75.516429)"
2017,Diciembre,Eslovenia,705,0,1,1,"(10.886611,-74.776708)"
2012,Diciembre,Territorio Antártico Británico/Territorio Británico de Ultramar,260,0,1,1,"(6.171601,-75.427454)"
2015,Abril,Nueva Zelanda,554,38,66,104,"(4.697144,-74.140516)"
2019,Julio,República de Corea,410,0,1,1,"(4.815061,-75.736532)"
2021,Marzo,Jamaica,388,1,0,1,"(10.886611,-74.776708)"
2018,Agosto,República de Corea,410,252,458,710,"(4.697144,-74.140516)"
2019,Noviembre,República Dominicana,214,0,1,1,"(8.36068,-72.409396)"
2018,Enero,Bulgaria,100,3,12,15,"(6.171601,-75.427454)"
2018,Febrero,Letonia,428,8,18,26,"(4.697144,-74.140516)"
2019,Noviembre,Estados Unidos de América,840,9,14,23,"(-4.223468,-69.945098)"
2013,Octubre,Federación de Rusia,643,0,2,2,"(7.818934,-72.453226)"
2013,Noviembre,Bahamas,44,0,4,4,"(4.697144,-74.140516)"
2022,Agosto,Trinidad y Tobago,780,5,12,17,"(3.541112,-76.384584)"
2020,Febrero,Países Bajos,528,375,341,716,"(10.445761,-75.516429)"
2017,Noviembre,Paraguay,600,2,3,5,"(7.818934,-72.453226)"
2021,Abril,Argentina,32,0,3,3,"(7.128456,-73.183637)"
2022,Enero,Ecuador,218,0,4,4,"(7.927209,-72.507910)"
2022,Abril,Canadá,124,1,0,1,"(7.927209,-72.507910)"
2019,Marzo,Austria,40,1,1,2,"(-4.197703,-69.941278)"
2020,Noviembre,Liechtenstein,438,1,1,2,"(6.171601,-75.427454)"
2013,Julio,China,156,1,2,3,"(10.886611,-74.776708)"
2014,Mayo,Perú,604,11,30,41,"(11.360009,-72.129330)"
2013,Julio,Argentina,32,441,327,768,"(10.445761,-75.516429)"
2023,Enero,Ucrania,804,0,1,1,"(0.814836,-77.662532)"
2012,Agosto,Chile,152,1,2,3,"(-4.197703,-69.941278)"
2015,Junio,México,484,24,37,61,"(0.814836,-77.662532)"
2015,Junio,Dinamarca,208,2,7,9,"(10.445761,-75.516429)"
2016,Octubre,Panamá,591,53,64,117,"(10.886611,-74.776708)"
2012,Septiembre,Dinamarca,208,3,1,4,"(0.814836,-77.662532)"
2014,Octubre,Letonia,428,0,1,1,"(11.247723,-74.213989)"
2021,Mayo,Ghana,288,0,2,2,"(10.445761,-75.516429)"
2015,Marzo,Filipinas,608,1,16,17,"(3.541112,-76.384584)"
2019,Septiembre,Uruguay,858,14,8,22,"(10.408582,-75.538003)"
2013,Agosto,Perú,604,139,77,216,"(12.586067,-81.702563)"
2012,Junio,Haití,332,0,2,2,"(10.445761,-75.516429)"
2012,Noviembre,República Dominicana,214,6,37,43,"(4.815061,-75.736532)"
2015,Febrero,Islandia,352,1,0,1,"(8.635765,-77.346578)"
2020,Marzo,Georgia,268,0,1,1,"(10.408582,-75.538003)"
2012,Julio,Reino Unido de Gran Bretaña e Irlanda del Norte,826,0,2,2,"(6.171601,-75.427454)"
2023,Febrero,Italia,380,0,3,3,"(7.088729,-70.740253)"
2019,Mayo,República de Corea,410,0,1,1,"(12.586067,-81.702563)"
2022,Abril,Desconocido,99999,2,2,4,"(10.445761,-75.516429)"
2019,Junio,Trinidad y Tobago,780,5,8,13,"(3.541112,-76.384584)"
2015,Julio,República de Armenia,51,1,0,1,"(4.697144,-74.140516)"
2014,Diciembre,Haití,332,1,2,3,"(10.445761,-75.516429)"
2018,Enero,Palestina,99999,1,0,1,"(6.171601,-75.427454)"
2019,Agosto,Paraguay,600,23,15,38,"(12.586067,-81.702563)"
2012,Mayo,Guinea Ecuatorial,226,1,0,1,"(4.697144,-74.140516)"
2018,Octubre,España,724,2,2,4,"(-4.223468,-69.945098)"
2017,Julio,Nicaragua,558,0,1,1,"(10.408582,-75.538003)"
2014,Febrero,Cuba,192,1,0,1,"(11.360009,-72.129330)"
2012,Octubre,Azerbaiyán,31,2,1,3,"(4.697144,-74.140516)"
2015,Abril,República Checa,203,4,1,5,"(6.171601,-75.427454)"
2016,Febrero,Croacia,191,1,1,2,"(-4.197703,-69.941278)"
2013,Octubre,Italia,380,0,3,3,"(4.815061,-75.736532)"
2019,Diciembre,Bélgica,56,1,1,2,"(0.25129,-76.875963)"
2014,Agosto,Brasil,76,72,65,137,"(-4.197703,-69.941278)"
2016,Agosto,Alemania,276,157,246,403,"(6.171601,-75.427454)"
2015,Abril,República de Corea,410,10,23,33,"(6.171601,-75.427454)"
2012,Abril,Grecia,300,2,2,4,"(10.445761,-75.516429)"
2018,Abril,Canadá,124,1,2,3,"(13.3387613,-81.372937)"
2021,Junio,Reino Unido de Gran Bretaña e Irlanda del Norte,826,0,3,3,"(10.408582,-75.538003)"
2018,Marzo,Estados Unidos de América,840,8,14,22,"(8.635765,-77.346578)"
2015,Abril,Austria,40,6,10,16,"(6.171601,-75.427454)"
2015,Julio,Finlandia,246,6,8,14,"(6.171601,-75.427454)"
2018,Enero,Estonia,233,4,2,6,"(3.541112,-76.384584)"
2016,Noviembre,Estados Unidos de América,840,480,954,1434,"(10.886611,-74.776708)"
2021,Diciembre,Etiopia,231,1,37,38,"(4.697144,-74.140516)"
2015,Julio,Ecuador,218,1,2,3,"(7.128456,-73.183637)"
2016,Noviembre,México,484,7,19,26,"(4.815061,-75.736532)"
2019,Abril,Nicaragua,558,86,130,216,"(4.697144,-74.140516)"
2023,Marzo,Chipre,196,0,1,1,"(10.445761,-75.516429)"
2012,Febrero,Cuba,192,0,4,4,"(4.452882,-75.766298)"
2017,Octubre,Malasia,458,2,0,2,"(10.445761,-75.516429)"
2013,Junio,Tailandia,764,1,0,1,"(10.445761,-75.516429)"
2019,Diciembre,India,356,0,3,3,"(3.893038,-77.067921)"
2019,Noviembre,Perú,604,0,1,1,"(8.635765,-77.346578)"
2021,Agosto,Chile,152,13,21,34,"(10.445761,-75.516429)"
2019,Diciembre,Canadá,124,6,4,10,"(4.452882,-75.766298)"
2022,Septiembre,Perú,604,1,1,2,"(7.088729,-70.740253)"
2017,Marzo,Noruega,578,20,26,46,"(10.445761,-75.516429)"
2019,Octubre,Benín,204,0,2,2,"(4.697144,-74.140516)"
2014,Diciembre,Nueva Zelanda,554,2,2,4,"(-4.197703,-69.941278)"
2019,Noviembre,República Checa,203,6,4,10,"(3.541112,-76.384584)"
2015,Mayo,Dinamarca,208,78,143,221,"(4.697144,-74.140516)"
2022,Noviembre,Grecia,300,53,108,161,"(4.697144,-74.140516)"
2013,Octubre,Italia,380,0,1,1,"(0.25129,-76.875963)"
2013,Agosto,Letonia,428,0,1,1,"(10.445761,-75.516429)"
2019,Agosto,República de Irlanda,372,180,224,404,"(4.697144,-74.140516)"
2016,Diciembre,Bahamas,44,6,3,9,"(6.171601,-75.427454)"
2020,Octubre,Panamá,591,81,81,162,"(3.541112,-76.384584)"
2022,Julio,Ucrania,804,1,1,2,"(7.128456,-73.183637)"
2023,Enero,Singapur,702,0,2,2,"(3.541112,-76.384584)"
2018,Enero,Chile,152,6,2,8,"(-4.223468,-69.945098)"
2020,Diciembre,Alemania,276,13,21,34,"(3.541112,-76.384584)"
2013,Agosto,Paraguay,600,75,86,161,"(4.697144,-74.140516)"
2019,Diciembre,Polonia,616,16,35,51,"(6.171601,-75.427454)"
2022,Noviembre,Suiza,756,1,0,1,"(7.916725,-72.462544)"
2015,Diciembre,Alemania,276,0,2,2,"(13.3387613,-81.372937)"
2022,Agosto,Mozambique,508,1,0,1,"(0.814836,-77.662532)"
2021,Octubre,Panamá,591,0,1,1,"(11.247723,-74.213989)"
2021,Junio,Francia,250,6,6,12,"(10.408582,-75.538003)"
2019,Julio,Bolivia,68,1,0,1,"(11.360009,-72.129330)"
2016,Agosto,Sudáfrica,710,0,2,2,"(3.541112,-76.384584)"
2015,Abril,Malta,470,1,12,13,"(4.697144,-74.140516)"
2012,Enero,Uruguay,858,7,6,13,"(0.814836,-77.662532)"
2013,Marzo,China,156,167,498,665,"(4.697144,-74.140516)"
2021,Marzo,México,484,18,11,29,"(4.815061,-75.736532)"
2022,Agosto,Guyana,328,5,4,9,"(6.171601,-75.427454)"
2020,Marzo,México,484,270,425,695,"(10.445761,-75.516429)"
2017,Junio,Estados Unidos de América,840,3702,6404,10106,"(6.171601,-75.427454)"
2012,Septiembre,Federación de Rusia,643,0,1,1,"(10.408582,-75.538003)"
2023,Febrero,Vietnam,704,0,4,4,"(10.971302,-74.765397)"
2017,Septiembre,El Salvador,222,83,109,192,"(3.541112,-76.384584)"
2022,Noviembre,Austria,40,1,0,1,"(4.815061,-75.736532)"
2018,Enero,Suecia,752,10,8,18,"(10.408582,-75.538003)"
2019,Mayo,Alemania,276,7,12,19,"(-4.197703,-69.941278)"
2018,Noviembre,Chipre,196,1,1,2,"(6.171601,-75.427454)"
2018,Agosto,Nicaragua,558,0,1,1,"(11.360009,-72.129330)"
2020,Noviembre,Costa Rica,188,0,1,1,"(7.818934,-72.453226)"
2019,Octubre,Japón,392,7,31,38,"(6.171601,-75.427454)"
2017,Septiembre,Ucrania,804,1,3,4,"(3.541112,-76.384584)"
2013,Diciembre,Honduras,340,1,1,2,"(8.635765,-77.346578)"
2018,Octubre,Reino Unido de Gran Bretaña e Irlanda del Norte,826,73,254,327,"(6.171601,-75.427454)"
2019,Septiembre,India,356,0,6,6,"(9.402978,-75.681599)"
2017,Agosto,Argentina,32,1,1,2,"(-4.223468,-69.945098)"
2015,Julio,Estonia,233,0,1,1,"(0.814836,-77.662532)"
2014,Enero,Pakistán,586,0,4,4,"(6.171601,-75.427454)"
2013,Febrero,Japón,392,0,1,1,"(4.815061,-75.736532)"
2013,Enero,Kirguistán,417,3,1,4,"(4.697144,-74.140516)"
2014,Marzo,Italia,380,3,1,4,"(7.927209,-72.507910)"
2022,Mayo,España,724,258,561,819,"(6.171601,-75.427454)"
2015,Julio,Nigeria,566,0,2,2,"(10.445761,-75.516429)"
2012,Enero,Singapur,702,0,2,2,"(10.445761,-75.516429)"
2012,Noviembre,Costa Rica,188,68,141,209,"(6.171601,-75.427454)"
2019,Diciembre,Tailandia,764,2,1,3,"(6.171601,-75.427454)"
2013,Junio,Islas Caimán/Territorio Británico de Ultramar,136,1,0,1,"(4.697144,-74.140516)"
2019,Febrero,Chile,152,561,420,981,"(10.408582,-75.538003)"
2013,Octubre,Italia,380,404,1615,2019,"(4.697144,-74.140516)"
2019,Agosto,Bélgica,56,1,1,2,"(11.247723,-74.213989)"
2019,Diciembre,Canadá,124,1,0,1,"(8.36068,-72.409396)"
2023,Febrero,México,484,0,11,11,"(3.893038,-77.067921)"
2020,Diciembre,Marruecos,504,1,0,1,"(10.445761,-75.516429)"
2016,Julio,Paraguay,600,1,1,2,"(7.818934,-72.453226)"
2014,Mayo,Honduras,340,3,2,5,"(12.586067,-81.702563)"
2015,Agosto,Francia,250,110,136,246,"(0.814836,-77.662532)"
2019,Abril,Guayana Francesa/Departamento de Ultramar Francés,254,0,1,1,"(3.541112,-76.384584)"
2012,Noviembre,Japón,392,124,462,586,"(4.697144,-74.140516)"
2013,Marzo,Argentina,32,0,7,7,"(7.927209,-72.507910)"
2017,Marzo,Taiwán,158,87,128,215,"(4.697144,-74.140516)"
2019,Diciembre,Ucrania,804,3,11,15,"(10.445761,-75.516429)"
2013,Marzo,Suecia,752,2,3,5,"(10.886611,-74.776708)"
2019,Mayo,Finlandia,246,4,8,12,"(6.171601,-75.427454)"
2019,Octubre,Venezuela,862,2,1,3,"(12.586067,-81.702563)"
2013,Julio,España,724,3,2,5,"(10.408582,-75.538003)"
2018,Enero,Honduras,340,8,7,15,"(0.814836,-77.662532)"
2017,Julio,Noruega,578,31,43,74,"(10.445761,-75.516429)"
2022,Diciembre,China,156,0,1,1,"(8.36068,-72.409396)"
2012,Enero,México,484,2,2,4,"(7.128456,-73.183637)"
2021,Febrero,Nicaragua,558,0,5,5,"(12.5744111,-81.703935)"
2021,Junio,Reino Unido de Gran Bretaña e Irlanda del Norte,826,1,2,3,"(7.818934,-72.453226)"
2012,Junio,Uruguay,858,4,13,17,"(3.541112,-76.384584)"
2015,Abril,Países Bajos,528,4,6,10,"(7.818934,-72.453226)"
2015,Enero,Suecia,752,17,14,31,"(-4.197703,-69.941278)"
2019,Agosto,Venezuela,862,4,13,17,"(1.813928,-78.763924)"
2023,Junio,República Checa,203,0,2,2,"(7.128456,-73.183637)"
2013,Noviembre,Georgia,268,1,0,1,"(4.697144,-74.140516)"
2019,Noviembre,México,484,2,7,9,"(11.360009,-72.129330)"
2014,Noviembre,Países Bajos,528,4,3,7,"(8.635765,-77.346578)"
2017,Enero,Santa Lucia,662,1,0,1,"(10.445761,-75.516429)"
2021,Marzo,China,156,1,0,1,"(10.886611,-74.776708)"
2012,Marzo,Puerto Rico/Territorio de Estados Unidos,630,0,2,2,"(6.171601,-75.427454)"
2023,Junio,Albania,8,1,1,2,"(10.445761,-75.516429)"
2017,Abril,Kenia,404,0,1,1,"(6.171601,-75.427454)"
2021,Agosto,México,484,1862,2983,4845,"(4.697144,-74.140516)"
2013,Septiembre,Turquía,792,3,11,14,"(10.445761,-75.516429)"
2012,Noviembre,Kenia,404,2,7,9,"(4.697144,-74.140516)"
2017,Julio,China,156,11,13,24,"(0.814836,-77.662532)"
2016,Febrero,Perú,604,4401,4969,9370,"(4.697144,-74.140516)"
2013,Diciembre,Uganda,800,4,6,10,"(4.697144,-74.140516)"
2017,Noviembre,República de Corea,410,3,13,16,"(10.445761,-75.516429)"
2018,Febrero,Egipto,818,0,2,2,"(7.818934,-72.453226)"
2022,Julio,Italia,380,50,38,88,"(7.916725,-72.462544)"
2019,Julio,Noruega,578,29,21,50,"(10.445761,-75.516429)"
2022,Julio,Myanmar,104,0,24,24,"(3.893038,-77.067921)"
2017,Mayo,República de Irlanda,372,0,3,3,"(-4.223468,-69.945098)"
2017,Septiembre,República de Irlanda,372,3,2,5,"(10.886611,-74.776708)"
2013,Marzo,Argentina,32,77,122,199,"(0.814836,-77.662532)"
2016,Septiembre,Chile,152,2,4,6,"(11.360009,-72.129330)"
2017,Agosto,Israel,376,18,54,72,"(6.171601,-75.427454)"
2016,Febrero,Bélgica,56,4,13,17,"(10.445761,-75.516429)"
2022,Julio,Austria,40,6,11,17,"(3.541112,-76.384584)"
2019,Septiembre,México,484,103,215,318,"(3.541112,-76.384584)"
2021,Noviembre,México,484,926,1834,2760,"(6.171601,-75.427454)"
2021,Mayo,República Dominicana,214,1,0,1,"(-4.197703,-69.941278)"
2013,Abril,Estados Unidos de América,840,0,2,2,"(11.528919,-72.919681)"
2016,Febrero,Guatemala,320,2,6,8,"(7.128456,-73.183637)"
2018,Febrero,Israel,376,0,4,4,"(10.408582,-75.538003)"
2017,Agosto,Guatemala,320,72,182,254,"(6.171601,-75.427454)"
2017,Enero,Iraq,368,1,1,2,"(0.814836,-77.662532)"
2012,Marzo,Bolivia,68,54,11,65,"(10.445761,-75.516429)"
2018,Septiembre,Eslovaquia,703,0,1,1,"(10.408582,-75.538003)"
2014,Septiembre,Tailandia,764,1,1,2,"(6.171601,-75.427454)"
2014,Octubre,Arabia Saudita,682,0,1,1,"(6.171601,-75.427454)"
2021,Julio,Brasil,76,0,1,1,"(11.360009,-72.129330)"
2018,Abril,Filipinas,608,1,8,9,"(10.886611,-74.776708)"
2013,Noviembre,Reino Unido de Gran Bretaña e Irlanda del Norte,826,25,46,71,"(0.814836,-77.662532)"
2023,Mayo,Francia,250,179,295,474,"(6.171601,-75.427454)"
2018,Abril,Perú,604,0,1,1,"(8.635765,-77.346578)"
2023,Enero,Guatemala,320,4,5,9,"(4.452882,-75.766298)"
2019,Julio,Santa Lucia,662,1,0,1,"(7.128456,-73.183637)"
2018,Marzo,México,484,1,1,2,"(0.25129,-76.875963)"
2014,Abril,Suecia,752,141,214,355,"(4.697144,-74.140516)"
2013,Julio,Cuba,192,0,1,1,"(11.360009,-72.129330)"
2017,Septiembre,Perú,604,0,1,1,"(3.893038,-77.067921)"
2022,Enero,Italia,380,14,11,25,"(7.927209,-72.507910)"
2015,Marzo,Venezuela,862,28,110,138,"(10.886611,-74.776708)"
2017,Enero,España,724,0,1,1,"(11.117806,-74.232622)"
2013,Septiembre,Camerún,120,0,2,2,"(10.445761,-75.516429)"
2017,Julio,Paraguay,600,33,18,51,"(10.445761,-75.516429)"
2019,Diciembre,Venezuela,862,544,542,1086,"(10.445761,-75.516429)"
2022,Enero,Líbano,422,1,1,2,"(10.445761,-75.516429)"
2014,Enero,Alemania,276,10,11,21,"(8.635765,-77.346578)"
2022,Marzo,Bermudas/Territorio Británico de Ultramar,60,3,1,4,"(4.697144,-74.140516)"
2012,Abril,Surinam,740,1,0,1,"(10.408582,-75.538003)"
2021,Septiembre,Costa Rica,188,2,8,10,"(7.128456,-73.183637)"
2014,Noviembre,Canadá,124,34,43,77,"(3.541112,-76.384584)"
2014,Octubre,República Árabe Siria,760,1,1,2,"(10.445761,-75.516429)"
2019,Junio,Federación de Rusia,643,20,18,38,"(6.171601,-75.427454)"
2012,Julio,Costa Rica,188,0,1,1,"(7.128456,-73.183637)"
2016,Julio,Venezuela,862,4,6,10,"No Aplica,No Aplica"
2020,Enero,Polonia,616,23,43,66,"(6.171601,-75.427454)"
2021,Agosto,Japón,392,1,7,8,"(10.408582,-75.538003)"
2014,Abril,Perú,604,21,39,60,"(11.360009,-72.129330)"
2019,Agosto,Venezuela,862,1791,1770,3561,"(6.171601,-75.427454)"
2012,Mayo,Federación de Rusia,643,1,2,3,"(11.247723,-74.213989)"
2012,Junio,Federación de Rusia,643,0,2,2,"(10.408582,-75.538003)"
2016,Octubre,Alemania,276,1,2,3,"(4.452882,-75.766298)"
2017,Octubre,Nigeria,566,1,0,1,"(3.541112,-76.384584)"
2019,Enero,Filipinas,608,1,0,1,"(-4.223468,-69.945098)"
2018,Enero,Israel,376,0,1,1,"(7.128456,-73.183637)"
2018,Octubre,España,724,10,8,18,"(-4.197703,-69.941278)"
2016,Mayo,Luxemburgo,442,0,11,11,"(4.697144,-74.140516)"
2019,Junio,India,356,12,75,88,"(6.171601,-75.427454)"
2012,Diciembre,Líbano,422,5,3,8,"(11.360009,-72.129330)"
2014,Agosto,Dinamarca,208,6,9,15,"(6.171601,-75.427454)"
2015,Diciembre,Santa Lucia,662,1,0,1,"(10.445761,-75.516429)"
2023,Marzo,Perú,604,0,21,21,"(10.971302,-74.765397)"
2015,Agosto,Honduras,340,0,14,14,"(12.5744111,-81.703935)"
2017,Agosto,Nueva Zelanda,554,2,4,6,"(3.541112,-76.384584)"
2022,Marzo,España,724,2445,4660,7108,"(4.697144,-74.140516)"
2022,Febrero,Turquía,792,3,18,21,"(6.171601,-75.427454)"
2012,Noviembre,España,724,3,8,11,"(12.586067,-81.702563)"
2019,Agosto,Argelia,12,0,1,1,"(4.815061,-75.736532)"
2013,Agosto,España,724,1,3,4,"(7.927209,-72.507910)"
2016,Mayo,Brasil,76,14,19,33,"(7.818934,-72.453226)"
2019,Abril,Ucrania,804,0,7,7,"(10.886611,-74.776708)"
2019,Diciembre,Guatemala,320,7,10,17,"(10.408582,-75.538003)"
2017,Julio,Canadá,124,4,6,10,"(4.452882,-75.766298)"
2014,Agosto,Jamaica,388,11,32,43,"(4.697144,-74.140516)"
2020,Enero,Países Bajos,528,3,18,21,"(7.818934,-72.453226)"
2021,Junio,Sudáfrica,710,0,3,3,"(10.886611,-74.776708)"
2015,Noviembre,Rumania,642,3,2,5,"(3.541112,-76.384584)"
2023,Marzo,Alemania,276,1,1,2,"(7.927209,-72.507910)"
2017,Febrero,Francia,250,24,21,45,"(-4.197703,-69.941278)"
2014,Julio,Palestina,99999,1,1,2,"(4.697144,-74.140516)"
2013,Marzo,Estados Unidos de América,840,21,51,72,"(7.818934,-72.453226)"
2022,Noviembre,Polonia,616,4,5,9,"(3.541112,-76.384584)"
2015,Junio,Ucrania,804,0,2,2,"(3.893038,-77.067921)"
2019,Agosto,Guatemala,320,66,157,223,"(6.171601,-75.427454)"
2021,Agosto,Venezuela,862,15,19,34,"(0.814836,-77.662532)"
2018,Octubre,Bahamas,44,8,8,16,"(4.697144,-74.140516)"
2020,Enero,Lituania,440,10,10,20,"(6.171601,-75.427454)"
2017,Noviembre,Filipinas,608,1,0,1,"(4.815061,-75.736532)"
2018,Julio,México,484,132,219,351,"(3.541112,-76.384584)"
2023,Marzo,Panamá,591,1,7,8,"(8.364293,-72.405710)"
2016,Octubre,Barbados,52,15,15,30,"(4.697144,-74.140516)"
2012,Marzo,Venezuela,862,1299,1506,2805,"(7.818934,-72.453226)"
2014,Mayo,Portugal,620,6,5,11,"(10.408582,-75.538003)"
2016,Noviembre,Egipto,818,1,0,1,"(3.541112,-76.384584)"
2019,Marzo,Nicaragua,558,1,0,1,"(4.452882,-75.766298)"
2018,Mayo,Finlandia,246,4,2,6,"(0.814836,-77.662532)"
2022,Junio,Honduras,340,0,7,7,"(10.408582,-75.538003)"
2021,Diciembre,Grecia,300,60,79,139,"(4.697144,-74.140516)"
2012,Octubre,Singapur,702,3,0,3,"(10.445761,-75.516429)"
2014,Junio,Brasil,76,5,20,25,"(10.886611,-74.776708)"
2015,Junio,Montenegro,499,0,1,1,"(10.971302,-74.765397)"
2016,Agosto,Panamá,591,0,10,10,"(7.927209,-72.507910)"
2021,Diciembre,Costa Rica,188,14,10,24,"(4.815061,-75.736532)"
2018,Noviembre,Filipinas,608,6,3,9,"(6.171601,-75.427454)"
2014,Diciembre,Líbano,422,3,1,4,"(10.445761,-75.516429)"
2016,Noviembre,Federación de Rusia,643,0,1,1,"(8.635765,-77.346578)"
2019,Abril,Perú,604,1,15,16,"(0.25129,-76.875963)"
2017,Marzo,Serbia,688,1,1,2,"(10.445761,-75.516429)"
2022,Julio,Portugal,620,3,4,7,"(10.886611,-74.776708)"
2015,Enero,Santa Lucia,662,0,1,1,"(6.171601,-75.427454)"
2012,Mayo,República Dominicana,214,17,22,39,"(3.541112,-76.384584)"
2020,Marzo,Dominica,212,1,3,4,"(4.697144,-74.140516)"
2015,Octubre,Letonia,428,0,1,1,"(10.971302,-74.765397)"
2017,Enero,España,724,225,564,789,"(6.171601,-75.427454)"
2014,Octubre,Portugal,620,0,3,3,"(11.360009,-72.129330)"
2019,Septiembre,Chile,152,1,0,1,"(4.452882,-75.766298)"
2018,Marzo,Costa de Marfil,384,3,1,4,"(4.697144,-74.140516)"
2023,Mayo,Italia,380,5,5,10,"(11.117806,-74.232622)"
2012,Noviembre,Rumania,642,22,54,76,"(4.697144,-74.140516)"
2018,Diciembre,Francia,250,0,4,4,"(11.360009,-72.129330)"
2018,Octubre,Países Bajos,528,15,34,49,"(10.886611,-74.776708)"
2013,Mayo,Bolivia,68,0,2,2,"(12.586067,-81.702563)"
2019,Diciembre,Perú,604,19,15,34,"(11.360009,-72.129330)"
2022,Junio,Francia,250,0,1,1,"(8.36068,-72.409396)"
2018,Septiembre,Australia,36,1,1,2,"(11.247723,-74.213989)"
2022,Noviembre,Azerbaiyán,31,9,17,26,"(4.697144,-74.140516)"
2022,Septiembre,Bulgaria,100,1,0,1,"(3.541112,-76.384584)"
2016,Septiembre,Chile,152,4,4,8,"(-4.197703,-69.941278)"
2020,Febrero,Austria,40,1,2,3,"(-4.197703,-69.941278)"
2014,Junio,Eslovaquia,703,3,0,3,"(11.360009,-72.129330)"
2017,Enero,Federación de Rusia,643,1,0,1,"(12.5744111,-81.703935)"
2019,Junio,Federación de Rusia,643,7,9,16,"(3.541112,-76.384584)"
2017,Mayo,Turquía,792,2,2,4,"(-4.223468,-69.945098)"
2018,Septiembre,Japón,392,0,2,2,"(4.815061,-75.736532)"
2018,Noviembre,México,484,3,7,10,"(4.16909,-73.612469)"
2012,Julio,Serbia,688,0,1,1,"(0.814836,-77.662532)"
2013,Octubre,Panamá,591,1,1,2,"(7.102626,-77.762647)"
2017,Febrero,Chile,152,0,1,1,"(8.635765,-77.346578)"
2012,Enero,Grecia,300,0,1,1,"(0.814836,-77.662532)"
2018,Noviembre,Chile,152,41,63,104,"(0.814836,-77.662532)"
2023,Mayo,Liechtenstein,438,1,1,2,"(4.697144,-74.140516)"
2022,Septiembre,Uruguay,858,330,397,727,"(4.697144,-74.140516)"
2012,Enero,Hungría,348,0,1,1,"(6.171601,-75.427454)"
2018,Febrero,Emiratos Árabes,784,3,8,11,"(4.697144,-74.140516)"
2022,Julio,Costa Rica,188,1148,843,1991,"(10.445761,-75.516429)"
2017,Junio,Francia,250,2,0,2,"(12.586067,-81.702563)"
2017,Febrero,México,484,0,1,1,"(6.185799,-67.483929)"
2012,Abril,Bolivia,68,1,1,2,"(12.586067,-81.702563)"
2021,Octubre,Eslovenia,705,1,3,4,"(10.445761,-75.516429)"
2012,Julio,Kenia,404,6,10,16,"(4.697144,-74.140516)"
2016,Marzo,Ecuador,218,50,195,245,"(10.886611,-74.776708)"
2013,Octubre,Nueva Zelanda,554,0,1,1,"(-4.197703,-69.941278)"
2015,Octubre,Zambia,894,0,1,1,"(7.128456,-73.183637)"
2015,Septiembre,México,484,138,264,402,"(10.445761,-75.516429)"
2016,Diciembre,República Dominicana,214,41,63,104,"(6.171601,-75.427454)"
2014,Marzo,España,724,31,60,91,"(0.814836,-77.662532)"
2020,Diciembre,Finlandia,246,0,3,3,"(6.171601,-75.427454)"
2012,Febrero,México,484,1,5,6,"(7.927209,-72.507910)"
2013,Febrero,Cuba,192,84,184,268,"(4.697144,-74.140516)"
2016,Junio,Canadá,124,756,1310,2066,"(4.697144,-74.140516)"
2022,Enero,Belice,84,2,1,3,"(4.697144,-74.140516)"
2018,Noviembre,Venezuela,862,98,83,181,"(0.25129,-76.875963)"
2019,Diciembre,México,484,39,101,140,"(3.541112,-76.384584)"
2016,Septiembre,Nueva Zelanda,554,6,9,15,"(10.408582,-75.538003)"
2022,Mayo,Namibia,516,1,1,2,"(4.697144,-74.140516)"
2022,Diciembre,Dinamarca,208,0,3,3,"(4.815061,-75.736532)"
2013,Junio,Santa Lucia,662,0,1,1,"(12.586067,-81.702563)"
2015,Marzo,España,724,1,0,1,"(7.128456,-73.183637)"
2021,Marzo,Países Bajos,528,1,2,3,"(4.815061,-75.736532)"
2014,Julio,Taiwán,158,49,68,117,"(4.697144,-74.140516)"
2019,Septiembre,Uganda,800,7,15,22,"(4.697144,-74.140516)"
2020,Julio,Guatemala,320,2,2,4,"(4.697144,-74.140516)"
2021,Febrero,Alemania,276,284,439,723,"(4.697144,-74.140516)"
2012,Agosto,República Checa,203,3,3,6,"(4.697144,-74.140516)"
2017,Marzo,Burkina Faso,854,0,1,1,"(4.697144,-74.140516)"
2014,Octubre,Lituania,440,2,2,4,"(10.445761,-75.516429)"
2022,Octubre,Venezuela,862,0,16,16,"(10.408582,-75.538003)"
2014,Agosto,Perú,604,213,285,498,"(3.541112,-76.384584)"
2015,Agosto,Jamaica,388,2,7,9,"(12.586067,-81.702563)"
2020,Febrero,Malta,470,12,18,30,"(4.697144,-74.140516)"
2022,Junio,Argentina,32,3,3,6,"(10.408582,-75.538003)"
2020,Febrero,Nicaragua,558,7,13,20,"(3.541112,-76.384584)"
2023,Abril,Federación de Rusia,643,0,33,33,"(10.408582,-75.538003)"
2018,Febrero,España,724,0,2,2,"(-4.197703,-69.941278)"
2012,Octubre,Panamá,591,2,5,7,"(8.635765,-77.346578)"
2017,Septiembre,México,484,54,87,141,"(10.886611,-74.776708)"
2018,Noviembre,República Dominicana,214,2,1,3,"(12.586067,-81.702563)"
2013,Mayo,Estonia,233,3,0,3,"(10.445761,-75.516429)"
2022,Julio,Argentina,32,11,10,21,"(7.818934,-72.453226)"
2018,Febrero,Perú,604,832,612,1444,"(10.445761,-75.516429)"
2021,Abril,España,724,2,1,3,"(11.360009,-72.129330)"
2012,Julio,República de Irlanda,372,1,3,4,"(7.818934,-72.453226)"
2021,Octubre,España,724,0,1,1,"(10.971302,-74.765397)"
2013,Marzo,San Cristóbal y Nevis,659,0,1,1,"(4.697144,-74.140516)"
2014,Agosto,México,484,127,186,313,"(10.445761,-75.516429)"
2022,Noviembre,Chile,152,6,8,14,"(4.452882,-75.766298)"
2017,Mayo,Surinam,740,2,0,2,"(10.408582,-75.538003)"
2013,Octubre,Costa Rica,188,1,0,1,"(4.452882,-75.766298)"
2012,Julio,Qatar,634,0,1,1,"(6.171601,-75.427454)"
2022,Abril,Canadá,124,1,0,1,"(8.36068,-72.409396)"
2018,Enero,Taiwán,158,1,3,4,"(0.814836,-77.662532)"
2017,Abril,Portugal,620,0,1,1,"(4.815061,-75.736532)"
2018,Noviembre,Perú,604,0,1,1,"(6.185799,-67.483929)"
2012,Mayo,Países Bajos,528,4,6,10,"(10.886611,-74.776708)"
2012,Mayo,Italia,380,1,5,6,"(8.635765,-77.346578)"
2019,Agosto,Reino Unido de Gran Bretaña e Irlanda del Norte,826,5,9,14,"(-4.223468,-69.945098)"
2018,Diciembre,Paraguay,600,58,29,87,"(10.445761,-75.516429)"
2012,Julio,Japón,392,2,7,9,"(10.886611,-74.776708)"
2022,Marzo,España,724,4,11,15,"(10.408582,-75.538003)"
2017,Junio,Uganda,800,2,0,2,"(4.697144,-74.140516)"
2015,Septiembre,Perú,604,2,3,5,"(4.815061,-75.736532)"
2023,Marzo,Islandia,352,2,2,4,"(10.445761,-75.516429)"
2013,Abril,Nicaragua,558,0,1,1,"(0.814836,-77.662532)"
2019,Marzo,Iraq,368,0,1,1,"(10.445761,-75.516429)"
2017,Octubre,Emiratos Árabes,784,3,23,26,"(4.697144,-74.140516)"
2018,Noviembre,Lituania,440,1,0,1,"(0.814836,-77.662532)"
2022,Mayo,España,724,9,10,19,"(11.360009,-72.129330)"
2019,Septiembre,Ucrania,804,0,8,8,"(10.408582,-75.538003)"
2020,Enero,Francia,250,7,9,16,"(-4.197703,-69.941278)"
2017,Julio,Alemania,276,2,1,3,"(7.128456,-73.183637)"
2023,Febrero,Chile,152,11,13,24,"(11.360009,-72.129330)"
2018,Julio,Islas Vírgenes Británicas/Territorio Británico de Ultramar,92,1,0,1,"(10.886611,-74.776708)"
2018,Agosto,Suecia,752,0,1,1,"(4.452882,-75.766298)"
2015,Abril,Turquía,792,28,99,127,"(4.697144,-74.140516)"
2018,Julio,San  Vicente y las Granadinas,670,0,3,3,"(6.171601,-75.427454)"
2016,Febrero,Eslovaquia,703,2,2,4,"(3.541112,-76.384584)"
2015,Febrero,Jordania,400,2,7,9,"(4.697144,-74.140516)"
2020,Diciembre,El Salvador,222,0,1,1,"(4.452882,-75.766298)"
2019,Junio,Desconocido,99999,7,15,22,"(6.171601,-75.427454)"
2022,Agosto,Argentina,32,72,51,123,"(12.586067,-81.702563)"
2015,Diciembre,Alemania,276,98,185,283,"(6.171601,-75.427454)"
2013,Octubre,Liberia,430,0,1,1,"(4.697144,-74.140516)"
2023,Febrero,India,356,1,0,1,"(-4.197703,-69.941278)"
2016,Junio,Ucrania,804,0,1,1,"(3.893038,-77.067921)"
2018,Julio,Estados Unidos de América,840,4298,7588,11886,"(6.171601,-75.427454)"
2022,Diciembre,Nigeria,566,0,1,1,"(10.886611,-74.776708)"
2019,Enero,Federación de Rusia,643,37,29,66,"(10.445761,-75.516429)"
2012,Enero,Honduras,340,0,1,1,"(4.815061,-75.736532)"
2018,Noviembre,Bulgaria,100,0,1,1,"(0.814836,-77.662532)"
2018,Octubre,Panamá,591,14,6,20,"(11.117806,-74.232622)"
2018,Agosto,Sudáfrica,710,1,3,4,"(10.408582,-75.538003)"
2019,Abril,Portugal,620,1,8,9,"(10.886611,-74.776708)"
2015,Junio,Ecuador,218,0,5,5,"(0.812436,-77.847006)"
2017,Octubre,República de Corea,410,0,4,4,"(10.886611,-74.776708)"
2016,Junio,Guyana,328,1,2,3,"(6.171601,-75.427454)"
2019,Marzo,República de Irlanda,372,7,4,11,"(10.408582,-75.538003)"
2015,Julio,Uruguay,858,27,48,75,"(6.171601,-75.427454)"
2014,Marzo,Grecia,300,13,63,76,"(4.697144,-74.140516)"
2014,Noviembre,Reino Unido de Gran Bretaña e Irlanda del Norte,826,4,2,6,"(12.586067,-81.702563)"
2022,Enero,Jamaica,388,4,6,10,"(10.445761,-75.516429)"
2018,Abril,Islandia,352,0,3,3,"(10.445761,-75.516429)"
2013,Octubre,Francia,250,8,15,23,"(7.818934,-72.453226)"
2012,Mayo,Reino Unido de Gran Bretaña e Irlanda del Norte,826,4,6,10,"(11.360009,-72.129330)"
2017,Octubre,Trinidad y Tobago,780,1,1,2,"(7.818934,-72.453226)"
2022,Diciembre,Venezuela,862,0,1,1,"(12.165168,-71.983761)"
2017,Agosto,Guyana,328,1,2,3,"(6.171601,-75.427454)"
2015,Julio,Ecuador,218,3,0,3,"(3.866713,-67.927521)"
2012,Febrero,México,484,3,16,19,"(4.815061,-75.736532)"
2022,Octubre,Turquía,792,1,2,3,"(3.541112,-76.384584)"
2012,Diciembre,Brasil,76,1,7,8,"(7.128456,-73.183637)"
2022,Diciembre,Islas Caimán/Territorio Británico de Ultramar,136,1,0,1,"(10.886611,-74.776708)"
2019,Febrero,Eslovenia,705,1,3,4,"(10.445761,-75.516429)"
2020,Marzo,Austria,40,1,3,4,"(7.818934,-72.453226)"
2020,Abril,Pakistán,586,0,1,1,"(4.697144,-74.140516)"
2022,Diciembre,Perú,604,0,1,1,"(6.17134,-75.427194)"
2018,Noviembre,Bermudas/Territorio Británico de Ultramar,60,2,1,3,"(10.445761,-75.516429)"
2018,Agosto,México,484,1,6,7,"(8.36068,-72.409396)"
2023,Enero,Vietnam,704,1,1,2,"(6.171601,-75.427454)"
2017,Agosto,Panamá,591,10,13,23,"(7.128456,-73.183637)"
2022,Septiembre,Suecia,752,1,0,1,"(8.36068,-72.409396)"
2017,Febrero,Canadá,124,173,355,528,"(6.171601,-75.427454)"
2023,Marzo,Noruega,578,28,27,55,"(10.445761,-75.516429)"
2017,Junio,Sri Lanka,144,0,1,1,"(6.171601,-75.427454)"
2015,Enero,Cuba,192,3,13,16,"(7.927209,-72.507910)"
2020,Marzo,Canadá,124,3,3,6,"(8.635765,-77.346578)"
2017,Mayo,Estados Unidos de América,840,9,10,19,"(13.3387613,-81.372937)"
2012,Febrero,Filipinas,608,1,5,6,"(10.445761,-75.516429)"
2014,Febrero,Suecia,752,15,13,28,"(10.408582,-75.538003)"
2014,Enero,Panamá,591,15,47,62,"(4.815061,-75.736532)"
2022,Septiembre,Venezuela,862,291,260,551,"(10.445761,-75.516429)"
2014,Febrero,Ecuador,218,0,1,1,"(12.5744111,-81.703935)"
2014,Mayo,Georgia,268,1,0,1,"(10.445761,-75.516429)"
2014,Enero,Ecuador,218,8,8,16,"(12.586067,-81.702563)"
2023,Enero,Israel,376,5,0,5,"(11.117806,-74.232622)"
2023,Enero,Malawi,454,1,1,2,"(4.697144,-74.140516)"
2013,Noviembre,Ghana,288,1,0,1,"(10.445761,-75.516429)"
2012,Diciembre,España,724,3,14,17,"(10.886611,-74.776708)"
2012,Mayo,Eslovenia,705,0,1,1,"(11.360009,-72.129330)"
2019,Septiembre,España,724,0,1,1,"(12.5744111,-81.703935)"
2018,Mayo,Suiza,756,0,1,1,"(4.815061,-75.736532)"
2017,Enero,China,156,11,9,20,"(3.541112,-76.384584)"
2012,Marzo,Francia,250,1,1,2,"(0.25129,-76.875963)"
2020,Enero,Federación de Rusia,643,0,4,4,"(9.402978,-75.681599)"
2017,Julio,Andorra,20,0,9,9,"(4.697144,-74.140516)"
2015,Marzo,España,724,1,3,4,"(13.3387613,-81.372937)"
2017,Febrero,Reino Unido de Gran Bretaña e Irlanda del Norte,826,1,1,2,"(7.128456,-73.183637)"
2023,Mayo,Ecuador,218,7,6,13,"(8.36068,-72.409396)"
2017,Marzo,Ecuador,218,0,1,1,"(7.102626,-77.762647)"
2017,Junio,Ucrania,804,1,2,3,"(0.814836,-77.662532)"
2023,Abril,República de Yibuti,262,1,0,1,"(4.697144,-74.140516)"
2014,Agosto,Israel,376,8,63,71,"(6.171601,-75.427454)"
2022,Octubre,Rumania,642,0,2,2,"(10.886611,-74.776708)"
2012,Octubre,Benín,204,1,0,1,"(4.697144,-74.140516)"
2014,Abril,Uruguay,858,90,78,168,"(10.445761,-75.516429)"
2017,Abril,Francia,250,8,7,15,"(-4.197703,-69.941278)"
2022,Enero,Santa Lucia,662,2,0,2,"(4.697144,-74.140516)"
2012,Septiembre,Ecuador,218,2,25,27,"(10.408582,-75.538003)"
2021,Noviembre,Egipto,818,0,3,3,"(6.171601,-75.427454)"
2022,Marzo,Taiwán,158,0,1,1,"(7.916725,-72.462544)"
2015,Febrero,Venezuela,862,6,13,19,"(7.128456,-73.183637)"
2023,Mayo,Nicaragua,558,7,3,10,"(10.886611,-74.776708)"
2013,Marzo,Croacia,191,0,1,1,"(10.445761,-75.516429)"
2019,Mayo,Albania,8,7,7,14,"(4.697144,-74.140516)"
2012,Enero,Austria,40,4,4,8,"(10.408582,-75.538003)"
2012,Marzo,Singapur,702,10,17,27,"(4.697144,-74.140516)"
2012,Mayo,Cabo Verde,132,0,1,1,"(4.697144,-74.140516)"
2021,Mayo,Lituania,440,3,0,3,"(6.171601,-75.427454)"
2016,Enero,Reino Unido de Gran Bretaña e Irlanda del Norte,826,67,175,242,"(6.171601,-75.427454)"
2014,Enero,Argentina,32,1,1,2,"(4.815061,-75.736532)"
2022,Junio,Japón,392,4,1,5,"(10.445761,-75.516429)"
2016,Mayo,Belice,84,1,0,1,"(3.541112,-76.384584)"
2019,Enero,Francia,250,119,175,294,"(3.541112,-76.384584)"
2016,Septiembre,Federación de Rusia,643,9,7,16,"(0.814836,-77.662532)"
2022,Marzo,San  Vicente y las Granadinas,670,0,1,1,"(7.818934,-72.453226)"
2019,Abril,España,724,5,6,11,"(8.36068,-72.409396)"
2023,Junio,Francia,250,6,10,16,"(11.247723,-74.213989)"
2012,Abril,Ecuador,218,2,11,13,"(10.408582,-75.538003)"
2018,Abril,Honduras,340,0,3,3,"(12.586067,-81.702563)"
2017,Octubre,Macedonia,807,0,9,9,"(4.697144,-74.140516)"
2016,Octubre,Venezuela,862,0,1,1,"(7.102626,-77.762647)"
2023,Enero,Perú,604,32,38,70,"(8.364293,-72.405710)"
2023,Abril,Japón,392,5,7,12,"(3.541112,-76.384584)"
2016,Abril,Portugal,620,2,3,5,"(0.814836,-77.662532)"
2018,Noviembre,Malasia,458,2,0,2,"(10.445761,-75.516429)"
2019,Noviembre,Alemania,276,14,20,34,"(-4.223468,-69.945098)"
2016,Febrero,República de Corea,410,7,9,16,"(10.445761,-75.516429)"
2017,Diciembre,Suiza,756,4,10,14,"(11.247723,-74.213989)"
2022,Diciembre,Rumania,642,1,1,2,"(4.815061,-75.736532)"
2019,Abril,México,484,99,198,297,"(3.541112,-76.384584)"
2019,Junio,Guyana,328,10,8,18,"(4.697144,-74.140516)"
2019,Marzo,Suiza,756,3,11,14,"(10.886611,-74.776708)"
2019,Febrero,Japón,392,0,7,7,"(10.886611,-74.776708)"
2012,Noviembre,República de Corea,410,144,522,666,"(4.697144,-74.140516)"
2017,Julio,Cuba,192,0,1,1,"(1.813928,-78.763924)"
2019,Julio,Francia,250,0,7,7,"(11.360009,-72.129330)"
2012,Junio,Luxemburgo,442,0,1,1,"(6.171601,-75.427454)"
2014,Abril,Desconocido,99999,1,0,1,"(0.25129,-76.875963)"
2021,Noviembre,Islandia,352,1,5,6,"(4.697144,-74.140516)"
2019,Abril,Nigeria,566,8,18,26,"(4.697144,-74.140516)"
2023,Enero,Francia,250,1,2,3,"(7.927209,-72.507910)"
2019,Octubre,Estados Unidos de América,840,494,836,1330,"(10.886611,-74.776708)"
2012,Marzo,Países Bajos,528,0,1,1,"(12.586067,-81.702563)"
2019,Marzo,Hungría,348,46,64,110,"(4.697144,-74.140516)"
2023,Abril,República Checa,203,2,2,4,"(7.128456,-73.183637)"
2019,Febrero,Israel,376,28,91,119,"(6.171601,-75.427454)"
2019,Abril,Francia,250,3,4,7,"(7.128456,-73.183637)"
2023,Abril,Estados Unidos de América,840,172,268,440,"(4.452882,-75.766298)"
2013,Diciembre,Benín,204,0,1,1,"(4.697144,-74.140516)"
2018,Abril,Austria,40,2,0,2,"(-4.223468,-69.945098)"
2019,Agosto,República de Belarús,112,1,0,1,"(3.541112,-76.384584)"
2013,Junio,Noruega,578,5,7,12,"(10.445761,-75.516429)"
2015,Mayo,Reino Unido de Gran Bretaña e Irlanda del Norte,826,681,1691,2372,"(4.697144,-74.140516)"
2012,Junio,Libia,434,0,1,1,"(0.814836,-77.662532)"
2018,Diciembre,Cuba,192,0,4,4,"(10.408582,-75.538003)"
2016,Julio,Australia,36,18,17,35,"(8.635765,-77.346578)"
2015,Febrero,Panamá,591,0,1,1,"(8.635765,-77.346578)"
2021,Agosto,Chile,152,0,1,1,"(4.452882,-75.766298)"
2012,Agosto,Croacia,191,1,0,1,"(6.171601,-75.427454)"
2018,Diciembre,Dinamarca,208,1,1,2,"(8.635765,-77.346578)"
2022,Julio,Egipto,818,0,2,2,"(10.408582,-75.538003)"
2019,Agosto,Venezuela,862,5,0,5,"(6.17134,-75.427194)"
2015,Septiembre,Federación de Rusia,643,0,2,2,"(11.247723,-74.213989)"
2021,Marzo,Eslovenia,705,0,1,1,"(3.541112,-76.384584)"
2015,Marzo,Andorra,20,2,15,17,"(4.697144,-74.140516)"
2023,Abril,Bolivia,68,24,17,41,"(3.541112,-76.384584)"
2014,Marzo,República de Irlanda,372,1,2,3,"(-4.197703,-69.941278)"
2019,Abril,Italia,380,893,1768,2661,"(4.697144,-74.140516)"
2013,Febrero,Bolivia,68,25,13,38,"(10.408582,-75.538003)"
2014,Agosto,Japón,392,166,484,650,"(4.697144,-74.140516)"
2018,Septiembre,Australia,36,37,101,138,"(6.171601,-75.427454)"
2014,Septiembre,Egipto,818,4,26,30,"(4.697144,-74.140516)"
2018,Noviembre,Tonga,776,1,0,1,"(4.697144,-74.140516)"
2018,Noviembre,Polonia,616,1,2,3,"(10.886611,-74.776708)"
2018,Enero,Bangladesh,50,0,1,1,"(4.452882,-75.766298)"
2014,Junio,Brasil,76,57,160,217,"(6.171601,-75.427454)"
2023,Enero,Brasil,76,0,1,1,"(3.866713,-67.927521)"
2014,Julio,Jamaica,388,4,5,9,"(6.171601,-75.427454)"
2023,Junio,Sierra Leona,694,1,0,1,"(4.697144,-74.140516)"
2018,Agosto,Venezuela,862,38931,35927,74871,"(7.818934,-72.453226)"
2015,Septiembre,India,356,0,4,4,"(10.971302,-74.765397)"
2018,Julio,Sri Lanka,144,0,1,1,"(3.541112,-76.384584)"
2012,Diciembre,Argentina,32,61,45,106,"(10.408582,-75.538003)"
2022,Febrero,España,724,0,1,1,"(11.117806,-74.232622)"
2018,Abril,Panamá,591,0,2,2,"(0.814836,-77.662532)"
2019,Septiembre,Uganda,800,3,0,3,"(6.171601,-75.427454)"
2019,Marzo,Estados Unidos de América,840,15,17,32,"(11.360009,-72.129330)"
2020,Marzo,Italia,380,2,0,2,"(8.635765,-77.346578)"
2012,Junio,Hungría,348,15,22,37,"(4.697144,-74.140516)"
2012,Octubre,Pakistán,586,0,1,1,"(10.445761,-75.516429)"
2016,Junio,Venezuela,862,174,251,425,"(0.814836,-77.662532)"
2022,Julio,Suiza,756,5,4,9,"(11.117806,-74.232622)"
2015,Diciembre,China,156,3,5,8,"(3.541112,-76.384584)"
2013,Agosto,Países Bajos,528,19,36,55,"(10.445761,-75.516429)"
2022,Junio,México,484,601,823,1424,"(10.445761,-75.516429)"
2017,Noviembre,Ecuador,218,2628,3305,5933,"(0.814836,-77.662532)"
2018,Octubre,Francia,250,2,4,6,"(-4.223468,-69.945098)"
2018,Enero,Alemania,276,1,2,3,"(3.893038,-77.067921)"
2017,Febrero,Belice,84,10,7,17,"(4.697144,-74.140516)"
2019,Septiembre,Etiopia,231,2,1,3,"(6.171601,-75.427454)"
2018,Diciembre,Costa Rica,188,0,5,5,"(11.117806,-74.232622)"
2017,Julio,Singapur,702,3,3,6,"(10.445761,-75.516429)"
2022,Julio,Kazajistán,398,15,14,29,"(4.697144,-74.140516)"
2015,Noviembre,Uzbekistán,860,1,0,1,"(4.697144,-74.140516)"
2013,Diciembre,Canadá,124,3,7,10,"(7.927209,-72.507910)"
2017,Mayo,Australia,36,1,2,3,"(1.813928,-78.763924)"
2023,Junio,Polonia,616,11,24,35,"(10.445761,-75.516429)"
2014,Abril,Gabón,266,0,1,1,"(4.697144,-74.140516)"
2015,Octubre,Bolivia,68,493,667,1160,"(4.697144,-74.140516)"
2016,Agosto,Dinamarca,208,0,5,5,"(10.408582,-75.538003)"
2016,Abril,Malasia,458,11,12,23,"(4.697144,-74.140516)"
2014,Agosto,Bélgica,56,2,5,7,"(7.818934,-72.453226)"
2018,Noviembre,Bermudas/Territorio Británico de Ultramar,60,0,1,1,"(3.541112,-76.384584)"
2017,Agosto,Italia,380,119,301,420,"(6.171601,-75.427454)"
2020,Febrero,Gabón,266,0,1,1,"(4.697144,-74.140516)"
2017,Septiembre,Federación de Rusia,643,134,150,284,"(4.697144,-74.140516)"
2023,Mayo,Indonesia,360,0,3,3,"(-4.197703,-69.941278)"
2017,Julio,España,724,1,4,5,"(11.360009,-72.129330)"
2018,Septiembre,Lituania,440,1,0,1,"(12.586067,-81.702563)"
2013,Octubre,Bolivia,68,0,1,1,"(10.408582,-75.538003)"
2022,Enero,Panamá,591,1,6,7,"(8.635765,-77.346578)"
2016,Mayo,República de Irlanda,372,3,3,6,"(-4.197703,-69.941278)"
2022,Septiembre,Bermudas/Territorio Británico de Ultramar,60,0,1,1,"(4.815061,-75.736532)"
2015,Julio,Dinamarca,208,13,8,21,"(10.445761,-75.516429)"
2021,Diciembre,Costa Rica,188,3,7,10,"(7.927209,-72.507910)"
2020,Julio,Estados Unidos de América,840,2,3,5,"(6.171601,-75.427454)"
2018,Enero,Ecuador,218,145,314,459,"(7.818934,-72.453226)"
2018,Enero,Venezuela,862,405,571,976,"(7.088729,-70.740253)"
2015,Julio,Indonesia,360,20,28,48,"(4.697144,-74.140516)"
2017,Abril,Bahamas,44,4,5,9,"(6.171601,-75.427454)"
2023,Enero,Austria,40,23,23,46,"(10.445761,-75.516429)"
2018,Noviembre,Letonia,428,0,3,3,"(9.402978,-75.681599)"
2019,Noviembre,Austria,40,1,2,3,"(-4.223468,-69.945098)"
2019,Agosto,Ecuador,218,3658,4059,7717,"(0.814836,-77.662532)"
2014,Mayo,Francia,250,2,1,3,"(12.5744111,-81.703935)"
2019,Abril,Taiwán,158,2,5,7,"(10.886611,-74.776708)"
2012,Abril,Austria,40,1,1,2,"(11.360009,-72.129330)"
2019,Julio,Mauricio,480,0,2,2,"(6.171601,-75.427454)"
2018,Abril,Guatemala,320,1,3,4,"(10.408582,-75.538003)"
2022,Marzo,Guyana,328,2,0,2,"(7.818934,-72.453226)"
2019,Diciembre,Canadá,124,31,63,94,"(10.886611,-74.776708)"
2017,Mayo,Mauricio,480,0,1,1,"(10.408582,-75.538003)"
2013,Abril,Andorra,20,0,1,1,"(6.171601,-75.427454)"
2019,Mayo,Países Bajos,528,12,14,26,"(10.886611,-74.776708)"
2018,Mayo,Sri Lanka,144,0,1,1,"(10.886611,-74.776708)"
2013,Noviembre,Cuba,192,0,1,1,"(10.408582,-75.538003)"
2019,Febrero,Guatemala,320,48,127,175,"(6.171601,-75.427454)"
2013,Julio,México,484,2,0,2,"(6.185799,-67.483929)"
2013,Septiembre,Japón,392,1,1,2,"(12.586067,-81.702563)"
2021,Febrero,Surinam,740,0,1,1,"(6.171601,-75.427454)"
2016,Diciembre,Países Bajos,528,14,15,29,"(10.408582,-75.538003)"
2022,Junio,Costa Rica,188,0,2,2,"(10.408582,-75.538003)"
2014,Mayo,Venezuela,862,8,24,32,"(4.815061,-75.736532)"
2014,Enero,Costa Rica,188,100,191,291,"(6.171601,-75.427454)"
2012,Mayo,Alemania,276,13,24,37,"(10.445761,-75.516429)"
2017,Diciembre,Uruguay,858,29,15,44,"(12.586067,-81.702563)"
2013,Abril,Israel,376,1,1,2,"(8.635765,-77.346578)"
2012,Agosto,Suecia,752,0,2,2,"(7.818934,-72.453226)"
2018,Julio,Indonesia,360,0,1,1,"(10.971302,-74.765397)"
2019,Marzo,Lituania,440,2,2,4,"(6.171601,-75.427454)"
2023,Mayo,Islas Marshall,584,0,1,1,"(6.171601,-75.427454)"
2014,Diciembre,Costa Rica,188,3,8,11,"(7.128456,-73.183637)"
2016,Marzo,Honduras,340,1,1,2,"(12.586067,-81.702563)"
2012,Mayo,Bolivia,68,5,6,11,"(3.541112,-76.384584)"
2014,Mayo,Sri Lanka,144,0,1,1,"(11.247723,-74.213989)"
2022,Octubre,Paraguay,600,3,4,7,"(3.541112,-76.384584)"
2018,Junio,Noruega,578,1,1,2,"(10.408582,-75.538003)"
2017,Agosto,Portugal,620,1,4,5,"(8.635765,-77.346578)"
2020,Diciembre,República de Belarús,112,2,1,3,"(4.697144,-74.140516)"
2016,Diciembre,Canadá,124,263,448,711,"(6.171601,-75.427454)"
2022,Noviembre,República de Moldavia,498,9,13,22,"(4.697144,-74.140516)"
2018,Febrero,Honduras,340,0,1,1,"(0.814836,-77.662532)"
2019,Septiembre,Taiwán,158,68,67,135,"(4.697144,-74.140516)"
2015,Noviembre,Honduras,340,21,23,44,"(10.445761,-75.516429)"
2022,Septiembre,Turquía,792,0,2,2,"(11.247723,-74.213989)"
2019,Enero,Portugal,620,320,573,893,"(4.697144,-74.140516)"
2017,Enero,Ecuador,218,3,1,4,"(0.812436,-77.847006)"
2016,Noviembre,Barbados,52,0,4,4,"(10.445761,-75.516429)"
2017,Agosto,Trinidad y Tobago,780,0,1,1,"(10.408582,-75.538003)"
2021,Junio,Haití,332,1,1,2,"(6.171601,-75.427454)"
2022,Agosto,Andorra,20,0,1,1,"(4.815061,-75.736532)"
2021,Agosto,Haití,332,9,12,21,"(4.697144,-74.140516)"
2019,Octubre,México,484,0,2,2,"(7.088729,-70.740253)"
2017,Julio,Panamá,591,1413,1579,2992,"(4.697144,-74.140516)"
2012,Enero,Lituania,440,0,1,1,"(3.541112,-76.384584)"
2012,Agosto,Chile,152,5,27,32,"(10.886611,-74.776708)"
2012,Diciembre,Brasil,76,83,68,151,"(-4.197703,-69.941278)"
2013,Septiembre,El Salvador,222,0,2,2,"(7.128456,-73.183637)"
2019,Julio,Etiopia,231,8,52,60,"(4.697144,-74.140516)"
2022,Abril,Venezuela,862,12,15,27,"(-4.197703,-69.941278)"
2015,Julio,Alemania,276,118,181,299,"(6.171601,-75.427454)"
2019,Diciembre,República Dominicana,214,0,2,2,"(11.528919,-72.919681)"
2012,Octubre,República de Irlanda,372,0,1,1,"(10.886611,-74.776708)"
2014,Junio,Israel,376,1,4,5,"(-4.197703,-69.941278)"
2022,Noviembre,Suecia,752,2,0,2,"(11.117806,-74.232622)"
2022,Agosto,Polonia,616,3,1,4,"(10.886611,-74.776708)"
2019,Junio,San Cristóbal y Nevis,659,0,2,2,"(12.586067,-81.702563)"
2019,Marzo,Alemania,276,0,4,4,"(9.402978,-75.681599)"
2019,Abril,Eslovenia,705,15,48,63,"(4.697144,-74.140516)"
2014,Agosto,Uruguay,858,0,1,1,"(8.635765,-77.346578)"
2016,Agosto,Bolivia,68,43,55,98,"(6.171601,-75.427454)"
2013,Febrero,Rumania,642,0,1,1,"(10.886611,-74.776708)"
2017,Noviembre,España,724,4,4,8,"(-4.197703,-69.941278)"
2016,Abril,Suiza,756,2,10,12,"(10.886611,-74.776708)"
2018,Agosto,Costa Rica,188,24,21,45,"(12.586067,-81.702563)"
2016,Octubre,Singapur,702,4,4,8,"(10.445761,-75.516429)"
2013,Julio,Austria,40,198,271,469,"(4.697144,-74.140516)"
2020,Agosto,México,484,0,2,2,"(6.171601,-75.427454)"
2017,Marzo,Dinamarca,208,2,0,2,"(0.25129,-76.875963)"
2022,Junio,República Checa,203,1,3,4,"(8.635765,-77.346578)"
2013,Enero,Japón,392,0,3,3,"(10.886611,-74.776708)"
2015,Mayo,Polonia,616,120,156,276,"(4.697144,-74.140516)"
2013,Abril,Grecia,300,1,3,4,"(7.818934,-72.453226)"
2020,Enero,Sudáfrica,710,1,5,6,"(10.408582,-75.538003)"
2019,Agosto,Italia,380,30,40,70,"(7.818934,-72.453226)"
2016,Octubre,Cuba,192,28,32,60,"(3.541112,-76.384584)"
2018,Noviembre,Haití,332,0,1,1,"(10.886611,-74.776708)"
2016,Agosto,Portugal,620,0,1,1,"(8.635765,-77.346578)"
2016,Julio,Singapur,702,0,6,6,"(3.541112,-76.384584)"
2022,Noviembre,Omán,512,2,0,2,"(4.697144,-74.140516)"
2016,Septiembre,Italia,380,29,144,173,"(3.541112,-76.384584)"
2022,Enero,Taiwán,158,1,0,1,"(12.586067,-81.702563)"
2017,Octubre,Noruega,578,0,1,1,"(0.25129,-76.875963)"
2015,Octubre,Austria,40,0,1,1,"(7.927209,-72.507910)"
2013,Agosto,Japón,392,136,461,597,"(4.697144,-74.140516)"
2013,Marzo,Argentina,32,1,5,6,"(7.088729,-70.740253)"
2015,Marzo,Suecia,752,3,1,4,"(-4.223468,-69.945098)"
2022,Diciembre,Andorra,20,0,1,1,"(4.815061,-75.736532)"
2013,Agosto,Costa Rica,188,1,0,1,"(10.408582,-75.538003)"
2020,Marzo,Países Bajos,528,10,17,27,"(0.814836,-77.662532)"
2018,Noviembre,Letonia,428,2,5,7,"(10.445761,-75.516429)"
2017,Octubre,México,484,7,3,10,"(-4.197703,-69.941278)"
2014,Noviembre,Reino Unido de Gran Bretaña e Irlanda del Norte,826,10,18,28,"(-4.197703,-69.941278)"
2022,Septiembre,Federación de Rusia,643,2,13,15,"(10.408582,-75.538003)"
2017,Septiembre,Turquía,792,0,1,1,"(4.815061,-75.736532)"
2019,Noviembre,Dinamarca,208,1,2,3,"(0.814836,-77.662532)"
2020,Diciembre,Brasil,76,6,10,16,"(10.886611,-74.776708)"
2021,Abril,Bulgaria,100,0,2,2,"(3.893038,-77.067921)"
2012,Agosto,Venezuela,862,0,1,1,"(-4.197703,-69.941278)"
2015,Marzo,Dinamarca,208,3,2,5,"(3.541112,-76.384584)"
2013,Abril,Bélgica,56,3,2,5,"(7.818934,-72.453226)"
2022,Mayo,Suiza,756,36,58,94,"(10.445761,-75.516429)"
2022,Agosto,México,484,47,105,152,"(10.886611,-74.776708)"
2015,Agosto,Eslovaquia,703,1,1,2,"(6.171601,-75.427454)"
2019,Abril,Bahamas,44,6,3,9,"(10.445761,-75.516429)"
2019,Diciembre,Honduras,340,92,93,185,"(10.445761,-75.516429)"
2022,Diciembre,República Checa,203,12,21,33,"(6.171601,-75.427454)"
2022,Marzo,Dinamarca,208,0,5,5,"(3.893038,-77.067921)"
2017,Noviembre,Estados Unidos de América,840,4,7,11,"(-4.223468,-69.945098)"
2018,Noviembre,Croacia,191,0,1,1,"(11.247723,-74.213989)"
2018,Junio,República Árabe de Yemen,887,0,3,3,"(4.697144,-74.140516)"
2023,Marzo,Suiza,756,3,2,5,"(11.117806,-74.232622)"
2015,Noviembre,China,156,0,2,2,"(7.818934,-72.453226)"
2014,Agosto,Croacia,191,1,2,3,"(0.814836,-77.662532)"
2013,Septiembre,India,356,0,1,1,"(11.360009,-72.129330)"
2014,Octubre,República Dominicana,214,0,8,8,"(7.927209,-72.507910)"
2015,Diciembre,Países Bajos,528,0,3,3,"(10.971302,-74.765397)"
2015,Diciembre,Filipinas,608,0,7,7,"(9.402978,-75.681599)"
2016,Noviembre,México,484,25,38,63,"(0.814836,-77.662532)"
2022,Diciembre,Indonesia,360,1,6,7,"(10.445761,-75.516429)"
2015,Octubre,Australia,36,1,1,2,"(4.815061,-75.736532)"
2017,Abril,Ecuador,218,0,2,2,"(8.635765,-77.346578)"
2020,Febrero,Grecia,300,74,140,214,"(4.697144,-74.140516)"
2022,Julio,Jamaica,388,8,13,21,"(10.445761,-75.516429)"
2022,Marzo,Ecuador,218,1,2,3,"(-4.197703,-69.941278)"
2013,Abril,Reino Unido de Gran Bretaña e Irlanda del Norte,826,4,22,26,"(3.541112,-76.384584)"
2012,Diciembre,Finlandia,246,3,7,10,"(10.445761,-75.516429)"
2012,Septiembre,Nueva Zelanda,554,0,1,1,"(10.886611,-74.776708)"
2015,Febrero,Filipinas,608,1,2,3,"(6.171601,-75.427454)"
2013,Noviembre,Brasil,76,3,4,7,"(7.927209,-72.507910)"
2023,Abril,Noruega,578,0,1,1,"(10.886611,-74.776708)"
2014,Mayo,Nicaragua,558,0,11,11,"(10.408582,-75.538003)"
2013,Diciembre,Federación de Rusia,643,9,4,13,"(3.541112,-76.384584)"
2016,Julio,Francia,250,32,36,68,"(-4.197703,-69.941278)"
2016,Julio,Camerún,120,0,1,1,"(10.445761,-75.516429)"
2022,Enero,Kazajistán,398,0,1,1,"(10.445761,-75.516429)"
2017,Febrero,República Checa,203,70,135,205,"(4.697144,-74.140516)"
2020,Enero,Francia,250,2,7,9,"(7.818934,-72.453226)"
2018,Julio,Italia,380,1,1,2,"(13.3387613,-81.372937)"
2013,Octubre,Alemania,276,34,93,127,"(6.171601,-75.427454)"
2021,Enero,Vietnam,704,1,0,1,"(3.541112,-76.384584)"
2019,Julio,Rumania,642,10,7,17,"(6.171601,-75.427454)"
2016,Marzo,Kazajistán,398,0,1,1,"(10.445761,-75.516429)"
2016,Enero,Sudáfrica,710,1,0,1,"(3.541112,-76.384584)"
2019,Junio,Brasil,76,0,12,12,"(7.927209,-72.507910)"
2022,Octubre,Zimbabue,716,0,1,1,"(10.445761,-75.516429)"
2019,Julio,Irán,364,0,4,4,"(6.171601,-75.427454)"
2021,Octubre,Venezuela,862,134,110,244,"(10.445761,-75.516429)"
2017,Enero,Canadá,124,63,85,148,"(3.541112,-76.384584)"
2022,Abril,Rumania,642,1,0,1,"(4.815061,-75.736532)"
2018,Abril,Filipinas,608,3,42,45,"(10.408582,-75.538003)"
2014,Febrero,Puerto Rico/Territorio de Estados Unidos,630,0,1,1,"(3.541112,-76.384584)"
2018,Agosto,Italia,380,21,35,56,"(10.886611,-74.776708)"
2019,Diciembre,Santa Lucia,662,1,0,1,"(6.171601,-75.427454)"
2018,Mayo,Guatemala,320,75,179,254,"(6.171601,-75.427454)"
2016,Mayo,Eslovaquia,703,13,31,44,"(4.697144,-74.140516)"
2013,Marzo,Jamaica,388,0,3,3,"(10.886611,-74.776708)"
2013,Junio,Líbano,422,5,5,10,"(11.360009,-72.129330)"
2022,Enero,Italia,380,1,5,6,"(4.452882,-75.766298)"
2015,Octubre,Myanmar,104,0,1,1,"(4.697144,-74.140516)"
2018,Marzo,Estonia,233,1,0,1,"(0.25129,-76.875963)"
2019,Marzo,Bélgica,56,6,19,25,"(3.541112,-76.384584)"
2022,Marzo,Suecia,752,0,2,2,"(11.247723,-74.213989)"
2015,Febrero,Reino Unido de Gran Bretaña e Irlanda del Norte,826,43,63,106,"(0.814836,-77.662532)"
2018,Noviembre,Ghana,288,1,1,2,"(6.171601,-75.427454)"
2016,Marzo,Cuba,192,1,2,3,"(4.815061,-75.736532)"
2015,Diciembre,Egipto,818,0,3,3,"(10.445761,-75.516429)"
2023,Febrero,República de Irlanda,372,1,1,2,"(7.128456,-73.183637)"
2022,Noviembre,Bahréin,48,2,2,4,"(6.171601,-75.427454)"
2013,Septiembre,Letonia,428,6,5,11,"(4.697144,-74.140516)"
2018,Marzo,México,484,0,1,1,"(-4.223468,-69.945098)"
2020,Febrero,Estonia,233,1,2,3,"(7.818934,-72.453226)"
2022,Septiembre,San Cristóbal y Nevis,659,0,1,1,"(6.171601,-75.427454)"
2023,Marzo,Grecia,300,0,1,1,"(4.815061,-75.736532)"
2015,Octubre,Ucrania,804,29,19,48,"(4.697144,-74.140516)"
2016,Diciembre,Emiratos Árabes,784,0,12,12,"(4.697144,-74.140516)"
2022,Agosto,Reino Unido de Gran Bretaña e Irlanda del Norte,826,0,3,3,"(7.818934,-72.453226)"
2013,Abril,República Dominicana,214,1,1,2,"(12.586067,-81.702563)"
2019,Agosto,Desconocido,99999,3,0,3,"(7.818934,-72.453226)"
2016,Septiembre,Estados Unidos de América,840,10,37,47,"(7.128456,-73.183637)"
2012,Enero,Estados Unidos de América,840,504,931,1435,"(3.541112,-76.384584)"
2012,Noviembre,Austria,40,1,0,1,"(7.818934,-72.453226)"
2017,Febrero,Federación de Rusia,643,1,1,2,"(-4.197703,-69.941278)"
2019,Febrero,Nicaragua,558,1,0,1,"(12.586067,-81.702563)"
2018,Junio,España,724,3,6,9,"(-4.223468,-69.945098)"
2014,Diciembre,Bahréin,48,0,2,2,"(4.697144,-74.140516)"
2023,Junio,Kuwait,414,2,2,4,"(4.697144,-74.140516)"
2014,Junio,Barbados,52,0,1,1,"(10.445761,-75.516429)"
2018,Julio,Hungría,348,22,41,63,"(4.697144,-74.140516)"
2021,Junio,República de Irlanda,372,2,1,3,"(3.541112,-76.384584)"
2012,Julio,Ecuador,218,2,11,13,"(7.128456,-73.183637)"
2015,Marzo,Bélgica,56,6,11,17,"(10.408582,-75.538003)"
2017,Marzo,Honduras,340,38,23,61,"(3.541112,-76.384584)"
2021,Septiembre,Zimbabue,716,0,2,2,"(4.697144,-74.140516)"
2014,Diciembre,Estados Unidos de América,840,5,17,22,"(11.247723,-74.213989)"
2022,Febrero,Austria,40,12,22,34,"(6.171601,-75.427454)"
2017,Noviembre,San Cristóbal y Nevis,659,0,1,1,"(6.171601,-75.427454)"
2022,Noviembre,Bahréin,48,2,1,3,"(4.697144,-74.140516)"
2012,Abril,Eslovaquia,703,16,27,43,"(4.697144,-74.140516)"
2013,Agosto,Francia,250,37,75,112,"(0.814836,-77.662532)"
2015,Diciembre,Turquía,792,4,14,18,"(6.171601,-75.427454)"
2020,Febrero,República Dominicana,214,0,1,1,"(-4.223468,-69.945098)"
2022,Julio,Grecia,300,1,4,5,"(6.171601,-75.427454)"
2017,Noviembre,Perú,604,0,1,1,"(6.228046,-77.404104)"
2015,Noviembre,Alemania,276,2,4,6,"(12.586067,-81.702563)"
2019,Octubre,Seychelles,690,0,1,1,"(4.697144,-74.140516)"
2015,Marzo,Nueva Zelanda,554,2,0,2,"(8.635765,-77.346578)"
2018,Abril,Alemania,276,1,0,1,"(7.102626,-77.762647)"
2012,Diciembre,Uruguay,858,1,2,3,"(11.360009,-72.129330)"
2021,Julio,Canadá,124,0,1,1,"(7.818934,-72.453226)"
2016,Febrero,Suiza,756,473,693,1166,"(4.697144,-74.140516)"
2014,Agosto,Brasil,76,10,23,33,"(10.886611,-74.776708)"
2023,Abril,El Salvador,222,977,1011,1988,"(4.697144,-74.140516)"
2018,Mayo,China,156,5,5,10,"(0.814836,-77.662532)"
2013,Diciembre,Paraguay,600,1,0,1,"(10.408582,-75.538003)"
2013,Marzo,Nueva Zelanda,554,1,1,2,"(4.697144,-74.140516)"
2012,Diciembre,Barbados,52,2,4,6,"(6.171601,-75.427454)"
2016,Enero,Suecia,752,11,15,26,"(10.408582,-75.538003)"
2019,Julio,Georgia,268,0,2,2,"(9.402978,-75.681599)"
2020,Febrero,Austria,40,24,30,54,"(10.445761,-75.516429)"
2012,Octubre,Suecia,752,1,6,7,"(3.541112,-76.384584)"
2023,Febrero,República Checa,203,9,37,46,"(6.171601,-75.427454)"
2019,Agosto,Brasil,76,3860,5359,9219,"(4.697144,-74.140516)"
2021,Octubre,Israel,376,0,1,1,"(4.815061,-75.736532)"
2019,Agosto,India,356,1,2,3,"(0.814836,-77.662532)"
2020,Marzo,Taiwán,158,0,2,2,"(11.247723,-74.213989)"
2016,Mayo,Suecia,752,1,1,2,"(12.586067,-81.702563)"
2012,Octubre,Alemania,276,28,38,66,"(0.814836,-77.662532)"
2022,Noviembre,Filipinas,608,7,92,99,"(10.445761,-75.516429)"
2016,Mayo,Noruega,578,2,2,4,"(7.128456,-73.183637)"
2013,Enero,Portugal,620,5,19,24,"(0.814836,-77.662532)"
2014,Enero,Guatemala,320,3,4,7,"(0.814836,-77.662532)"
2022,Septiembre,Malta,470,1,1,2,"(10.445761,-75.516429)"
2022,Enero,Dinamarca,208,3,3,6,"(3.541112,-76.384584)"
2014,Noviembre,Finlandia,246,0,1,1,"(10.886611,-74.776708)"
2020,Octubre,Egipto,818,0,5,5,"(4.697144,-74.140516)"
2020,Abril,Venezuela,862,1,1,2,"(0.814836,-77.662532)"
2012,Diciembre,Grecia,300,0,8,8,"(10.408582,-75.538003)"
2018,Abril,Chile,152,144,109,253,"(10.408582,-75.538003)"
2022,Octubre,Cuba,192,0,2,2,"(4.815061,-75.736532)"
2017,Septiembre,Israel,376,9,22,31,"(0.814836,-77.662532)"
2018,Julio,Indonesia,360,1,3,4,"(6.171601,-75.427454)"
2014,Febrero,Myanmar,104,2,17,19,"(4.697144,-74.140516)"
2018,Junio,Canadá,124,0,1,1,"(13.3387613,-81.372937)"
2016,Abril,Bulgaria,100,3,6,9,"(10.445761,-75.516429)"
2015,Julio,Gabón,266,0,1,1,"(4.697144,-74.140516)"
2018,Febrero,Bolivia,68,189,129,318,"(10.445761,-75.516429)"
2017,Marzo,Alemania,276,1,3,4,"(11.360009,-72.129330)"
2021,Diciembre,Rumania,642,4,7,11,"(6.171601,-75.427454)"
2018,Abril,Reino Unido de Gran Bretaña e Irlanda del Norte,826,1,1,2,"(7.102626,-77.762647)"
2012,Diciembre,Argentina,32,1,5,6,"(8.635765,-77.346578)"
2015,Abril,Cuba,192,0,2,2,"(10.408582,-75.538003)"
2019,Agosto,Japón,392,0,1,1,"(8.36068,-72.409396)"
2023,Marzo,Albania,8,2,0,2,"(10.445761,-75.516429)"
2014,Junio,Brasil,76,3,4,7,"(4.815061,-75.736532)"
2022,Septiembre,Burkina Faso,854,1,1,2,"(4.697144,-74.140516)"
2019,Diciembre,Austria,40,240,360,600,"(4.697144,-74.140516)"
2016,Septiembre,Vietnam,704,8,29,37,"(4.697144,-74.140516)"
2023,Abril,Panamá,591,0,1,1,"(10.971302,-74.765397)"
2022,Septiembre,Suiza,756,17,16,33,"(3.541112,-76.384584)"
2015,Octubre,Países Bajos,528,0,1,1,"(12.586067,-81.702563)"
2015,Marzo,República de Corea,410,17,38,55,"(6.171601,-75.427454)"
2016,Febrero,Polonia,616,0,2,2,"(10.971302,-74.765397)"
2021,Enero,Estonia,233,1,1,2,"(6.171601,-75.427454)"
2022,Diciembre,Venezuela,862,25,21,46,"(7.128456,-73.183637)"
2013,Marzo,Austria,40,0,2,2,"(10.886611,-74.776708)"
2021,Octubre,Alemania,276,36,36,72,"(3.541112,-76.384584)"
2019,Julio,Chile,152,0,1,1,"(8.36068,-72.409396)"
2014,Octubre,Haití,332,2,8,10,"(6.171601,-75.427454)"
2016,Mayo,Guatemala,320,0,2,2,"(12.5744111,-81.703935)"
2012,Mayo,Argentina,32,24,60,84,"(3.541112,-76.384584)"
2021,Febrero,Italia,380,0,3,3,"(10.408582,-75.538003)"
2019,Junio,México,484,1,1,2,"(-4.197703,-69.941278)"
2022,Abril,España,724,2,3,5,"(7.927209,-72.507910)"
2013,Enero,Países Bajos,528,1,3,4,"(7.128456,-73.183637)"
2022,Febrero,Uruguay,858,16,46,62,"(6.171601,-75.427454)"
2022,Enero,Bolivia,68,3,6,9,"(10.886611,-74.776708)"
2023,Mayo,Singapur,702,4,4,8,"(6.171601,-75.427454)"
2017,Septiembre,Kenia,404,0,1,1,"(10.445761,-75.516429)"
2014,Diciembre,Reino Unido de Gran Bretaña e Irlanda del Norte,826,35,59,94,"(0.814836,-77.662532)"
2017,Octubre,Israel,376,26,69,95,"(6.171601,-75.427454)"
2020,Noviembre,Myanmar,104,0,1,1,"(4.697144,-74.140516)"
2017,Enero,Nigeria,566,1,0,1,"(12.586067,-81.702563)"
2015,Agosto,Cuba,192,7,7,14,"(10.886611,-74.776708)"
2022,Enero,Estados Unidos de América,840,4,13,17,"(11.360009,-72.129330)"
2013,Junio,Haití,332,0,1,1,"(10.886611,-74.776708)"
2019,Febrero,Bélgica,56,2,0,2,"(0.25129,-76.875963)"
2019,Junio,Japón,392,1,2,3,"(10.886611,-74.776708)"
2022,Agosto,Barbados,52,0,1,1,"(3.541112,-76.384584)"
2013,Octubre,España,724,34,71,105,"(10.445761,-75.516429)"
2022,Septiembre,Eslovenia,705,17,29,46,"(4.697144,-74.140516)"
2023,Enero,Portugal,620,1,0,1,"(-4.223468,-69.945098)"
2019,Diciembre,Brunei Darussalam,96,1,0,1,"(10.445761,-75.516429)"
2018,Marzo,Suiza,756,7,5,12,"(8.635765,-77.346578)"
2014,Diciembre,Estados Unidos de América,840,45,58,103,"(7.818934,-72.453226)"
2020,Julio,República de Corea,410,1,2,3,"(4.697144,-74.140516)"
2015,Noviembre,Ucrania,804,0,1,1,"(0.814836,-77.662532)"
2021,Diciembre,Chipre,196,0,1,1,"(10.408582,-75.538003)"
2015,Septiembre,Alemania,276,0,1,1,"(4.452882,-75.766298)"
2023,Enero,Marruecos,504,0,1,1,"(-4.223468,-69.945098)"
2016,Septiembre,Barbados,52,0,2,2,"(10.445761,-75.516429)"
2017,Junio,Reino Unido de Gran Bretaña e Irlanda del Norte,826,25,31,56,"(8.635765,-77.346578)"
2014,Julio,Hungría,348,0,1,1,"(0.814836,-77.662532)"
2013,Febrero,Trinidad y Tobago,780,2,3,5,"(6.171601,-75.427454)"
2019,Diciembre,Italia,380,35,36,71,"(11.360009,-72.129330)"
2015,Enero,Italia,380,672,2055,2727,"(4.697144,-74.140516)"
2013,Diciembre,Nueva Zelanda,554,4,5,9,"(10.408582,-75.538003)"
2017,Mayo,Chile,152,53,101,154,"(6.171601,-75.427454)"
2022,Septiembre,Países Bajos,528,2,5,7,"(8.635765,-77.346578)"
2014,Agosto,República de Irlanda,372,17,32,49,"(0.814836,-77.662532)"
2013,Diciembre,Perú,604,1,4,5,"(7.128456,-73.183637)"
2015,Abril,Francia,250,46,63,109,"(10.445761,-75.516429)"
2014,Agosto,Australia,36,253,459,712,"(4.697144,-74.140516)"
2012,Agosto,Ghana,288,0,2,2,"(4.697144,-74.140516)"
2012,Diciembre,Guyana,328,0,1,1,"(3.541112,-76.384584)"
2012,Abril,Guatemala,320,33,94,127,"(10.445761,-75.516429)"
2020,Enero,Federación de Rusia,643,33,22,55,"(6.171601,-75.427454)"
2013,Septiembre,Costa Rica,188,36,46,82,"(10.445761,-75.516429)"
2018,Febrero,Uganda,800,1,0,1,"(4.697144,-74.140516)"
2012,Febrero,México,484,9,31,40,"(7.818934,-72.453226)"
2021,Marzo,Surinam,740,0,1,1,"(3.541112,-76.384584)"
2022,Marzo,El Salvador,222,0,1,1,"(1.813928,-78.763924)"
2014,Diciembre,Albania,8,2,4,6,"(4.697144,-74.140516)"
2023,Enero,Canadá,124,3,4,7,"(7.916725,-72.462544)"
2019,Febrero,Uruguay,858,18,13,31,"(12.586067,-81.702563)"
2019,Septiembre,Etiopia,231,0,59,59,"(4.697144,-74.140516)"
2023,Marzo,Honduras,340,0,5,5,"(11.247723,-74.213989)"
2016,Septiembre,Honduras,340,42,51,93,"(6.171601,-75.427454)"
2020,Enero,Jamaica,388,0,3,3,"(12.586067,-81.702563)"
2023,Mayo,España,724,2,7,9,"(7.128456,-73.183637)"
2015,Marzo,Portugal,620,2,0,2,"(12.586067,-81.702563)"
2013,Enero,Estonia,233,15,9,24,"(4.697144,-74.140516)"
2018,Octubre,Países Bajos,528,2,1,3,"(-4.223468,-69.945098)"
2021,Noviembre,Argentina,32,0,1,1,"(8.635765,-77.346578)"
2012,Marzo,Uzbekistán,860,1,0,1,"(4.697144,-74.140516)"
2014,Agosto,Nueva Zelanda,554,4,11,15,"(10.445761,-75.516429)"
2020,Enero,Venezuela,862,14,23,37,"(4.815061,-75.736532)"
2013,Febrero,Perú,604,57,55,112,"(10.408582,-75.538003)"
2018,Febrero,Francia,250,0,8,8,"(7.818934,-72.453226)"
2016,Septiembre,Turquía,792,2,4,6,"(7.818934,-72.453226)"
2019,Diciembre,Eslovenia,705,2,14,16,"(6.171601,-75.427454)"
2022,Septiembre,Finlandia,246,1,0,1,"(8.635765,-77.346578)"
2013,Septiembre,Países Bajos,528,144,262,406,"(4.697144,-74.140516)"
2014,Agosto,Malasia,458,0,1,1,"(6.171601,-75.427454)"
2021,Agosto,Alemania,276,785,1259,2048,"(4.697144,-74.140516)"
2012,Agosto,Bahamas,44,0,4,4,"(10.445761,-75.516429)"
2021,Noviembre,Rumania,642,2,1,3,"(3.541112,-76.384584)"
2016,Julio,Nicaragua,558,2,6,8,"(12.5744111,-81.703935)"
2014,Agosto,Hungría,348,1,1,2,"(4.815061,-75.736532)"
2016,Junio,Alemania,276,0,1,1,"(1.813928,-78.763924)"
2015,Marzo,Suecia,752,7,6,13,"(-4.197703,-69.941278)"
2016,Noviembre,Tailandia,764,0,2,2,"(10.971302,-74.765397)"
2017,Septiembre,Ecuador,218,30,301,331,"(1.813928,-78.763924)"
2013,Julio,República Checa,203,1,0,1,"(4.815061,-75.736532)"
2019,Marzo,Eslovenia,705,1,2,3,"(6.171601,-75.427454)"
2015,Julio,Hungría,348,2,7,9,"(6.171601,-75.427454)"
2017,Febrero,Uruguay,858,92,75,167,"(10.445761,-75.516429)"
2017,Noviembre,Croacia,191,0,5,5,"(3.541112,-76.384584)"
2023,Enero,Canadá,124,2,1,3,"(8.36068,-72.409396)"
2018,Agosto,Paraguay,600,4,0,4,"(10.408582,-75.538003)"
2015,Junio,Turquía,792,1,0,1,"(0.25129,-76.875963)"
2014,Septiembre,China,156,1,2,3,"(10.408582,-75.538003)"
2021,Agosto,Kuwait,414,0,1,1,"(6.171601,-75.427454)"
2017,Enero,República de Irlanda,372,103,193,296,"(4.697144,-74.140516)"
2014,Abril,Chad,148,1,7,8,"(4.697144,-74.140516)"
2015,Septiembre,Bulgaria,100,3,1,4,"(6.171601,-75.427454)"
2015,Abril,Argentina,32,1,2,3,"(1.813928,-78.763924)"
2015,Junio,Noruega,578,0,1,1,"(13.3387613,-81.372937)"
2019,Mayo,Barbados,52,0,1,1,"(3.541112,-76.384584)"
2013,Septiembre,Chile,152,0,1,1,"(3.893038,-77.067921)"
2018,Septiembre,México,484,1,4,5,"(8.635765,-77.346578)"
2020,Diciembre,Dominica,212,0,1,1,"(3.541112,-76.384584)"
2014,Abril,Islandia,352,2,4,6,"(4.697144,-74.140516)"
2012,Abril,Surinam,740,0,3,3,"(6.171601,-75.427454)"
2012,Junio,Dinamarca,208,8,11,19,"(6.171601,-75.427454)"
2022,Julio,China,156,249,528,777,"(4.697144,-74.140516)"
2013,Enero,Honduras,340,1,0,1,"(7.818934,-72.453226)"
2021,Diciembre,Alemania,276,60,112,172,"(3.541112,-76.384584)"
2022,Enero,Francia,250,1,5,6,"(-4.197703,-69.941278)"
2023,Enero,Irán,364,1,0,1,"(3.541112,-76.384584)"
2022,Febrero,Chile,152,42,24,66,"(12.586067,-81.702563)"
2020,Marzo,Tailandia,764,0,1,1,"(10.445761,-75.516429)"
2016,Noviembre,Palestina,99999,0,1,1,"(4.697144,-74.140516)"
2017,Diciembre,Uruguay,858,53,56,109,"(10.445761,-75.516429)"
2018,Septiembre,Argentina,32,17,49,66,"(10.886611,-74.776708)"
2021,Octubre,Chile,152,0,2,2,"(7.916725,-72.462544)"
2016,Noviembre,Etiopia,231,0,1,1,"(10.445761,-75.516429)"
2012,Enero,Trinidad y Tobago,780,0,3,3,"(6.171601,-75.427454)"
2022,Noviembre,Pakistán,586,3,17,20,"(4.697144,-74.140516)"
2013,Diciembre,México,484,123,314,437,"(6.171601,-75.427454)"
2018,Diciembre,México,484,26,43,69,"(0.814836,-77.662532)"
2020,Noviembre,Bolivia,68,1,1,2,"(10.445761,-75.516429)"
2018,Noviembre,República de Irlanda,372,1,2,3,"(10.886611,-74.776708)"
2021,Junio,Federación de Rusia,643,1,4,5,"(10.886611,-74.776708)"
2022,Abril,China,156,0,1,1,"(4.452882,-75.766298)"
2012,Julio,Bélgica,56,12,24,36,"(3.541112,-76.384584)"
2015,Marzo,Canadá,124,4,3,7,"(7.927209,-72.507910)"
2022,Enero,Australia,36,0,1,1,"(-4.197703,-69.941278)"
2016,Abril,Portugal,620,5,29,34,"(3.541112,-76.384584)"
2019,Diciembre,Ucrania,804,0,1,1,"(3.893038,-77.067921)"
2016,Noviembre,Bolivia,68,6,8,14,"(10.408582,-75.538003)"
2021,Julio,Brasil,76,80,74,154,"(-4.197703,-69.941278)"
2015,Abril,México,484,286,705,991,"(6.171601,-75.427454)"
2023,Febrero,Eslovenia,705,0,2,2,"(3.541112,-76.384584)"
2023,Mayo,Bahamas,44,16,7,23,"(3.541112,-76.384584)"
2019,Julio,Paraguay,600,3,1,4,"(0.814836,-77.662532)"
2023,Abril,España,724,2,4,6,"(4.452882,-75.766298)"
2013,Abril,Ecuador,218,131,145,276,"(7.818934,-72.453226)"
2015,Mayo,Brasil,76,23,12,35,"(7.818934,-72.453226)"
2022,Julio,República Checa,203,11,17,28,"(6.171601,-75.427454)"
2022,Marzo,Panamá,591,1,0,1,"(8.36068,-72.409396)"
2018,Noviembre,República Democrática de Timor Oriental,626,0,1,1,"(4.697144,-74.140516)"
2022,Mayo,Grecia,300,2,4,6,"(3.541112,-76.384584)"
2015,Julio,Sri Lanka,144,0,1,1,"(0.814836,-77.662532)"
2017,Enero,Venezuela,862,137,172,309,"(10.445761,-75.516429)"
2012,Diciembre,Isla de Man,833,5,6,11,"(10.886611,-74.776708)"
2022,Agosto,Serbia,688,0,1,1,"(10.408582,-75.538003)"
2016,Diciembre,República Árabe Siria,760,0,1,1,"(3.541112,-76.384584)"
2014,Mayo,Croacia,191,3,24,27,"(4.697144,-74.140516)"
2017,Diciembre,Estados Unidos de América,840,37,112,149,"(10.408582,-75.538003)"
2016,Mayo,Venezuela,862,60,68,128,"(7.088729,-70.740253)"
2012,Abril,Países Bajos,528,1,0,1,"(12.586067,-81.702563)"
2016,Marzo,China,156,17,61,78,"(6.171601,-75.427454)"
2015,Agosto,Uganda,800,0,3,3,"(3.541112,-76.384584)"
2016,Septiembre,Federación de Rusia,643,0,1,1,"(10.886611,-74.776708)"
2012,Enero,Brasil,76,8,23,31,"(10.886611,-74.776708)"
2023,Mayo,Alemania,276,4,2,6,"(0.25129,-76.875963)"
2017,Diciembre,Países Bajos,528,14,18,32,"(11.247723,-74.213989)"
2015,Febrero,Ecuador,218,8,9,17,"(12.586067,-81.702563)"
2020,Diciembre,Costa Rica,188,8,9,17,"(4.815061,-75.736532)"
2019,Mayo,Canadá,124,0,2,2,"(12.5744111,-81.703935)"
2020,Noviembre,Rumania,642,0,1,1,"(11.247723,-74.213989)"
2015,Mayo,Desconocido,99999,1,0,1,"(0.814836,-77.662532)"
2018,Julio,Argentina,32,73,128,201,"(0.814836,-77.662532)"
2021,Junio,Suiza,756,1,3,4,"(3.541112,-76.384584)"
2023,Mayo,Kuwait,414,0,12,12,"(4.697144,-74.140516)"
2022,Agosto,Argelia,12,0,16,16,"(4.697144,-74.140516)"
2017,Febrero,Italia,380,11,32,43,"(10.886611,-74.776708)"
2016,Diciembre,Refugiado,99999,1,4,5,"(4.697144,-74.140516)"
2013,Diciembre,Kenia,404,0,1,1,"(6.171601,-75.427454)"
2013,Noviembre,Honduras,340,9,27,36,"(10.445761,-75.516429)"
2017,Diciembre,Brasil,76,8,9,17,"(11.247723,-74.213989)"
2022,Diciembre,Jordania,400,1,4,5,"(4.697144,-74.140516)"
2012,Octubre,Países Bajos,528,13,17,30,"(4.452882,-75.766298)"
2020,Noviembre,Estados Unidos de América,840,1511,1555,3066,"(3.541112,-76.384584)"
2018,Noviembre,República de Corea,410,10,17,27,"(10.445761,-75.516429)"
2014,Noviembre,Azerbaiyán,31,1,0,1,"(10.445761,-75.516429)"
2014,Enero,Ecuador,218,3,8,11,"(10.886611,-74.776708)"
2022,Enero,Iraq,368,1,1,2,"(4.697144,-74.140516)"
2022,Agosto,Argentina,32,3,4,7,"(8.36068,-72.409396)"
2018,Julio,Chile,152,16,17,33,"(7.818934,-72.453226)"
2016,Agosto,Cuba,192,7,12,19,"(10.886611,-74.776708)"
2015,Enero,Suiza,756,1,1,2,"(13.3387613,-81.372937)"
2022,Noviembre,Nueva Zelanda,554,2,2,4,"(10.408582,-75.538003)"
2016,Enero,Alemania,276,0,2,2,"(4.815061,-75.736532)"
2013,Marzo,Marruecos,504,0,1,1,"(3.541112,-76.384584)"
2020,Enero,Nepal,524,1,0,1,"(6.171601,-75.427454)"
2015,Octubre,Nueva Zelanda,554,1,2,3,"(8.635765,-77.346578)"
2017,Marzo,República de Kosovo,901,1,0,1,"(4.697144,-74.140516)"
2013,Septiembre,Luxemburgo,442,0,1,1,"(10.445761,-75.516429)"
2023,Febrero,Bulgaria,100,1,0,1,"(7.128456,-73.183637)"
2017,Septiembre,Kenia,404,1,2,3,"(3.541112,-76.384584)"
2015,Enero,Bélgica,56,8,29,37,"(10.445761,-75.516429)"
2016,Enero,Desconocido,99999,1,1,2,"(6.171601,-75.427454)"
2012,Octubre,Vietnam,704,0,2,2,"(10.408582,-75.538003)"
2015,Junio,Alemania,276,8,9,17,"(7.818934,-72.453226)"
2014,Octubre,Papúa Nueva Guinea,598,1,0,1,"(4.697144,-74.140516)"
2016,Septiembre,Portugal,620,7,36,43,"(6.171601,-75.427454)"
2013,Marzo,Filipinas,608,0,18,18,"(3.893038,-77.067921)"
2016,Julio,Francia,250,26,40,66,"(10.886611,-74.776708)"
2022,Octubre,Panamá,591,1,3,4,"(7.102626,-77.762647)"
2014,Diciembre,Italia,380,0,3,3,"(8.635765,-77.346578)"
2023,Enero,Guatemala,320,15,12,27,"(11.117806,-74.232622)"
2016,Marzo,Taiwán,158,1,1,2,"(10.886611,-74.776708)"
2016,Febrero,Haití,332,0,1,1,"(10.408582,-75.538003)"
2017,Agosto,Brasil,76,108,208,316,"(6.171601,-75.427454)"
2015,Agosto,Japón,392,1,6,7,"(7.818934,-72.453226)"
2018,Agosto,Turquía,792,1,1,2,"(11.247723,-74.213989)"
2015,Octubre,Suiza,756,19,19,38,"(0.814836,-77.662532)"
2018,Abril,Estados Unidos de América,840,0,1,1,"(10.971302,-74.765397)"
2015,Noviembre,Italia,380,0,4,4,"(0.25129,-76.875963)"
2017,Agosto,México,484,0,1,1,"(8.635765,-77.346578)"
2016,Septiembre,República Checa,203,1,1,2,"(10.408582,-75.538003)"
2020,Octubre,Vietnam,704,3,2,5,"(4.697144,-74.140516)"
2017,Mayo,Australia,36,0,1,1,"(7.128456,-73.183637)"
2015,Julio,Malasia,458,0,7,7,"(11.360009,-72.129330)"
2012,Mayo,Turquía,792,1,5,6,"(10.886611,-74.776708)"
2017,Abril,Portugal,620,4,10,14,"(3.541112,-76.384584)"
2022,Marzo,España,724,8,17,25,"(0.814836,-77.662532)"
2017,Enero,Estados Unidos de América,840,0,1,1,"(1.813928,-78.763924)"
2018,Noviembre,Dinamarca,208,12,25,37,"(10.445761,-75.516429)"
2016,Junio,Azerbaiyán,31,2,0,2,"(4.697144,-74.140516)"
2015,Febrero,Hungría,348,30,46,76,"(4.697144,-74.140516)"
2021,Marzo,Rumania,642,1,0,1,"(3.541112,-76.384584)"
2016,Abril,Nueva Zelanda,554,0,15,15,"(6.171601,-75.427454)"
2013,Enero,Suecia,752,1,5,6,"(7.818934,-72.453226)"
2015,Julio,Cuba,192,21,34,55,"(6.171601,-75.427454)"
2012,Agosto,Nueva Zelanda,554,0,1,1,"(4.815061,-75.736532)"
2016,Febrero,Alemania,276,11,13,24,"(8.635765,-77.346578)"
2017,Junio,República de Irlanda,372,0,2,2,"(-4.197703,-69.941278)"
2016,Noviembre,Reino Unido de Gran Bretaña e Irlanda del Norte,826,17,18,35,"(-4.197703,-69.941278)"
2023,Mayo,Sri Lanka,144,0,19,19,"(10.408582,-75.538003)"
2021,Enero,Argentina,32,29,68,97,"(6.171601,-75.427454)"
2014,Enero,Costa Rica,188,2,5,7,"(7.927209,-72.507910)"
2019,Marzo,Lituania,440,0,1,1,"(10.971302,-74.765397)"
2019,Febrero,Emiratos Árabes,784,2,14,16,"(4.697144,-74.140516)"
2021,Septiembre,Panamá,591,3,1,4,"(8.635765,-77.346578)"
2023,Abril,Malasia,458,5,2,7,"(10.445761,-75.516429)"
2019,Junio,República Árabe de Yemen,887,2,3,5,"(4.697144,-74.140516)"
2022,Enero,Australia,36,4,6,10,"(3.541112,-76.384584)"
2013,Marzo,Estados Unidos de América,840,5,9,14,"(11.247723,-74.213989)"
2015,Julio,Guinea Bissau,624,0,2,2,"(3.541112,-76.384584)"
2015,Marzo,Kazajistán,398,6,4,10,"(4.697144,-74.140516)"
2023,Junio,Liechtenstein,438,0,1,1,"(6.171601,-75.427454)"
2016,Noviembre,Panamá,591,44,56,100,"(4.815061,-75.736532)"
2012,Abril,Japón,392,1,0,1,"(4.815061,-75.736532)"
2023,Junio,Luxemburgo,442,3,0,3,"(4.815061,-75.736532)"
2013,Enero,República Checa,203,0,1,1,"(4.815061,-75.736532)"
2014,Septiembre,Panamá,591,10,20,30,"(4.815061,-75.736532)"
2014,Junio,Ecuador,218,1592,2477,4069,"(4.697144,-74.140516)"
2019,Agosto,Perú,604,5,7,12,"(8.36068,-72.409396)"
2013,Junio,Honduras,340,19,28,47,"(6.171601,-75.427454)"
2022,Noviembre,Estonia,233,23,29,52,"(4.697144,-74.140516)"
2019,Diciembre,Ecuador,218,1,1,2,"(-4.197703,-69.941278)"
2020,Marzo,Estonia,233,2,4,6,"(10.445761,-75.516429)"
2015,Junio,Sudáfrica,710,40,87,127,"(4.697144,-74.140516)"
2015,Agosto,Perú,604,2,5,7,"(7.927209,-72.507910)"
2019,Abril,Alemania,276,152,214,366,"(10.445761,-75.516429)"
2023,Marzo,México,484,25,43,68,"(0.814836,-77.662532)"
2015,Septiembre,Argentina,32,9,16,25,"(11.360009,-72.129330)"
2017,Julio,Namibia,516,1,0,1,"(4.697144,-74.140516)"
2015,Marzo,Uruguay,858,1,0,1,"(0.25129,-76.875963)"
2015,Enero,Japón,392,5,2,7,"(12.586067,-81.702563)"
2017,Septiembre,Croacia,191,0,4,4,"(10.971302,-74.765397)"
2012,Agosto,Cuba,192,11,24,35,"(10.445761,-75.516429)"
2022,Noviembre,República Dominicana,214,114,188,302,"(3.541112,-76.384584)"
2016,Mayo,Malasia,458,0,1,1,"(3.541112,-76.384584)"
2015,Octubre,República de Armenia,51,1,0,1,"(4.697144,-74.140516)"
2016,Septiembre,Taiwán,158,2,5,7,"(10.886611,-74.776708)"
2019,Marzo,Belice,84,0,1,1,"(10.445761,-75.516429)"
2016,Mayo,Filipinas,608,5,4,9,"(0.814836,-77.662532)"
2015,Julio,Australia,36,12,13,25,"(10.886611,-74.776708)"
2016,Marzo,Países Bajos,528,2,2,4,"(7.818934,-72.453226)"
2023,Febrero,Italia,380,1,5,6,"(7.128456,-73.183637)"
2023,Junio,Costa Rica,188,4,4,8,"(12.586067,-81.702563)"
2017,Octubre,Portugal,620,14,38,52,"(6.171601,-75.427454)"
2021,Septiembre,Hungría,348,0,1,1,"(10.445761,-75.516429)"
2013,Junio,Francia,250,51,65,116,"(0.814836,-77.662532)"
2015,Febrero,Guatemala,320,3,4,7,"(12.586067,-81.702563)"
2014,Enero,Venezuela,862,5943,6679,12622,"(4.697144,-74.140516)"
2021,Septiembre,Grecia,300,17,29,46,"(4.697144,-74.140516)"
2013,Marzo,España,724,139,360,499,"(4.697144,-74.140516)"
2017,Octubre,Vietnam,704,0,1,1,"(10.445761,-75.516429)"
2018,Septiembre,Paraguay,600,109,70,179,"(10.445761,-75.516429)"
2023,Mayo,Palestina,0,0,4,4,"(4.697144,-74.140516)"
2014,Agosto,Mozambique,508,1,5,6,"(4.697144,-74.140516)"
2012,Julio,Croacia,191,1,0,1,"(7.818934,-72.453226)"
2019,Enero,Barbados,52,3,0,3,"(10.445761,-75.516429)"
2018,Abril,Túnez,788,1,0,1,"(3.541112,-76.384584)"
2012,Abril,Finlandia,246,27,56,83,"(4.697144,-74.140516)"
2020,Marzo,Letonia,428,1,0,1,"(-4.223468,-69.945098)"
2015,Agosto,Suecia,752,0,1,1,"(11.117806,-74.232622)"
2014,Agosto,Perú,604,251,441,692,"(0.814836,-77.662532)"
2019,Febrero,Kenia,404,1,0,1,"(3.541112,-76.384584)"
2014,Diciembre,Italia,380,1,2,3,"(-4.197703,-69.941278)"
2018,Enero,Jordania,400,1,1,2,"(4.697144,-74.140516)"
2021,Diciembre,Tailandia,764,1,0,1,"(10.445761,-75.516429)"
2012,Mayo,Países Bajos,528,1,2,3,"(7.128456,-73.183637)"
2022,Febrero,Israel,376,2,1,3,"(0.814836,-77.662532)"
2018,Agosto,Refugiado,99999,3,2,5,"(10.886611,-74.776708)"
2018,Marzo,Venezuela,862,101,109,210,"(3.541112,-76.384584)"
2017,Abril,Sri Lanka,144,0,1,1,"(10.408582,-75.538003)"
2013,Septiembre,República de Irlanda,372,0,1,1,"(10.886611,-74.776708)"
2017,Mayo,Surinam,740,0,1,1,"(10.445761,-75.516429)"
2013,Agosto,Malasia,458,1,1,2,"(3.541112,-76.384584)"
2023,Febrero,Francia,250,1,0,1,"(4.452882,-75.766298)"
2019,Abril,Cuba,192,1,2,3,"(0.814836,-77.662532)"
2017,Julio,España,724,4,5,9,"(-4.223468,-69.945098)"
2022,Agosto,Uruguay,858,1,0,1,"(11.360009,-72.129330)"
2023,Febrero,Austria,40,1,0,1,"(4.815061,-75.736532)"
2013,Noviembre,Ecuador,218,390,509,899,"(3.541112,-76.384584)"
2017,Febrero,Grecia,300,1,0,1,"(8.36068,-72.409396)"
2012,Julio,Taiwán,158,1,1,2,"(10.886611,-74.776708)"
2015,Abril,India,356,0,5,5,"(10.408582,-75.538003)"
2023,Enero,Australia,36,0,2,2,"(11.360009,-72.129330)"
2022,Julio,Brasil,76,3256,3790,7049,"(4.697144,-74.140516)"
2023,Mayo,Federación de Rusia,643,2,1,3,"(7.916725,-72.462544)"
2016,Mayo,España,724,6,11,17,"(12.586067,-81.702563)"
2018,Febrero,Italia,380,109,172,281,"(10.445761,-75.516429)"
2017,Enero,República Dominicana,214,8,21,29,"(0.814836,-77.662532)"
2022,Enero,Polonia,616,19,61,80,"(3.541112,-76.384584)"
2021,Julio,Panamá,591,225,314,539,"(3.541112,-76.384584)"
2022,Mayo,Honduras,340,266,259,525,"(4.697144,-74.140516)"
2014,Agosto,Canadá,124,1,3,4,"(7.927209,-72.507910)"
2012,Febrero,Granada,308,1,0,1,"(10.445761,-75.516429)"
2019,Febrero,Grecia,300,39,105,144,"(4.697144,-74.140516)"
2012,Julio,Ghana,288,1,2,3,"(4.697144,-74.140516)"
2016,Mayo,Polonia,616,0,4,4,"(10.971302,-74.765397)"
2019,Junio,Bélgica,56,40,73,113,"(6.171601,-75.427454)"
2023,Febrero,Nueva Zelanda,554,53,71,124,"(4.697144,-74.140516)"
2017,Mayo,Chile,152,103,73,176,"(10.408582,-75.538003)"
2019,Diciembre,Haití,332,0,1,1,"(3.541112,-76.384584)"
2020,Diciembre,Iraq,368,1,0,1,"(4.697144,-74.140516)"
2014,Mayo,Emiratos Árabes,784,1,6,7,"(4.697144,-74.140516)"
2019,Diciembre,India,356,0,1,1,"(10.971302,-74.765397)"
2015,Mayo,Argelia,12,1,9,10,"(4.697144,-74.140516)"
2022,Mayo,India,356,0,16,16,"(10.971302,-74.765397)"
2020,Marzo,Grecia,300,0,2,2,"(3.541112,-76.384584)"
2021,Diciembre,Brasil,76,87,117,204,"(6.171601,-75.427454)"
2020,Agosto,República Dominicana,214,0,1,1,"(1.813928,-78.763924)"
2013,Marzo,Estados Unidos de América,840,1,4,5,"(7.088729,-70.740253)"
2013,Julio,República de Irlanda,372,6,11,17,"(3.541112,-76.384584)"
2016,Junio,Austria,40,2,3,5,"(10.886611,-74.776708)"
2022,Septiembre,Bélgica,56,1,2,3,"(4.815061,-75.736532)"
2015,Noviembre,Singapur,702,3,2,5,"(10.445761,-75.516429)"
2015,Abril,Italia,380,44,46,90,"(12.586067,-81.702563)"
2014,Junio,República Árabe Siria,760,0,1,1,"(4.697144,-74.140516)"
2019,Agosto,Grecia,300,3,9,12,"(6.171601,-75.427454)"
2013,Agosto,República de Corea,410,2,1,3,"(-4.197703,-69.941278)"
2012,Mayo,El Salvador,222,319,538,857,"(4.697144,-74.140516)"
2019,Agosto,Letonia,428,0,1,1,"(8.36068,-72.409396)"
2015,Junio,Líbano,422,2,4,6,"(11.360009,-72.129330)"
2020,Marzo,Brasil,76,0,2,2,"(11.360009,-72.129330)"
2013,Enero,Reino Unido de Gran Bretaña e Irlanda del Norte,826,9,8,17,"(8.635765,-77.346578)"
2015,Mayo,Palestina,99999,0,1,1,"(6.171601,-75.427454)"
2018,Julio,Alemania,276,3,4,7,"(4.815061,-75.736532)"
2013,Julio,Federación de Rusia,643,0,1,1,"(10.445761,-75.516429)"
2022,Diciembre,Reino Unido de Gran Bretaña e Irlanda del Norte,826,198,275,473,"(10.445761,-75.516429)"
2015,Diciembre,Ecuador,218,0,2,2,"(12.5744111,-81.703935)"
2013,Enero,República Checa,203,1,1,2,"(7.818934,-72.453226)"
2015,Octubre,Francia,250,38,67,105,"(10.445761,-75.516429)"
2019,Mayo,Noruega,578,2,0,2,"(10.408582,-75.538003)"
2019,Julio,Trinidad y Tobago,780,7,8,15,"(3.541112,-76.384584)"
2022,Abril,Nigeria,566,1,2,3,"(0.814836,-77.662532)"
2023,Mayo,Turquía,792,0,7,7,"(10.971302,-74.765397)"
2012,Mayo,Austria,40,1,1,2,"(8.635765,-77.346578)"
2012,Junio,Nicaragua,558,0,1,1,"(10.408582,-75.538003)"
2020,Enero,Eslovaquia,703,5,8,13,"(10.445761,-75.516429)"
2012,Diciembre,República de Irlanda,372,0,2,2,"(10.408582,-75.538003)"
2017,Octubre,China,156,0,1,1,"(7.088729,-70.740253)"
2016,Diciembre,Panamá,591,1517,1608,3125,"(6.171601,-75.427454)"
2019,Octubre,Italia,380,1,0,1,"(6.185799,-67.483929)"
2021,Octubre,Lituania,440,0,4,4,"(6.171601,-75.427454)"
2023,Enero,Nepal,524,2,2,4,"(4.697144,-74.140516)"
2012,Abril,Sudáfrica,710,0,1,1,"(11.247723,-74.213989)"
2015,Marzo,El Salvador,222,21,24,45,"(10.445761,-75.516429)"
2013,Mayo,China,156,0,2,2,"(11.247723,-74.213989)"
2018,Agosto,Malasia,458,1,3,4,"(6.171601,-75.427454)"
2014,Octubre,Uruguay,858,2,3,5,"(10.408582,-75.538003)"
2015,Abril,República Dominicana,214,4,7,11,"(12.586067,-81.702563)"
2022,Noviembre,Dinamarca,208,7,14,21,"(8.635765,-77.346578)"
2013,Abril,Canadá,124,13,34,47,"(10.886611,-74.776708)"
2017,Julio,Alemania,276,31,40,71,"(10.408582,-75.538003)"
2013,Diciembre,Argentina,32,8,24,32,"(7.818934,-72.453226)"
2019,Diciembre,Suecia,752,8,6,14,"(10.408582,-75.538003)"
2018,Mayo,Paraguay,600,12,6,18,"(3.541112,-76.384584)"
2017,Mayo,Croacia,191,0,9,9,"(10.445761,-75.516429)"
2018,Febrero,Malasia,458,1,2,3,"(10.445761,-75.516429)"
2016,Febrero,Nueva Zelanda,554,5,23,28,"(6.171601,-75.427454)"
2022,Diciembre,Argentina,32,10,19,29,"(7.818934,-72.453226)"
2013,Octubre,Países Bajos,528,15,48,63,"(3.541112,-76.384584)"
2019,Julio,Argentina,32,136,118,254,"(12.586067,-81.702563)"
2021,Febrero,Venezuela,862,177,190,367,"(10.886611,-74.776708)"
2023,Mayo,Croacia,191,1,3,4,"(3.541112,-76.384584)"
2015,Septiembre,Uruguay,858,0,1,1,"(8.635765,-77.346578)"
2013,Julio,Eritrea,232,1,1,2,"(4.697144,-74.140516)"
2022,Mayo,Jamaica,388,1,3,4,"(10.886611,-74.776708)"
2016,Julio,Federación de Rusia,643,1,0,1,"(12.586067,-81.702563)"
2019,Enero,Trinidad y Tobago,780,8,10,18,"(3.541112,-76.384584)"
2017,Agosto,Mauricio,480,1,1,2,"(4.697144,-74.140516)"
2022,Noviembre,Hungría,348,5,10,15,"(10.445761,-75.516429)"
2013,Julio,San  Vicente y las Granadinas,670,0,1,1,"(0.814836,-77.662532)"
2013,Julio,República de Tayikistán,762,0,1,1,"(4.697144,-74.140516)"
2019,Diciembre,Antigua y Barbuda,28,0,1,1,"(10.445761,-75.516429)"
2020,Enero,Ucrania,804,3,2,5,"(0.814836,-77.662532)"
2014,Septiembre,Paraguay,600,26,69,95,"(6.171601,-75.427454)"
2012,Marzo,Suiza,756,11,12,23,"(10.408582,-75.538003)"
2017,Noviembre,Venezuela,862,53,46,99,"(6.185799,-67.483929)"
2016,Octubre,Cuba,192,2,1,3,"(4.815061,-75.736532)"
2021,Mayo,Venezuela,862,3,1,4,"(-4.197703,-69.941278)"
2016,Agosto,Italia,380,9,21,30,"(-4.197703,-69.941278)"
2019,Mayo,Estados Unidos de América,840,180,226,406,"(4.452882,-75.766298)"
2012,Febrero,Ecuador,218,1228,1269,2497,"(0.814836,-77.662532)"
2014,Febrero,Francia,250,1146,2044,3190,"(4.697144,-74.140516)"
2014,Agosto,Italia,380,10,13,23,"(-4.197703,-69.941278)"
2014,Diciembre,Argentina,32,3023,4300,7323,"(4.697144,-74.140516)"
2015,Diciembre,Grecia,300,2,3,5,"(0.814836,-77.662532)"
2017,Agosto,India,356,1,0,1,"(-4.197703,-69.941278)"
2015,Mayo,República Checa,203,0,1,1,"(12.586067,-81.702563)"
2015,Junio,Perú,604,8,7,15,"(7.927209,-72.507910)"
2018,Noviembre,Suiza,756,67,133,200,"(6.171601,-75.427454)"
2020,Septiembre,Venezuela,862,63,60,123,"(10.445761,-75.516429)"
2013,Julio,Belice,84,0,1,1,"(6.171601,-75.427454)"
2019,Febrero,Francia,250,313,504,817,"(6.171601,-75.427454)"
2014,Septiembre,Reino Unido de Gran Bretaña e Irlanda del Norte,826,26,109,135,"(6.171601,-75.427454)"
2014,Septiembre,China,156,0,1,1,"(4.815061,-75.736532)"
2022,Abril,Etiopia,231,0,3,3,"(10.886611,-74.776708)"
2013,Abril,Suecia,752,2,13,15,"(3.541112,-76.384584)"
2015,Enero,Costa Rica,188,31,62,93,"(3.541112,-76.384584)"
2017,Agosto,Mozambique,508,1,2,3,"(4.697144,-74.140516)"
2014,Julio,Federación de Rusia,643,1,0,1,"(10.408582,-75.538003)"
2023,Junio,Venezuela,862,201,179,380,"(7.088729,-70.740253)"
2014,Noviembre,Bélgica,56,1,1,2,"(-4.197703,-69.941278)"
2012,Mayo,Países Bajos,528,3,3,6,"(-4.197703,-69.941278)"
2014,Noviembre,Haití,332,6,4,10,"(6.171601,-75.427454)"
2016,Mayo,Ucrania,804,16,12,28,"(4.697144,-74.140516)"
2018,Agosto,República de Corea,410,0,2,2,"(10.886611,-74.776708)"
2023,Enero,Brasil,76,61,64,125,"(12.586067,-81.702563)"
2015,Noviembre,Tailandia,764,2,2,4,"(6.171601,-75.427454)"
2017,Septiembre,Brasil,76,1,2,3,"(7.128456,-73.183637)"
2016,Marzo,Federación de Rusia,643,6,8,14,"(0.814836,-77.662532)"
2022,Octubre,Francia,250,1,0,1,"(6.228046,-77.404104)"
2023,Mayo,Croacia,191,2,8,10,"(6.171601,-75.427454)"
2019,Marzo,Países Bajos,528,11,13,24,"(7.128456,-73.183637)"
2023,Junio,Perú,604,83,174,257,"(0.814836,-77.662532)"
2023,Enero,Portugal,620,2,0,2,"(4.815061,-75.736532)"
2015,Agosto,Estados Unidos de América,840,34,68,102,"(7.128456,-73.183637)"
2019,Junio,Venezuela,862,3,2,5,"(12.586067,-81.702563)"
2019,Junio,India,356,0,11,11,"(10.408582,-75.538003)"
2014,Junio,Italia,380,4,6,10,"(-4.197703,-69.941278)"
2012,Junio,México,484,1,15,16,"(4.815061,-75.736532)"
2017,Enero,Hungría,348,1,4,5,"(3.541112,-76.384584)"
2022,Mayo,Italia,380,1,6,7,"(12.586067,-81.702563)"
2012,Enero,Kazajistán,398,1,1,2,"(4.697144,-74.140516)"
2018,Noviembre,Cuba,192,0,1,1,"(-4.197703,-69.941278)"
2021,Octubre,Estados Unidos de América,840,339,637,976,"(4.815061,-75.736532)"
2013,Agosto,Chile,152,8,12,20,"(11.360009,-72.129330)"
2018,Abril,Bosnia y Herzegovina,70,0,1,1,"(10.445761,-75.516429)"
2014,Octubre,El Salvador,222,486,601,1087,"(4.697144,-74.140516)"
2016,Diciembre,Noruega,578,0,4,4,"(7.818934,-72.453226)"
2019,Julio,Canadá,124,1357,1901,3258,"(4.697144,-74.140516)"
2021,Julio,República de Irlanda,372,0,2,2,"(3.541112,-76.384584)"
2012,Enero,Jamaica,388,0,1,1,"(12.586067,-81.702563)"
2013,Agosto,Francia,250,60,106,166,"(3.541112,-76.384584)"
2023,Abril,Ucrania,804,67,63,130,"(4.697144,-74.140516)"
2018,Julio,Ecuador,218,138,166,304,"(7.818934,-72.453226)"
2018,Agosto,Brasil,76,1,5,6,"(4.253669,-74.642361)"
2012,Enero,Argentina,32,0,1,1,"(7.088729,-70.740253)"
2017,Abril,Ucrania,804,1,19,20,"(10.408582,-75.538003)"
2013,Noviembre,Federación de Rusia,643,3,7,10,"(0.814836,-77.662532)"
2015,Febrero,Argelia,12,0,1,1,"(3.541112,-76.384584)"
2017,Marzo,Ecuador,218,4,6,10,"(11.360009,-72.129330)"
2014,Abril,Georgia,268,1,1,2,"(4.697144,-74.140516)"
2018,Junio,Finlandia,246,3,1,4,"(10.886611,-74.776708)"
2021,Diciembre,Venezuela,862,908,885,1793,"(8.36068,-72.409396)"
2013,Enero,México,484,3,2,5,"(6.185799,-67.483929)"
2017,Diciembre,Dinamarca,208,0,1,1,"(-4.197703,-69.941278)"
2018,Enero,Países Bajos,528,0,1,1,"(4.697144,-74.140516)"
2023,Abril,Estados Unidos de América,840,7,4,11,"(8.635765,-77.346578)"
2022,Agosto,Mongolia,496,1,0,1,"(6.171601,-75.427454)"
2019,Abril,Argentina,32,7,21,28,"(10.886611,-74.776708)"
2017,Julio,Honduras,340,54,115,169,"(6.171601,-75.427454)"
2014,Febrero,Paraguay,600,15,47,62,"(3.541112,-76.384584)"
2013,Marzo,Sudáfrica,710,0,5,5,"(10.886611,-74.776708)"
2018,Octubre,Estonia,233,3,1,4,"(10.445761,-75.516429)"
2017,Mayo,República Dominicana,214,6,7,13,"(10.408582,-75.538003)"
2014,Septiembre,Guatemala,320,24,36,60,"(10.445761,-75.516429)"
2018,Enero,Madagascar,450,2,1,3,"(4.697144,-74.140516)"
2012,Noviembre,Qatar,634,0,1,1,"(10.445761,-75.516429)"
2023,Febrero,España,724,21,38,59,"(0.814836,-77.662532)"
2016,Enero,Malta,470,1,0,1,"(3.541112,-76.384584)"
2023,Febrero,Francia,250,20,16,36,"(0.25129,-76.875963)"
2018,Enero,Canadá,124,17,19,36,"(10.408582,-75.538003)"
2020,Enero,República de Irlanda,372,1,0,1,"(0.25129,-76.875963)"
2012,Noviembre,Sri Lanka,144,1,0,1,"(4.697144,-74.140516)"
2021,Abril,Bulgaria,100,1,6,7,"(3.541112,-76.384584)"
2019,Abril,Malta,470,1,3,4,"(6.171601,-75.427454)"
2016,Septiembre,Mauricio,480,1,4,5,"(4.697144,-74.140516)"
2017,Enero,Ucrania,804,0,4,4,"(10.408582,-75.538003)"
2019,Julio,Albania,8,0,2,2,"(6.171601,-75.427454)"
2019,Julio,República Árabe de Yemen,887,1,2,3,"(4.697144,-74.140516)"
2023,Abril,Portugal,620,7,8,15,"(10.886611,-74.776708)"
2016,Agosto,República Dominicana,214,1,0,1,"(7.102626,-77.762647)"
2019,Junio,Japón,392,111,420,531,"(4.697144,-74.140516)"
2021,Abril,Ucrania,804,0,6,6,"(10.971302,-74.765397)"
2020,Diciembre,Liechtenstein,438,2,0,2,"(6.171601,-75.427454)"
2019,Febrero,Turquía,792,0,1,1,"(12.586067,-81.702563)"
2012,Enero,Chile,152,0,1,1,"(7.088729,-70.740253)"
2018,Enero,Dinamarca,208,179,222,401,"(4.697144,-74.140516)"
2021,Febrero,Canadá,124,1,0,1,"(11.247723,-74.213989)"
2019,Octubre,Hungría,348,1,14,15,"(6.171601,-75.427454)"
2013,Marzo,Países Bajos,528,2,30,32,"(7.818934,-72.453226)"
2016,Marzo,Guyana,328,0,1,1,"(11.360009,-72.129330)"
2017,Abril,Lituania,440,0,2,2,"(3.541112,-76.384584)"
2022,Diciembre,Eslovenia,705,1,7,8,"(6.171601,-75.427454)"
2012,Septiembre,Venezuela,862,34,81,115,"(10.886611,-74.776708)"
2015,Noviembre,Austria,40,1,1,2,"(0.25129,-76.875963)"
2014,Julio,República de Irlanda,372,9,18,27,"(6.171601,-75.427454)"
2012,Septiembre,Costa Rica,188,2,2,4,"(7.927209,-72.507910)"
2016,Enero,República Árabe de Yemen,887,0,1,1,"(4.697144,-74.140516)"
2018,Abril,Cuba,192,0,4,4,"(0.814836,-77.662532)"
2015,Enero,China,156,1,1,2,"(0.814836,-77.662532)"
2014,Julio,Trinidad y Tobago,780,2,1,3,"(4.815061,-75.736532)"
2012,Mayo,Belice,84,1,0,1,"(3.541112,-76.384584)"
2012,Julio,República Dominicana,214,26,22,48,"(3.541112,-76.384584)"
2018,Marzo,Federación de Rusia,643,4,9,13,"(10.408582,-75.538003)"
2013,Noviembre,Eslovenia,705,0,2,2,"(10.408582,-75.538003)"
2012,Marzo,Bulgaria,100,1,2,3,"(10.445761,-75.516429)"
2022,Febrero,Serbia,688,0,2,2,"(10.886611,-74.776708)"
2023,Abril,Nicaragua,558,3,6,9,"(12.5744111,-81.703935)"
2015,Junio,Rumania,642,1,3,4,"(10.445761,-75.516429)"
2022,Mayo,Ecuador,218,1,1,2,"(7.128456,-73.183637)"
2012,Abril,Nueva Zelanda,554,3,7,10,"(6.171601,-75.427454)"
2013,Julio,Suecia,752,5,3,8,"(10.408582,-75.538003)"
2017,Agosto,Cuba,192,0,4,4,"(0.814836,-77.662532)"
2021,Octubre,Desconocido,99999,1,0,1,"(7.818934,-72.453226)"
2013,Mayo,Australia,36,4,8,12,"(10.886611,-74.776708)"
2023,Junio,Grecia,300,2,14,16,"(3.893038,-77.067921)"
2020,Marzo,Países Bajos,528,3,5,8,"(8.635765,-77.346578)"
2016,Noviembre,México,484,21,15,36,"(10.408582,-75.538003)"
2015,Julio,Ecuador,218,3,1,4,"(7.088729,-70.740253)"
2013,Mayo,Australia,36,47,76,123,"(0.814836,-77.662532)"
2021,Diciembre,El Salvador,222,37,41,78,"(3.541112,-76.384584)"
2021,Mayo,Perú,604,396,518,914,"(6.171601,-75.427454)"
2013,Febrero,Ecuador,218,2091,2808,4899,"(4.697144,-74.140516)"
2019,Octubre,Letonia,428,16,23,39,"(4.697144,-74.140516)"
2018,Abril,Francia,250,96,118,214,"(0.814836,-77.662532)"
2012,Diciembre,Eritrea,232,0,1,1,"(7.818934,-72.453226)"
2019,Abril,Montenegro,499,1,2,3,"(4.697144,-74.140516)"
2015,Agosto,Estados Unidos de América,840,12,25,37,"(-4.197703,-69.941278)"
2019,Agosto,Guatemala,320,9,15,24,"(12.586067,-81.702563)"
2014,Agosto,Turquía,792,1,1,2,"(7.818934,-72.453226)"
2014,Febrero,Ghana,288,0,1,1,"(10.408582,-75.538003)"
2019,Septiembre,Israel,376,1,2,3,"(0.25129,-76.875963)"
2014,Agosto,Polonia,616,1,2,3,"(3.541112,-76.384584)"
2022,Diciembre,Estados Unidos de América,840,73,85,158,"(7.927209,-72.507910)"
2015,Abril,Bermudas/Territorio Británico de Ultramar,60,0,1,1,"(6.171601,-75.427454)"
2021,Septiembre,Hong Kong,344,1,0,1,"(6.171601,-75.427454)"
2015,Julio,Reino Unido de Gran Bretaña e Irlanda del Norte,826,1,1,2,"(4.452882,-75.766298)"
2022,Diciembre,Australia,36,0,1,1,"(7.818934,-72.453226)"
2014,Febrero,Australia,36,6,9,15,"(8.635765,-77.346578)"
2014,Diciembre,Paraguay,600,31,25,56,"(12.586067,-81.702563)"
2019,Mayo,Taiwán,158,10,9,19,"(6.171601,-75.427454)"
2019,Mayo,Paraguay,600,41,32,73,"(12.586067,-81.702563)"
2023,Mayo,Costa de Marfil,384,0,1,1,"(10.886611,-74.776708)"
2023,Mayo,Suiza,756,1,0,1,"(11.117806,-74.232622)"
2018,Agosto,Nepal,524,1,0,1,"(6.171601,-75.427454)"
2015,Agosto,San Cristóbal y Nevis,659,1,0,1,"(3.541112,-76.384584)"
2023,Mayo,Países Bajos,528,8,14,22,"(4.815061,-75.736532)"
2017,Marzo,Sudáfrica,710,3,9,12,"(10.408582,-75.538003)"
2012,Enero,Bélgica,56,4,3,7,"(7.818934,-72.453226)"
2013,Julio,Reino Unido de Gran Bretaña e Irlanda del Norte,826,7,12,19,"(11.360009,-72.129330)"
2017,Marzo,Federación de Rusia,643,0,1,1,"(4.815061,-75.736532)"
2012,Junio,Malasia,458,10,24,34,"(4.697144,-74.140516)"
2014,Noviembre,Emiratos Árabes,784,1,3,4,"(4.697144,-74.140516)"
2015,Noviembre,Uruguay,858,26,56,82,"(6.171601,-75.427454)"
2012,Octubre,Perú,604,255,145,400,"(12.586067,-81.702563)"
2020,Febrero,Turquía,792,0,4,4,"(3.541112,-76.384584)"
2014,Febrero,Canadá,124,1,1,2,"(7.927209,-72.507910)"
2022,Abril,Taiwán,158,4,8,12,"(6.171601,-75.427454)"
2012,Febrero,Estados Unidos de América,840,6,24,30,"(12.5744111,-81.703935)"
2012,Noviembre,República de Armenia,51,1,0,1,"(10.408582,-75.538003)"
2021,Agosto,España,724,0,3,3,"(10.408582,-75.538003)"
2023,Febrero,España,724,13,17,30,"(11.360009,-72.129330)"
2012,Noviembre,Canadá,124,76,192,268,"(6.171601,-75.427454)"
2022,Abril,Costa Rica,188,2,2,4,"(7.818934,-72.453226)"
2017,Enero,Ecuador,218,1,2,3,"(7.128456,-73.183637)"
2023,Mayo,Eslovaquia,703,0,1,1,"(10.408582,-75.538003)"
2020,Diciembre,Argentina,32,1,0,1,"(7.818934,-72.453226)"
2015,Julio,Reino Unido de Gran Bretaña e Irlanda del Norte,826,2,10,12,"(11.360009,-72.129330)"
2012,Octubre,España,724,131,291,422,"(3.541112,-76.384584)"
2023,Abril,España,724,31,55,86,"(7.818934,-72.453226)"
2014,Agosto,Indonesia,360,0,1,1,"(-4.197703,-69.941278)"
2022,Marzo,Qatar,634,0,1,1,"(4.697144,-74.140516)"
2023,Junio,Países Bajos,528,29,64,93,"(10.886611,-74.776708)"
2022,Febrero,Austria,40,1,0,1,"(0.814836,-77.662532)"
2017,Junio,Bulgaria,100,3,2,5,"(0.814836,-77.662532)"
2014,Octubre,Uruguay,858,0,2,2,"(7.927209,-72.507910)"
2019,Junio,Sudáfrica,710,0,1,1,"(10.408582,-75.538003)"
2023,Marzo,México,484,0,5,5,"(8.36068,-72.409396)"
2022,Diciembre,Marruecos,504,1,3,4,"(0.814836,-77.662532)"
2022,Junio,Qatar,634,0,1,1,"(6.171601,-75.427454)"
2018,Julio,Suecia,752,1,0,1,"(0.25129,-76.875963)"
2023,Enero,Grecia,300,4,23,27,"(10.445761,-75.516429)"
2021,Mayo,Suiza,756,59,128,187,"(4.697144,-74.140516)"
2023,Enero,República Árabe Siria,760,0,1,1,"(10.445761,-75.516429)"
2017,Agosto,Reino Unido de Gran Bretaña e Irlanda del Norte,826,1,2,3,"(4.452882,-75.766298)"
2015,Agosto,Kenia,404,0,2,2,"(3.541112,-76.384584)"
2015,Noviembre,Países Bajos,528,0,2,2,"(4.697144,-74.140516)"
2022,Diciembre,Argentina,32,1,2,3,"(-4.223468,-69.945098)"
2017,Diciembre,Islas Caimán/Territorio Británico de Ultramar,136,2,0,2,"(10.445761,-75.516429)"
2017,Marzo,Alemania,276,15,17,32,"(10.886611,-74.776708)"
2017,Septiembre,Guatemala,320,2,3,5,"(7.128456,-73.183637)"
2016,Mayo,Países Bajos,528,958,1406,2364,"(4.697144,-74.140516)"
2022,Septiembre,Serbia,688,0,1,1,"(10.408582,-75.538003)"
2013,Mayo,Suiza,756,28,25,53,"(0.814836,-77.662532)"
2017,Septiembre,Turquía,792,0,1,1,"(10.408582,-75.538003)"
2018,Febrero,Venezuela,862,156,229,385,"(10.445761,-75.516429)"
2014,Febrero,Eslovaquia,703,0,1,1,"(10.408582,-75.538003)"
2012,Junio,Federación de Rusia,643,6,6,12,"(0.814836,-77.662532)"
2017,Noviembre,Israel,376,3,2,5,"(12.586067,-81.702563)"
2013,Febrero,España,724,31,80,111,"(10.445761,-75.516429)"
2016,Abril,Chile,152,142,130,272,"(10.445761,-75.516429)"
2020,Enero,Países Bajos,528,0,1,1,"(8.36068,-72.409396)"
2022,Noviembre,Costa Rica,188,1,0,1,"(7.128456,-73.183637)"
2018,Agosto,República de Corea,410,3,7,10,"(3.541112,-76.384584)"
2022,Agosto,Marruecos,504,28,70,98,"(4.697144,-74.140516)"
2016,Octubre,Filipinas,608,1,2,3,"(3.541112,-76.384584)"
2021,Junio,Alemania,276,1,3,4,"(12.5744111,-81.703935)"
2018,Enero,República Árabe de Yemen,887,0,1,1,"(4.697144,-74.140516)"
2023,Marzo,República de Irlanda,372,0,2,2,"(-4.197703,-69.941278)"
2015,Enero,Rumania,642,0,1,1,"(10.445761,-75.516429)"
2018,Febrero,Panamá,591,0,1,1,"(6.17134,-75.427194)"
2013,Septiembre,Australia,36,0,1,1,"(7.927209,-72.507910)"
2013,Noviembre,Singapur,702,3,1,4,"(10.445761,-75.516429)"
2022,Agosto,México,484,5,10,15,"(12.586067,-81.702563)"
2018,Febrero,Japón,392,0,1,1,"(-4.223468,-69.945098)"
2019,Junio,Israel,376,102,185,287,"(6.171601,-75.427454)"
2017,Marzo,Ucrania,804,0,3,3,"(10.886611,-74.776708)"
2014,Diciembre,Polonia,616,0,8,8,"(3.893038,-77.067921)"
2018,Mayo,República de Corea,410,13,17,30,"(0.814836,-77.662532)"
2022,Agosto,Israel,376,17,54,71,"(10.445761,-75.516429)"
2021,Octubre,China,156,1,0,1,"(4.815061,-75.736532)"
2015,Abril,Canadá,124,4,2,6,"(7.927209,-72.507910)"
2022,Julio,Italia,380,0,7,7,"(4.815061,-75.736532)"
2012,Agosto,Países Bajos,528,10,28,38,"(3.541112,-76.384584)"
2019,Octubre,Filipinas,608,0,19,19,"(3.541112,-76.384584)"
2012,Agosto,España,724,3,1,4,"(12.586067,-81.702563)"
2017,Abril,Uruguay,858,26,39,65,"(3.541112,-76.384584)"
2017,Marzo,Bulgaria,100,32,24,56,"(4.697144,-74.140516)"
2023,Febrero,Perú,604,0,20,20,"(10.971302,-74.765397)"
2014,Noviembre,Italia,380,0,1,1,"(7.088729,-70.740253)"
2015,Junio,Estados Unidos de América,840,0,3,3,"(0.25129,-76.875963)"
2012,Junio,Honduras,340,104,211,315,"(4.697144,-74.140516)"
2012,Febrero,China,156,2,6,8,"(3.541112,-76.384584)"
2013,Septiembre,Austria,40,0,3,3,"(10.886611,-74.776708)"
2018,Julio,Finlandia,246,8,5,13,"(10.445761,-75.516429)"
2013,Abril,Santa Lucia,662,0,1,1,"(7.927209,-72.507910)"
2023,Marzo,Brasil,76,196,328,524,"(6.171601,-75.427454)"
2022,Noviembre,Ucrania,804,16,23,39,"(10.445761,-75.516429)"
2013,Mayo,Filipinas,608,0,1,1,"(10.408582,-75.538003)"
2017,Septiembre,Estados Unidos de América,840,4,9,13,"(11.247723,-74.213989)"
2022,Febrero,Bolivia,68,4,3,7,"(7.128456,-73.183637)"
2022,Julio,México,484,3,11,14,"(7.128456,-73.183637)"
2016,Marzo,Suecia,752,15,18,33,"(10.445761,-75.516429)"
2018,Septiembre,Costa Rica,188,5,8,13,"(4.815061,-75.736532)"
2021,Septiembre,India,356,11,37,48,"(6.171601,-75.427454)"
2018,Julio,Bolivia,68,1,0,1,"(-4.197703,-69.941278)"
2018,Mayo,Reino Unido de Gran Bretaña e Irlanda del Norte,826,12,10,22,"(10.886611,-74.776708)"
2019,Mayo,España,724,24,56,80,"(0.814836,-77.662532)"
2014,Febrero,Ecuador,218,17,28,45,"(11.360009,-72.129330)"
2013,Enero,Benín,204,0,1,1,"(4.697144,-74.140516)"
2013,Septiembre,Estados Unidos de América,840,13,21,34,"(12.586067,-81.702563)"
2015,Abril,Alemania,276,0,1,1,"(0.25129,-76.875963)"
2015,Junio,Estados Unidos de América,840,0,12,12,"(10.971302,-74.765397)"
2022,Septiembre,Ecuador,218,3740,4273,8014,"(0.814836,-77.662532)"
2022,Octubre,Austria,40,18,14,32,"(10.445761,-75.516429)"
2019,Enero,San Cristóbal y Nevis,659,0,1,1,"(6.171601,-75.427454)"
2018,Enero,Marruecos,504,0,1,1,"(3.541112,-76.384584)"
2019,Septiembre,República Dominicana,214,76,98,174,"(6.171601,-75.427454)"
2019,Diciembre,Alemania,276,205,312,517,"(10.445761,-75.516429)"
2016,Octubre,India,356,8,16,24,"(3.541112,-76.384584)"
2019,Enero,Bolivia,68,2,7,9,"(7.818934,-72.453226)"
2020,Marzo,Suecia,752,1,0,1,"(7.818934,-72.453226)"
2016,Abril,Pakistán,586,0,2,2,"(3.541112,-76.384584)"
2022,Abril,Jamaica,388,27,29,56,"(4.697144,-74.140516)"
2021,Diciembre,Panamá,591,42,66,108,"(4.452882,-75.766298)"
2021,Octubre,Perú,604,2,3,5,"(11.360009,-72.129330)"
2017,Enero,Austria,40,3,5,8,"(-4.197703,-69.941278)"
2022,Agosto,Italia,380,0,8,8,"(4.815061,-75.736532)"
2020,Junio,Serbia,688,1,0,1,"(4.697144,-74.140516)"
2012,Febrero,Eslovaquia,703,3,1,4,"(6.171601,-75.427454)"
2020,Marzo,Irán,364,0,1,1,"(10.408582,-75.538003)"
2015,Febrero,Polonia,616,2,0,2,"(8.635765,-77.346578)"
2015,Junio,Canadá,124,27,38,65,"(10.886611,-74.776708)"
2015,Febrero,Estados Unidos de América,840,2,9,11,"(12.5744111,-81.703935)"
2015,Marzo,Desconocido,99999,1,1,2,"(3.541112,-76.384584)"
2021,Mayo,Portugal,620,2,4,6,"(3.541112,-76.384584)"
2021,Junio,Grecia,300,2,4,6,"(10.445761,-75.516429)"
2013,Agosto,Arabia Saudita,682,0,2,2,"(4.697144,-74.140516)"
2021,Enero,Alemania,276,4,13,17,"(3.541112,-76.384584)"
2016,Junio,Rumania,642,1,0,1,"(10.886611,-74.776708)"
2019,Noviembre,Finlandia,246,0,5,5,"(3.541112,-76.384584)"
2019,Marzo,Ghana,288,1,10,11,"(4.697144,-74.140516)"
2021,Septiembre,Argentina,32,2,1,3,"(7.128456,-73.183637)"
2014,Agosto,Sudáfrica,710,1,6,7,"(6.171601,-75.427454)"
2022,Octubre,Suecia,752,2,6,8,"(10.408582,-75.538003)"
2023,Abril,Irán,364,12,14,26,"(4.697144,-74.140516)"
2013,Enero,Chile,152,6,15,21,"(10.886611,-74.776708)"
2019,Septiembre,Estados Unidos de América,840,2,3,5,"(11.528919,-72.919681)"
2022,Marzo,Bermudas/Territorio Británico de Ultramar,60,0,1,1,"(3.541112,-76.384584)"
2014,Noviembre,Chipre,196,0,1,1,"(0.814836,-77.662532)"
2023,Marzo,Venezuela,862,0,56,56,"(3.893038,-77.067921)"
2022,Agosto,Israel,376,13,27,40,"(0.814836,-77.662532)"
2020,Marzo,Honduras,340,1,0,1,"(7.818934,-72.453226)"
2021,Diciembre,Pakistán,586,0,1,1,"(3.541112,-76.384584)"
2016,Enero,Estados Unidos de América,840,1,0,1,"(-4.223468,-69.945098)"
2017,Marzo,Rumania,642,0,1,1,"(11.247723,-74.213989)"
2015,Julio,Benín,204,0,2,2,"(4.697144,-74.140516)"
2020,Febrero,Nigeria,566,7,4,11,"(4.697144,-74.140516)"
2015,Septiembre,Taiwán,158,4,4,8,"(10.445761,-75.516429)"
2022,Febrero,República Dominicana,214,719,799,1519,"(6.171601,-75.427454)"
2014,Diciembre,Polonia,616,0,5,5,"(10.971302,-74.765397)"
2022,Octubre,Italia,380,2,10,12,"(10.408582,-75.538003)"
2016,Diciembre,Hungría,348,3,3,6,"(3.541112,-76.384584)"
2013,Febrero,Emiratos Árabes,784,1,5,6,"(4.697144,-74.140516)"
2014,Febrero,Bahamas,44,3,9,12,"(4.697144,-74.140516)"
2022,Febrero,Suiza,756,10,12,22,"(10.886611,-74.776708)"
2020,Marzo,Italia,380,6,6,12,"(-4.223468,-69.945098)"
2021,Junio,Nigeria,566,0,13,13,"(10.445761,-75.516429)"
2021,Mayo,Hong Kong,344,0,2,2,"(10.445761,-75.516429)"
2022,Agosto,Cuba,192,3,2,5,"(7.128456,-73.183637)"
2016,Noviembre,Uruguay,858,1,1,2,"(4.452882,-75.766298)"
2012,Diciembre,Francia,250,1112,2054,3166,"(4.697144,-74.140516)"
2016,Junio,Canadá,124,2,4,6,"(12.586067,-81.702563)"
2012,Agosto,San  Vicente y las Granadinas,670,0,2,2,"(4.697144,-74.140516)"
2019,Mayo,Federación de Rusia,643,11,9,21,"(6.171601,-75.427454)"
2016,Diciembre,Mongolia,496,1,1,2,"(4.697144,-74.140516)"
2012,Julio,Reino Unido de Gran Bretaña e Irlanda del Norte,826,1,4,5,"(10.886611,-74.776708)"
2022,Marzo,Omán,512,0,1,1,"(4.697144,-74.140516)"
2012,Enero,Venezuela,862,0,4,4,"(11.117806,-74.232622)"
2022,Junio,Portugal,620,5,10,15,"(11.360009,-72.129330)"
2019,Septiembre,Irán,364,8,18,26,"(4.697144,-74.140516)"
2023,Junio,Guatemala,320,15,19,34,"(10.886611,-74.776708)"
2015,Agosto,Antigua y Barbuda,28,0,4,4,"(10.445761,-75.516429)"
2022,Mayo,Croacia,191,21,36,57,"(4.697144,-74.140516)"
2020,Junio,Brasil,76,13,8,21,"(4.697144,-74.140516)"
2021,Agosto,Dominica,212,1,3,4,"(4.697144,-74.140516)"
2012,Julio,Polonia,616,0,1,1,"(9.402978,-75.681599)"
2023,Mayo,Federación de Rusia,643,1,4,5,"(3.541112,-76.384584)"
2019,Mayo,Panamá,591,1482,1450,2932,"(6.171601,-75.427454)"
2018,Noviembre,Jamaica,388,9,9,18,"(10.445761,-75.516429)"
2022,Enero,Venezuela,862,406,412,818,"(7.088729,-70.740253)"
2021,Noviembre,Países Bajos,528,5,4,9,"(11.247723,-74.213989)"
2022,Febrero,Italia,380,21,55,76,"(3.541112,-76.384584)"
2016,Mayo,Brasil,76,8,28,36,"(10.886611,-74.776708)"
2020,Septiembre,República Dominicana,214,0,6,6,"(10.886611,-74.776708)"
2018,Julio,Chile,152,9,19,28,"(10.886611,-74.776708)"
2014,Diciembre,Dinamarca,208,0,1,1,"(11.360009,-72.129330)"
2015,Marzo,Honduras,340,197,255,452,"(4.697144,-74.140516)"
2019,Febrero,Austria,40,2,0,2,"(4.815061,-75.736532)"
2016,Mayo,Emiratos Árabes,784,0,1,1,"(3.541112,-76.384584)"
2022,Septiembre,Chile,152,20,16,36,"(7.927209,-72.507910)"
2019,Marzo,Perú,604,0,1,1,"(6.185799,-67.483929)"
2022,Junio,Uruguay,858,0,1,1,"(11.360009,-72.129330)"
2023,Marzo,Alemania,276,1,2,3,"(8.36068,-72.409396)"
2018,Octubre,Myanmar,104,0,3,3,"(10.408582,-75.538003)"
2016,Marzo,República Dominicana,214,113,104,217,"(6.171601,-75.427454)"
2017,Septiembre,Finlandia,246,2,3,5,"(0.814836,-77.662532)"
2015,Septiembre,Eslovenia,705,0,1,1,"(6.171601,-75.427454)"
2012,Febrero,Costa Rica,188,18,39,57,"(3.541112,-76.384584)"
2012,Febrero,Perú,604,0,1,1,"(3.893038,-77.067921)"
2019,Agosto,Nueva Zelanda,554,0,1,1,"(7.818934,-72.453226)"
2021,Julio,Alemania,276,13,22,35,"(3.541112,-76.384584)"
2020,Septiembre,China,156,1,0,1,"(7.818934,-72.453226)"
2015,Mayo,Venezuela,862,1652,2453,4105,"(11.360009,-72.129330)"
2016,Abril,Aruba,533,1,0,1,"(7.128456,-73.183637)"
2012,Septiembre,Chile,152,0,1,1,"(6.185799,-67.483929)"
2013,Diciembre,Noruega,578,2,4,6,"(0.814836,-77.662532)"
2022,Octubre,Austria,40,141,231,372,"(4.697144,-74.140516)"
2013,Agosto,Bélgica,56,0,1,1,"(7.128456,-73.183637)"
2012,Enero,Finlandia,246,0,1,1,"(6.171601,-75.427454)"
2014,Julio,Taiwán,158,2,1,3,"(3.541112,-76.384584)"
2014,Noviembre,Paraguay,600,34,24,58,"(10.445761,-75.516429)"
2021,Enero,Chile,152,8,12,20,"(4.815061,-75.736532)"
2020,Marzo,Sudáfrica,710,5,15,20,"(4.697144,-74.140516)"
2015,Octubre,Chile,152,3,2,5,"(0.25129,-76.875963)"
2014,Octubre,Austria,40,1,1,2,"(7.818934,-72.453226)"
2023,Marzo,Bélgica,56,2,3,5,"(-4.197703,-69.941278)"
2022,Enero,Suecia,752,0,3,3,"(12.5744111,-81.703935)"
2021,Junio,Cuba,192,1,1,2,"(4.815061,-75.736532)"
2016,Febrero,Ecuador,218,68,156,224,"(0.25129,-76.875963)"
2017,Octubre,Estados Unidos de América,840,6,7,13,"(8.635765,-77.346578)"
2013,Julio,Islas Aland/Provincia de Finlandia,248,0,1,1,"(4.697144,-74.140516)"
2016,Febrero,China,156,2,0,2,"(8.635765,-77.346578)"
2012,Junio,Cuba,192,0,1,1,"(-4.197703,-69.941278)"
2015,Junio,Uganda,800,4,4,8,"(4.697144,-74.140516)"
2020,Marzo,Cuba,192,104,150,254,"(4.697144,-74.140516)"
2016,Mayo,Luxemburgo,442,1,1,2,"(6.171601,-75.427454)"
2017,Julio,Ecuador,218,3153,3916,7069,"(4.697144,-74.140516)"
2022,Marzo,Ecuador,218,1,2,3,"(7.927209,-72.507910)"
2019,Julio,Dominica,212,0,2,2,"(10.445761,-75.516429)"
2022,Agosto,Francia,250,1,0,1,"(6.18189,-67.47535)"
2017,Diciembre,Costa de Marfil,384,0,1,1,"(4.697144,-74.140516)"
2012,Abril,Bulgaria,100,3,6,9,"(4.697144,-74.140516)"
2020,Febrero,Austria,40,8,7,15,"(10.408582,-75.538003)"
2018,Septiembre,Croacia,191,1,1,2,"(11.360009,-72.129330)"
2023,Marzo,Barbados,52,1,2,3,"(10.886611,-74.776708)"
2015,Abril,Costa de Marfil,384,0,1,1,"(10.445761,-75.516429)"
2016,Febrero,Italia,380,49,205,254,"(6.171601,-75.427454)"
2014,Diciembre,Guatemala,320,4,10,14,"(10.886611,-74.776708)"
2020,Enero,Botsuana,72,0,2,2,"(4.697144,-74.140516)"
2018,Agosto,Nicaragua,558,2,1,3,"(7.128456,-73.183637)"
2015,Mayo,Rumania,642,1,1,2,"(11.360009,-72.129330)"
2017,Agosto,Cuba,192,212,482,694,"(4.697144,-74.140516)"
2012,Febrero,Dominica,212,4,4,8,"(4.697144,-74.140516)"
2013,Julio,Perú,604,0,2,2,"(7.128456,-73.183637)"
2016,Abril,Serbia,688,5,17,22,"(4.697144,-74.140516)"
2014,Noviembre,Polonia,616,11,7,18,"(10.445761,-75.516429)"
2018,Abril,Bulgaria,100,3,3,6,"(3.541112,-76.384584)"
2012,Enero,Alemania,276,0,2,2,"(7.128456,-73.183637)"
2017,Abril,Guatemala,320,1,2,3,"(11.360009,-72.129330)"
2020,Marzo,Filipinas,608,0,1,1,"(3.541112,-76.384584)"
2018,Junio,Burundi,108,0,2,2,"(4.697144,-74.140516)"
2012,Enero,Líbano,422,1,0,1,"(10.445761,-75.516429)"
2018,Septiembre,Sudáfrica,710,2,5,7,"(3.541112,-76.384584)"
2018,Septiembre,Estonia,233,12,9,21,"(4.697144,-74.140516)"
2023,Enero,Guatemala,320,1,1,2,"(7.916725,-72.462544)"
2013,Diciembre,Japón,392,4,8,12,"(10.445761,-75.516429)"
2022,Agosto,Dinamarca,208,4,25,29,"(6.171601,-75.427454)"
2023,Mayo,China,156,1,0,1,"(11.117806,-74.232622)"
2014,Septiembre,Nicaragua,558,0,2,2,"(10.886611,-74.776708)"
2013,Julio,Isla de Man,833,24,32,56,"(0.814836,-77.662532)"
2013,Diciembre,Bolivia,68,21,22,43,"(6.171601,-75.427454)"
2022,Agosto,Uruguay,858,35,17,52,"(12.586067,-81.702563)"
2019,Noviembre,Nigeria,566,1,2,3,"(10.445761,-75.516429)"
2016,Febrero,España,724,184,417,601,"(6.171601,-75.427454)"
2016,Septiembre,Surinam,740,0,1,1,"(0.814836,-77.662532)"
2022,Noviembre,Uzbekistán,860,1,0,1,"(6.171601,-75.427454)"
2015,Julio,Argentina,32,3,0,3,"(8.635765,-77.346578)"
2020,Octubre,Honduras,340,0,2,2,"(3.893038,-77.067921)"
2019,Julio,Macedonia,807,0,1,1,"(10.445761,-75.516429)"
2021,Marzo,Australia,36,7,36,43,"(4.697144,-74.140516)"
2016,Diciembre,Venezuela,862,415,579,994,"(6.185799,-67.483929)"
2014,Abril,Suecia,752,10,19,29,"(10.408582,-75.538003)"
2021,Junio,México,484,38,70,108,"(3.541112,-76.384584)"
2018,Marzo,Noruega,578,1,2,3,"(-4.197703,-69.941278)"
2015,Agosto,Uruguay,858,1,1,2,"(10.408582,-75.538003)"
2012,Enero,Haití,332,0,7,7,"(6.171601,-75.427454)"
2014,Junio,Honduras,340,0,2,2,"(13.3387613,-81.372937)"
2014,Agosto,Federación de Rusia,643,1,1,2,"(4.815061,-75.736532)"
2021,Agosto,Sudáfrica,710,0,1,1,"(4.815061,-75.736532)"
2012,Marzo,Ecuador,218,1048,1554,2602,"(0.814836,-77.662532)"
2014,Agosto,Eslovenia,705,0,2,2,"(3.541112,-76.384584)"
2015,Mayo,Azerbaiyán,31,3,3,6,"(4.697144,-74.140516)"
2014,Enero,Hungría,348,0,1,1,"(10.886611,-74.776708)"
2021,Noviembre,Nigeria,566,0,1,1,"(3.541112,-76.384584)"
2018,Enero,Francia,250,2845,3781,6626,"(4.697144,-74.140516)"
2019,Agosto,Kuwait,414,1,1,2,"(6.171601,-75.427454)"
2022,Julio,Malasia,458,1,0,1,"(7.927209,-72.507910)"
2018,Noviembre,Ecuador,218,0,1,1,"(-4.197703,-69.941278)"
2016,Enero,República Checa,203,4,1,5,"(10.445761,-75.516429)"
2019,Julio,Brasil,76,1,0,1,"(7.128456,-73.183637)"
2017,Junio,Barbados,52,0,1,1,"(6.171601,-75.427454)"
2020,Diciembre,Israel,376,0,5,5,"(3.541112,-76.384584)"
2018,Marzo,El Salvador,222,0,3,3,"(7.818934,-72.453226)"
2022,Febrero,Bosnia y Herzegovina,70,0,1,1,"(10.445761,-75.516429)"
2018,Noviembre,Perú,604,35,25,60,"(10.408582,-75.538003)"
2012,Febrero,Alemania,276,1,1,2,"(12.5744111,-81.703935)"
2015,Octubre,Marruecos,504,0,1,1,"(0.814836,-77.662532)"
2016,Julio,Ucrania,804,0,1,1,"(3.541112,-76.384584)"
2013,Diciembre,Chile,152,1,2,3,"(7.088729,-70.740253)"
2017,Diciembre,Costa Rica,188,1466,1587,3053,"(4.697144,-74.140516)"
2018,Diciembre,Rumania,642,0,1,1,"(0.814836,-77.662532)"
2020,Septiembre,Egipto,818,11,18,29,"(4.697144,-74.140516)"
2021,Mayo,Venezuela,862,4,3,7,"(3.866713,-67.927521)"
2021,Agosto,Belice,84,1,0,1,"(10.445761,-75.516429)"
2018,Noviembre,Perú,604,6,14,20,"(11.360009,-72.129330)"
2014,Noviembre,Uruguay,858,129,321,450,"(4.697144,-74.140516)"
2016,Diciembre,Estados Unidos de América,840,2,1,3,"(8.36068,-72.409396)"
2018,Julio,Kenia,404,0,1,1,"(10.408582,-75.538003)"
2014,Junio,Argentina,32,0,1,1,"(11.247723,-74.213989)"
2023,Mayo,Kazajistán,398,0,1,1,"(3.541112,-76.384584)"
2022,Octubre,Federación de Rusia,643,2,1,3,"(4.815061,-75.736532)"
2021,Septiembre,Uruguay,858,7,9,16,"(10.445761,-75.516429)"
2018,Noviembre,Sudáfrica,710,1,3,4,"(10.886611,-74.776708)"
2012,Mayo,Japón,392,3,24,27,"(6.171601,-75.427454)"
2019,Abril,Argentina,32,1,0,1,"(7.128456,-73.183637)"
2021,Agosto,Portugal,620,4,3,7,"(7.916725,-72.462544)"
2013,Mayo,Suiza,756,0,1,1,"(7.128456,-73.183637)"
2015,Diciembre,Estados Unidos de América,840,2,17,19,"(12.5744111,-81.703935)"
2018,Febrero,Turquía,792,0,1,1,"(8.635765,-77.346578)"
2018,Abril,Ecuador,218,61,109,170,"(6.171601,-75.427454)"
2015,Julio,Polonia,616,8,5,13,"(0.814836,-77.662532)"
2019,Julio,Australia,36,10,16,26,"(10.886611,-74.776708)"
2013,Diciembre,Perú,604,217,417,634,"(0.814836,-77.662532)"
2019,Octubre,Georgia,268,1,0,1,"(3.541112,-76.384584)"
2018,Abril,República Dominicana,214,634,654,1288,"(4.697144,-74.140516)"
2019,Octubre,Japón,392,0,1,1,"(8.36068,-72.409396)"
2015,Abril,Granada,308,1,3,4,"(4.697144,-74.140516)"
2018,Enero,Israel,376,0,2,2,"(-4.223468,-69.945098)"
2016,Febrero,Trinidad y Tobago,780,4,6,10,"(10.445761,-75.516429)"
2015,Octubre,República de Irlanda,372,6,15,21,"(10.445761,-75.516429)"
2012,Mayo,Guatemala,320,22,67,89,"(6.171601,-75.427454)"
2023,Enero,Alemania,276,4,8,12,"(8.364293,-72.405710)"
2019,Febrero,Federación de Rusia,643,0,2,2,"(9.402978,-75.681599)"
2016,Agosto,Sudán,736,0,1,1,"(7.128456,-73.183637)"
2021,Enero,Eslovenia,705,0,2,2,"(10.408582,-75.538003)"
2022,Junio,Canadá,124,5,3,8,"(12.586067,-81.702563)"
2023,Marzo,México,484,0,1,1,"(8.635765,-77.346578)"
2018,Febrero,Líbano,422,2,3,5,"(6.171601,-75.427454)"
2013,Agosto,Rumania,642,0,1,1,"(0.814836,-77.662532)"
2022,Agosto,República Checa,203,1,2,3,"(10.408582,-75.538003)"
2017,Junio,Senegal,686,1,0,1,"(4.697144,-74.140516)"
2017,Abril,República Dominicana,214,4,5,9,"(0.814836,-77.662532)"
2019,Febrero,Perú,604,7,9,16,"(8.36068,-72.409396)"
2015,Enero,Reino Unido de Gran Bretaña e Irlanda del Norte,826,13,12,25,"(8.635765,-77.346578)"
2017,Febrero,Reino Unido de Gran Bretaña e Irlanda del Norte,826,0,3,3,"(4.815061,-75.736532)"
2017,Octubre,Perú,604,0,2,2,"(3.866713,-67.927521)"
2018,Noviembre,Países Bajos,528,0,2,2,"(8.36068,-72.409396)"
2019,Mayo,Venezuela,862,9,20,29,"(4.815061,-75.736532)"
2022,Septiembre,Mozambique,508,4,7,11,"(4.697144,-74.140516)"
2019,Marzo,República Dominicana,214,1,6,7,"(11.360009,-72.129330)"
2019,Junio,Letonia,428,1,0,1,"(3.541112,-76.384584)"
2013,Junio,España,724,0,1,1,"(0.25129,-76.875963)"
2014,Abril,Filipinas,608,1,16,17,"(10.886611,-74.776708)"
2015,Agosto,Estados Unidos de América,840,567,1000,1567,"(10.886611,-74.776708)"
2022,Octubre,España,724,2,5,7,"(7.088729,-70.740253)"
2013,Agosto,Francia,250,0,1,1,"(7.088729,-70.740253)"
2012,Noviembre,Costa Rica,188,1,0,1,"(-4.197703,-69.941278)"
2019,Junio,Argentina,32,3,5,8,"(7.818934,-72.453226)"
2014,Octubre,Líbano,422,13,24,37,"(4.697144,-74.140516)"
2022,Noviembre,Bélgica,56,2,6,8,"(10.886611,-74.776708)"
2012,Noviembre,Dominica,212,0,1,1,"(11.360009,-72.129330)"
2016,Octubre,República de Corea,410,2,8,10,"(3.541112,-76.384584)"
2019,Enero,El Salvador,222,0,1,1,"(12.586067,-81.702563)"
2023,Marzo,Guatemala,320,275,447,722,"(6.171601,-75.427454)"
2018,Noviembre,Barbados,52,2,2,4,"(12.586067,-81.702563)"
2023,Febrero,Portugal,620,1,3,4,"(7.088729,-70.740253)"
2021,Noviembre,República Checa,203,4,12,16,"(6.171601,-75.427454)"
2014,Junio,Ecuador,218,0,1,1,"(4.452882,-75.766298)"
2021,Enero,Letonia,428,0,1,1,"(10.886611,-74.776708)"
2012,Abril,Estados Unidos de América,840,65,123,188,"(4.452882,-75.766298)"
2014,Abril,España,724,1,2,3,"(7.088729,-70.740253)"
2014,Septiembre,Argentina,32,8,12,20,"(11.360009,-72.129330)"
2015,Junio,Australia,36,1,1,2,"(4.815061,-75.736532)"
2021,Marzo,Costa Rica,188,8,4,12,"(4.815061,-75.736532)"
2014,Noviembre,Japón,392,111,505,616,"(4.697144,-74.140516)"
2023,Abril,República Democrática del Congo,180,0,1,1,"(8.364293,-72.405710)"
2019,Diciembre,Reino Unido de Gran Bretaña e Irlanda del Norte,826,172,269,441,"(10.445761,-75.516429)"
2019,Agosto,Panamá,591,8,8,16,"(7.102626,-77.762647)"
2021,Octubre,Estados Unidos de América,840,3,7,10,"(11.360009,-72.129330)"
2022,Abril,Alemania,276,25,38,63,"(10.408582,-75.538003)"
2021,Noviembre,Georgia,268,0,1,1,"(6.171601,-75.427454)"
2012,Septiembre,México,484,1,5,6,"(7.927209,-72.507910)"
2023,Febrero,República de Corea,410,15,28,43,"(6.171601,-75.427454)"
2013,Septiembre,Italia,380,26,99,125,"(6.171601,-75.427454)"
2016,Noviembre,Ecuador,218,0,1,1,"(7.128456,-73.183637)"
2017,Octubre,Bolivia,68,12,8,20,"(10.408582,-75.538003)"
2018,Junio,Belice,84,0,1,1,"(12.586067,-81.702563)"
2018,Agosto,Dinamarca,208,0,1,1,"(7.128456,-73.183637)"
2014,Diciembre,Noruega,578,2,4,6,"(10.408582,-75.538003)"
2018,Agosto,India,356,12,51,63,"(10.445761,-75.516429)"
2014,Agosto,Australia,36,7,11,18,"(-4.197703,-69.941278)"
2015,Agosto,Finlandia,246,2,3,5,"(6.171601,-75.427454)"
2021,Octubre,Hungría,348,1,1,2,"(0.814836,-77.662532)"
2019,Agosto,Indonesia,360,0,2,2,"(10.445761,-75.516429)"
2022,Junio,Filipinas,608,5,14,19,"(3.541112,-76.384584)"
2013,Julio,República Dominicana,214,1,1,2,"(7.128456,-73.183637)"
2018,Octubre,Paraguay,600,8,28,36,"(3.541112,-76.384584)"
2015,Octubre,Croacia,191,0,6,6,"(1.813928,-78.763924)"
2013,Agosto,Perú,604,13,12,25,"(-4.197703,-69.941278)"
2020,Marzo,Bolivia,68,1,1,2,"(10.408582,-75.538003)"
2016,Diciembre,Bolivia,68,13,13,26,"(10.408582,-75.538003)"
2015,Febrero,Bermudas/Territorio Británico de Ultramar,60,0,2,2,"(6.171601,-75.427454)"
2013,Enero,Bolivia,68,16,19,35,"(10.445761,-75.516429)"
2019,Octubre,Guatemala,320,0,1,1,"(7.128456,-73.183637)"
2018,Diciembre,Suecia,752,2,1,3,"(8.635765,-77.346578)"
2019,Abril,Bolivia,68,0,1,1,"(7.818934,-72.453226)"
2023,Mayo,Haití,332,15,26,41,"(4.697144,-74.140516)"
2013,Junio,Suiza,756,2,3,5,"(7.818934,-72.453226)"
2019,Octubre,Bahamas,44,1,3,4,"(3.541112,-76.384584)"
2014,Abril,Myanmar,104,0,1,1,"(3.893038,-77.067921)"
2012,Julio,Reino Unido de Gran Bretaña e Irlanda del Norte,826,10,10,20,"(0.814836,-77.662532)"
2016,Diciembre,Japón,392,11,14,25,"(10.445761,-75.516429)"
2014,Febrero,Italia,380,5,5,10,"(8.635765,-77.346578)"
2019,Julio,Cuba,192,1,2,3,"(10.408582,-75.538003)"
2017,Agosto,Ucrania,804,0,7,7,"(10.408582,-75.538003)"
2017,Octubre,Ecuador,218,98,406,504,"(0.25129,-76.875963)"
2016,Febrero,China,156,0,1,1,"(11.360009,-72.129330)"
2013,Agosto,Chile,152,32,31,63,"(12.586067,-81.702563)"
2022,Septiembre,República Dominicana,214,1096,1096,2192,"(6.171601,-75.427454)"
2012,Julio,Hungría,348,0,3,3,"(6.171601,-75.427454)"
2014,Agosto,Guyana,328,0,1,1,"(11.247723,-74.213989)"
2015,Septiembre,República Dominicana,214,62,114,176,"(6.171601,-75.427454)"
2015,Septiembre,Bahamas,44,0,1,1,"(3.541112,-76.384584)"
2019,Febrero,Irán,364,0,2,2,"(6.171601,-75.427454)"
2020,Enero,Noruega,578,0,1,1,"(12.586067,-81.702563)"
2017,Octubre,Maldivas,462,1,0,1,"(4.697144,-74.140516)"
2013,Mayo,Estados Unidos de América,840,1,7,8,"(10.408582,-75.538003)"
2017,Octubre,Argentina,32,0,1,1,"(6.185799,-67.483929)"
2014,Mayo,Portugal,620,5,10,15,"(10.445761,-75.516429)"
2014,Noviembre,Paraguay,600,5,2,7,"(10.886611,-74.776708)"
2023,Marzo,Islas Caimán/Territorio Británico de Ultramar,136,0,1,1,"(12.586067,-81.702563)"
2021,Julio,Países Bajos,528,749,1071,1820,"(4.697144,-74.140516)"
2015,Diciembre,Ecuador,218,2892,4218,7110,"(0.814836,-77.662532)"
2016,Junio,República de Corea,410,1,1,2,"(0.25129,-76.875963)"
2014,Junio,Grecia,300,2,2,4,"(6.171601,-75.427454)"
2022,Abril,Federación de Rusia,643,1,1,2,"(10.886611,-74.776708)"
2013,Enero,Sudáfrica,710,1,0,1,"(-4.197703,-69.941278)"
2023,Enero,Nigeria,566,0,1,1,"(6.171601,-75.427454)"
2019,Diciembre,Granada,308,0,1,1,"(10.886611,-74.776708)"
2013,Marzo,República Checa,203,0,1,1,"(11.360009,-72.129330)"
2021,Enero,Brasil,76,22,30,52,"(3.541112,-76.384584)"
2012,Junio,Malta,470,1,0,1,"(3.541112,-76.384584)"
2019,Agosto,República Checa,203,10,13,23,"(6.171601,-75.427454)"
2014,Agosto,Benín,204,0,1,1,"(10.445761,-75.516429)"
2023,Marzo,Bulgaria,100,0,3,3,"(10.971302,-74.765397)"
2014,Noviembre,Dominica,212,1,1,2,"(3.541112,-76.384584)"
2014,Enero,Guatemala,320,2,3,5,"(12.586067,-81.702563)"
2016,Noviembre,Estados Unidos de América,840,1,0,1,"(0.25129,-76.875963)"
2012,Febrero,Serbia,688,7,7,14,"(4.697144,-74.140516)"
2023,Enero,Suecia,752,235,380,618,"(4.697144,-74.140516)"
2014,Diciembre,Reino Unido de Gran Bretaña e Irlanda del Norte,826,0,1,1,"(7.088729,-70.740253)"
2017,Noviembre,Trinidad y Tobago,780,1,0,1,"(7.128456,-73.183637)"
2015,Junio,República Dominicana,214,19,70,89,"(10.445761,-75.516429)"
2015,Noviembre,Taiwán,158,0,1,1,"(7.927209,-72.507910)"
2014,Agosto,Aruba,533,1,0,1,"(4.697144,-74.140516)"
2016,Noviembre,Estados Unidos de América,840,2321,3736,6057,"(10.445761,-75.516429)"
2019,Mayo,Alemania,276,51,89,140,"(3.541112,-76.384584)"
2016,Diciembre,Dinamarca,208,13,24,37,"(6.171601,-75.427454)"
2023,Marzo,Sierra Leona,694,2,1,3,"(4.697144,-74.140516)"
2017,Abril,Marruecos,504,1,0,1,"(6.171601,-75.427454)"
2017,Octubre,Bolivia,68,606,681,1287,"(4.697144,-74.140516)"
2023,Abril,Hungría,348,0,1,1,"(7.927209,-72.507910)"
2018,Noviembre,Filipinas,608,5,92,97,"(10.408582,-75.538003)"
2014,Abril,Filipinas,608,0,34,34,"(10.408582,-75.538003)"
2012,Septiembre,Uruguay,858,131,370,501,"(4.697144,-74.140516)"
2018,Agosto,Rumania,642,0,2,2,"(3.893038,-77.067921)"
2013,Diciembre,República Dominicana,214,1,10,11,"(0.814836,-77.662532)"
2020,Marzo,Ecuador,218,1865,2054,3919,"(4.697144,-74.140516)"
2014,Julio,Islas Salomón,90,1,0,1,"(4.697144,-74.140516)"
2015,Julio,Canadá,124,5,7,12,"(8.635765,-77.346578)"
2022,Marzo,República Del Congo,178,0,2,2,"(4.697144,-74.140516)"
2014,Noviembre,Mozambique,508,0,1,1,"(4.697144,-74.140516)"
2023,Enero,Filipinas,608,0,1,1,"(12.165168,-71.983761)"
2012,Junio,República de Moldavia,498,1,0,1,"(6.171601,-75.427454)"
2017,Noviembre,Finlandia,246,1,2,3,"(10.408582,-75.538003)"
2023,Junio,Perú,604,0,2,2,"(-0.193180,-74.784874)"
2022,Noviembre,Países Bajos,528,7,24,31,"(0.814836,-77.662532)"
2019,Septiembre,Cuba,192,0,1,1,"(4.452882,-75.766298)"
2018,Noviembre,Estados Unidos de América,840,142,216,358,"(4.452882,-75.766298)"
2014,Septiembre,Turquía,792,0,2,2,"(7.818934,-72.453226)"
2016,Septiembre,Panamá,591,1,0,1,"(0.25129,-76.875963)"
2015,Marzo,China,156,0,1,1,"(11.360009,-72.129330)"
2017,Mayo,Italia,380,4,11,15,"(7.818934,-72.453226)"
2012,Abril,República de Irlanda,372,2,11,13,"(6.171601,-75.427454)"
2018,Febrero,Italia,380,7,26,33,"(10.886611,-74.776708)"
2016,Julio,Filipinas,608,31,89,120,"(4.697144,-74.140516)"
2015,Septiembre,Guyana,328,0,1,1,"(8.635765,-77.346578)"
2018,Diciembre,Italia,380,0,2,2,"(11.117806,-74.232622)"
2013,Marzo,Nigeria,566,1,0,1,"(10.408582,-75.538003)"
2013,Julio,Turquía,792,0,1,1,"(10.408582,-75.538003)"
2018,Noviembre,Noruega,578,162,211,373,"(4.697144,-74.140516)"
2018,Mayo,Costa Rica,188,2,2,4,"(0.814836,-77.662532)"
2019,Marzo,Nigeria,566,1,2,3,"(10.445761,-75.516429)"
2014,Marzo,Austria,40,3,3,6,"(-4.197703,-69.941278)"
2016,Noviembre,Turquía,792,1,4,5,"(0.814836,-77.662532)"
2023,Marzo,España,724,581,856,1437,"(6.171601,-75.427454)"
2022,Junio,Albania,8,5,4,9,"(6.171601,-75.427454)"
2016,Septiembre,Chile,152,1,3,4,"(0.25129,-76.875963)"
2012,Septiembre,El Salvador,222,0,2,2,"(0.814836,-77.662532)"
2015,Septiembre,Chile,152,1,1,2,"(7.927209,-72.507910)"
2022,Abril,Filipinas,608,20,204,224,"(10.408582,-75.538003)"
2018,Noviembre,Hungría,348,10,19,29,"(10.445761,-75.516429)"
2018,Julio,Turquía,792,7,20,27,"(6.171601,-75.427454)"
2019,Abril,Hungría,348,2,1,3,"(10.408582,-75.538003)"
2013,Marzo,Panamá,591,5,12,17,"(7.128456,-73.183637)"
2012,Diciembre,Turquía,792,1,0,1,"(0.814836,-77.662532)"
2022,Febrero,Australia,36,78,202,280,"(4.697144,-74.140516)"
2018,Febrero,Croacia,191,1,10,11,"(10.445761,-75.516429)"
2016,Febrero,Uganda,800,0,1,1,"(10.445761,-75.516429)"
2018,Agosto,Noruega,578,56,114,170,"(4.697144,-74.140516)"
2020,Febrero,India,356,0,2,2,"(12.586067,-81.702563)"
2022,Junio,Polonia,616,0,1,1,"(4.452882,-75.766298)"
2022,Agosto,Guatemala,320,2,0,2,"(7.818934,-72.453226)"
2018,Agosto,Singapur,702,1,0,1,"(10.408582,-75.538003)"
2019,Abril,República de Irlanda,372,8,7,15,"(8.635765,-77.346578)"
2015,Marzo,Francia,250,0,3,3,"(0.25129,-76.875963)"
2022,Abril,Eslovaquia,703,10,8,18,"(6.171601,-75.427454)"
2023,Abril,Perú,604,2,0,2,"(-0.193180,-74.784874)"
2022,Junio,Dominica,212,0,2,2,"(6.171601,-75.427454)"
2016,Enero,El Salvador,222,101,106,207,"(3.541112,-76.384584)"
2019,Diciembre,Polonia,616,0,1,1,"(8.635765,-77.346578)"
2012,Octubre,Brasil,76,0,3,3,"(7.927209,-72.507910)"
2020,Febrero,España,724,1,7,8,"(8.36068,-72.409396)"
2013,Febrero,Noruega,578,3,2,5,"(0.814836,-77.662532)"
2018,Julio,Polonia,616,0,1,1,"(8.36068,-72.409396)"
2016,Enero,Omán,512,0,1,1,"(4.697144,-74.140516)"
2016,Diciembre,Brasil,76,8,10,18,"(7.818934,-72.453226)"
2023,Marzo,República de Tayikistán,762,1,0,1,"(6.171601,-75.427454)"
2013,Enero,Austria,40,13,17,30,"(0.814836,-77.662532)"
2016,Julio,Tailandia,764,4,3,7,"(6.171601,-75.427454)"
2013,Septiembre,Brasil,76,68,51,119,"(10.408582,-75.538003)"
2014,Enero,Suecia,752,1,3,4,"(11.360009,-72.129330)"
2016,Abril,Kenia,404,0,1,1,"(0.25129,-76.875963)"
2023,Marzo,República Árabe Siria,760,0,1,1,"(10.445761,-75.516429)"
2019,Diciembre,Venezuela,862,1119,885,2004,"(8.36068,-72.409396)"
2015,Marzo,Reino Unido de Gran Bretaña e Irlanda del Norte,826,69,123,192,"(10.445761,-75.516429)"
2022,Abril,Perú,604,0,3,3,"(10.408582,-75.538003)"
2015,Junio,Trinidad y Tobago,780,3,25,28,"(10.445761,-75.516429)"
2012,Noviembre,Italia,380,24,74,98,"(3.541112,-76.384584)"
2023,Abril,Países Bajos,528,4,1,5,"(7.916725,-72.462544)"
2018,Diciembre,Sri Lanka,144,0,1,1,"(0.814836,-77.662532)"
2012,Diciembre,Israel,376,2,4,6,"(0.814836,-77.662532)"
2017,Julio,Bahréin,48,1,4,5,"(4.697144,-74.140516)"
2022,Julio,Perú,604,6,9,15,"(4.452882,-75.766298)"
2013,Enero,Ecuador,218,6,13,19,"(10.445761,-75.516429)"
2021,Junio,Ecuador,218,0,1,1,"(11.360009,-72.129330)"
2013,Diciembre,Nepal,524,0,1,1,"(10.408582,-75.538003)"
2018,Julio,Polonia,616,0,2,2,"(10.971302,-74.765397)"
2021,Mayo,Kenia,404,1,0,1,"(4.697144,-74.140516)"
2023,Marzo,Venezuela,862,253,255,508,"(7.088729,-70.740253)"
2017,Diciembre,República de Corea,410,4,27,31,"(10.445761,-75.516429)"
2016,Marzo,Hong Kong,344,1,1,2,"(4.697144,-74.140516)"
2014,Julio,Argentina,32,0,3,3,"(-4.223468,-69.945098)"
2021,Septiembre,Canadá,124,31,84,115,"(10.445761,-75.516429)"
2019,Septiembre,Polonia,616,0,2,2,"(-4.197703,-69.941278)"
2022,Junio,Canadá,124,45,66,111,"(10.886611,-74.776708)"
2014,Diciembre,Hungría,348,1,0,1,"(10.408582,-75.538003)"
2012,Septiembre,Nueva Zelanda,554,0,1,1,"(-4.197703,-69.941278)"
2015,Octubre,Noruega,578,6,8,14,"(10.445761,-75.516429)"
2014,Septiembre,Kenia,404,0,2,2,"(6.171601,-75.427454)"
2015,Julio,Dinamarca,208,0,1,1,"(11.360009,-72.129330)"
2022,Junio,Italia,380,0,2,2,"(9.402978,-75.681599)"
2022,Agosto,Paraguay,600,0,1,1,"(7.818934,-72.453226)"
2015,Junio,Filipinas,608,2,17,19,"(10.408582,-75.538003)"
2015,Abril,Costa Rica,188,1,2,3,"(11.360009,-72.129330)"
2013,Julio,Líbano,422,16,23,39,"(4.697144,-74.140516)"
2012,Julio,Islandia,352,0,1,1,"(10.445761,-75.516429)"
2021,Diciembre,Turquía,792,1,5,6,"(10.886611,-74.776708)"
2019,Junio,Singapur,702,2,0,2,"(6.171601,-75.427454)"
2018,Agosto,Cuba,192,14,20,34,"(3.541112,-76.384584)"
2016,Julio,Barbados,52,1,0,1,"(10.445761,-75.516429)"
2023,Enero,China,156,2,0,2,"(-4.223468,-69.945098)"
2019,Noviembre,Venezuela,862,20,13,33,"(7.128456,-73.183637)"
2022,Enero,España,724,2,5,7,"(7.128456,-73.183637)"
2016,Septiembre,Cuba,192,0,1,1,"(7.927209,-72.507910)"
2012,Enero,República Dominicana,214,0,1,1,"(7.088729,-70.740253)"
2018,Enero,Cuba,192,1,2,3,"(7.128456,-73.183637)"
2019,Diciembre,República de Corea,410,0,3,3,"(10.886611,-74.776708)"
2021,Agosto,Reino Unido de Gran Bretaña e Irlanda del Norte,826,1,4,5,"(10.886611,-74.776708)"
2019,Agosto,Jamaica,388,32,51,83,"(4.697144,-74.140516)"
2017,Noviembre,Portugal,620,23,35,58,"(6.171601,-75.427454)"
2017,Marzo,Brasil,76,5093,6341,11434,"(4.697144,-74.140516)"
2018,Diciembre,Guatemala,320,0,1,1,"(7.818934,-72.453226)"
2017,Septiembre,Perú,604,0,1,1,"(7.927209,-72.507910)"
2019,Marzo,San  Vicente y las Granadinas,670,1,0,1,"(3.541112,-76.384584)"
2019,Julio,Mauricio,480,0,1,1,"(3.541112,-76.384584)"
2022,Septiembre,República Dominicana,214,7,8,15,"(0.814836,-77.662532)"
2012,Febrero,Países Bajos,528,16,31,47,"(11.528919,-72.919681)"
2012,Junio,Puerto Rico/Territorio de Estados Unidos,630,1,3,4,"(3.541112,-76.384584)"
2018,Junio,Venezuela,862,45,53,98,"(0.25129,-76.875963)"
2023,Febrero,Finlandia,246,1,1,2,"(10.886611,-74.776708)"
2016,Diciembre,El Salvador,222,1,0,1,"(0.25129,-76.875963)"
2016,Febrero,Montenegro,499,0,1,1,"(10.408582,-75.538003)"
2018,Mayo,Portugal,620,173,426,599,"(4.697144,-74.140516)"
2022,Diciembre,China,156,0,1,1,"(10.971302,-74.765397)"
2020,Marzo,Ecuador,218,44,111,155,"(0.25129,-76.875963)"
2016,Marzo,Malí,466,2,5,7,"(4.697144,-74.140516)"
2016,Abril,Polonia,616,0,1,1,"(1.813928,-78.763924)"
2022,Abril,Indonesia,360,0,1,1,"(0.814836,-77.662532)"
2014,Enero,Austria,40,4,5,9,"(10.408582,-75.538003)"
2018,Enero,Indonesia,360,16,24,40,"(4.697144,-74.140516)"
2014,Mayo,Luxemburgo,442,0,1,1,"(10.886611,-74.776708)"
2017,Junio,Rumania,642,45,70,115,"(4.697144,-74.140516)"
2022,Diciembre,Estados Unidos de América,840,19,10,29,"(7.916725,-72.462544)"
2016,Septiembre,Israel,376,126,500,626,"(4.697144,-74.140516)"
2022,Septiembre,Portugal,620,3,2,5,"(7.088729,-70.740253)"
2012,Enero,Países Bajos,528,122,198,320,"(4.697144,-74.140516)"
2022,Marzo,Antigua y Barbuda,28,0,1,1,"(6.171601,-75.427454)"
2018,Diciembre,Portugal,620,18,36,54,"(10.445761,-75.516429)"
2013,Abril,Ecuador,218,714,765,1479,"(6.171601,-75.427454)"
2012,Junio,República Dominicana,214,2,6,8,"(0.814836,-77.662532)"
2014,Mayo,Japón,392,21,26,47,"(0.814836,-77.662532)"
2017,Julio,República de Corea,410,9,34,43,"(6.171601,-75.427454)"
2016,Junio,Albania,8,0,2,2,"(4.697144,-74.140516)"
2018,Diciembre,Guatemala,320,1,0,1,"(8.36068,-72.409396)"
2015,Enero,Bolivia,68,0,2,2,"(11.360009,-72.129330)"
2013,Octubre,Ecuador,218,1444,2111,3555,"(0.814836,-77.662532)"
2016,Junio,Trinidad y Tobago,780,2,4,6,"(3.541112,-76.384584)"
2018,Junio,Canadá,124,0,1,1,"(8.36068,-72.409396)"
2017,Septiembre,Ecuador,218,75,109,184,"(6.171601,-75.427454)"
2013,Abril,Antigua y Barbuda,28,0,1,1,"(10.886611,-74.776708)"
2014,Febrero,Nicaragua,558,0,1,1,"(8.635765,-77.346578)"
2014,Octubre,Desconocido,99999,1,2,3,"(3.541112,-76.384584)"
2014,Agosto,Finlandia,246,41,67,108,"(4.697144,-74.140516)"
2018,Diciembre,Eslovaquia,703,0,2,2,"(10.408582,-75.538003)"
2015,Junio,Suiza,756,4,0,4,"(8.635765,-77.346578)"
2013,Octubre,Indonesia,360,0,8,8,"(3.893038,-77.067921)"
2022,Julio,México,484,0,5,5,"(12.5744111,-81.703935)"
2013,Octubre,Venezuela,862,0,1,1,"(10.971302,-74.765397)"
2014,Julio,Nueva Zelanda,554,7,12,19,"(10.408582,-75.538003)"
2023,Abril,Alemania,276,20,28,48,"(10.886611,-74.776708)"
2018,Diciembre,Reino Unido de Gran Bretaña e Irlanda del Norte,826,153,308,461,"(6.171601,-75.427454)"
2021,Enero,República Árabe de Yemen,887,0,1,1,"(4.697144,-74.140516)"
2012,Junio,Mauritania,478,0,1,1,"(4.697144,-74.140516)"
2014,Septiembre,Argentina,32,2789,4322,7111,"(4.697144,-74.140516)"
2018,Julio,Panamá,591,3,43,46,"(10.408582,-75.538003)"
2017,Agosto,Líbano,422,2,1,3,"(3.541112,-76.384584)"
2016,Julio,Estados Unidos de América,840,14,12,26,"(8.635765,-77.346578)"
2021,Mayo,Estados Unidos de América,840,2403,4478,6881,"(10.445761,-75.516429)"
2014,Noviembre,Suiza,756,1,3,4,"(4.815061,-75.736532)"
2013,Noviembre,Argentina,32,12,37,49,"(7.818934,-72.453226)"
2013,Septiembre,Guyana,328,0,1,1,"(3.541112,-76.384584)"
2015,Septiembre,Federación de Rusia,643,3,10,13,"(10.445761,-75.516429)"
2017,Enero,Noruega,578,2,5,7,"(10.408582,-75.538003)"
2019,Abril,Tailandia,764,2,0,2,"(3.541112,-76.384584)"
2012,Enero,República de Irlanda,372,0,3,3,"(11.360009,-72.129330)"
2019,Enero,Federación de Rusia,643,0,1,1,"(8.635765,-77.346578)"
2018,Agosto,Haití,332,1,0,1,"(10.886611,-74.776708)"
2015,Enero,Jamaica,388,5,2,7,"(3.541112,-76.384584)"
2019,Enero,Alemania,276,1,0,1,"(-0.193180,-74.784874)"
2012,Noviembre,Canadá,124,15,22,37,"(0.814836,-77.662532)"
2017,Marzo,República Checa,203,1,1,2,"(-4.197703,-69.941278)"
2018,Julio,Trinidad y Tobago,780,0,1,1,"(7.818934,-72.453226)"
2015,Junio,Mozambique,508,0,1,1,"(4.697144,-74.140516)"
2012,Enero,México,484,2,2,4,"(8.635765,-77.346578)"
2022,Octubre,Ucrania,804,1,4,5,"(10.886611,-74.776708)"
2013,Octubre,Sudáfrica,710,1,5,6,"(10.445761,-75.516429)"
2020,Enero,Venezuela,862,771,717,1488,"(10.445761,-75.516429)"
2013,Agosto,Puerto Rico/Territorio de Estados Unidos,630,1,1,2,"(10.445761,-75.516429)"
2014,Febrero,Suiza,756,35,25,60,"(0.814836,-77.662532)"
2017,Enero,Austria,40,177,294,471,"(4.697144,-74.140516)"
2017,Enero,Nigeria,566,5,7,12,"(4.697144,-74.140516)"
2016,Noviembre,Montenegro,499,1,1,2,"(4.697144,-74.140516)"
2022,Julio,Chile,152,2,2,4,"(4.452882,-75.766298)"
2022,Marzo,Vietnam,704,0,7,7,"(3.893038,-77.067921)"
2012,Diciembre,Nueva Zelanda,554,43,81,124,"(4.697144,-74.140516)"
2022,Julio,República de Kosovo,901,1,0,1,"(4.697144,-74.140516)"
2018,Abril,Venezuela,862,11,10,21,"(3.866713,-67.927521)"
2014,Octubre,Cuba,192,0,1,1,"(1.813928,-78.763924)"
2013,Abril,Libia,434,1,0,1,"(4.697144,-74.140516)"
2016,Junio,Islas Caimán/Territorio Británico de Ultramar,136,0,1,1,"(12.586067,-81.702563)"
2019,Marzo,India,356,2,15,17,"(10.408582,-75.538003)"
2012,Septiembre,Bolivia,68,16,32,48,"(10.445761,-75.516429)"
2023,Marzo,Chipre,196,1,4,5,"(6.171601,-75.427454)"
2022,Abril,Brasil,76,1,3,4,"(4.452882,-75.766298)"
2015,Noviembre,Alemania,276,1,5,6,"(4.815061,-75.736532)"
2018,Febrero,Guatemala,320,124,182,306,"(10.445761,-75.516429)"
2022,Enero,Panamá,591,30,58,88,"(7.927209,-72.507910)"
2019,Mayo,Uzbekistán,860,0,2,2,"(6.171601,-75.427454)"
2023,Marzo,Alemania,276,0,2,2,"(13.3387613,-81.372937)"
2023,Abril,Italia,380,3,2,5,"(12.586067,-81.702563)"
2018,Mayo,Brasil,76,0,2,2,"(7.128456,-73.183637)"
2018,Octubre,Paraguay,600,1,0,1,"(7.088729,-70.740253)"
2013,Febrero,Panamá,591,1,2,3,"(0.814836,-77.662532)"
2017,Enero,Ecuador,218,73,122,195,"(7.818934,-72.453226)"
2023,Junio,Países Bajos,528,314,307,621,"(10.445761,-75.516429)"
2020,Enero,Pakistán,586,3,20,23,"(4.697144,-74.140516)"
2021,Junio,Austria,40,5,7,12,"(6.171601,-75.427454)"
2013,Agosto,Suecia,752,7,7,14,"(3.541112,-76.384584)"
2021,Diciembre,Turquía,792,0,4,4,"(3.893038,-77.067921)"
2014,Julio,Guatemala,320,0,1,1,"(11.360009,-72.129330)"
2022,Agosto,España,724,12,11,23,"(7.927209,-72.507910)"
2017,Abril,Turquía,792,3,5,8,"(0.814836,-77.662532)"
2021,Diciembre,República de Corea,410,9,15,24,"(6.171601,-75.427454)"
2017,Mayo,Italia,380,1,2,3,"(-4.197703,-69.941278)"
2013,Diciembre,Italia,380,2,13,15,"(10.408582,-75.538003)"
2017,Septiembre,Chile,152,43,31,74,"(12.586067,-81.702563)"
2018,Marzo,Brasil,76,6,10,16,"(7.818934,-72.453226)"
2014,Diciembre,Bermudas/Territorio Británico de Ultramar,60,0,1,1,"(3.541112,-76.384584)"
2018,Abril,Canadá,124,5,12,17,"(4.815061,-75.736532)"
2019,Mayo,Australia,36,0,1,1,"(7.128456,-73.183637)"
2013,Octubre,Eslovaquia,703,1,0,1,"(3.541112,-76.384584)"
2015,Octubre,Francia,250,1,1,2,"(12.5744111,-81.703935)"
2022,Julio,Rumania,642,0,1,1,"(4.452882,-75.766298)"
2016,Junio,Venezuela,862,35,72,107,"(3.541112,-76.384584)"
2021,Julio,Afganistán,4,0,2,2,"(4.697144,-74.140516)"
2018,Marzo,Rumania,642,1,8,9,"(10.408582,-75.538003)"
2014,Abril,Finlandia,246,2,6,8,"(3.541112,-76.384584)"
2018,Septiembre,Trinidad y Tobago,780,7,14,21,"(10.445761,-75.516429)"
2019,Junio,Qatar,634,1,2,3,"(4.697144,-74.140516)"
2023,Junio,Costa Rica,188,11,11,22,"(11.117806,-74.232622)"
2012,Febrero,El Salvador,222,7,8,15,"(10.886611,-74.776708)"
2021,Octubre,Chile,152,2063,2580,4643,"(4.697144,-74.140516)"
2022,Abril,Noruega,578,0,1,1,"(0.25129,-76.875963)"
2016,Mayo,Cuba,192,2,5,7,"(0.814836,-77.662532)"
2014,Septiembre,República Dominicana,214,13,27,40,"(10.886611,-74.776708)"
2017,Diciembre,Francia,250,6,3,9,"(11.247723,-74.213989)"
2016,Mayo,Brasil,76,1,2,3,"(13.3387613,-81.372937)"
2019,Enero,Bangladesh,50,0,2,2,"(4.697144,-74.140516)"
2019,Febrero,Estonia,233,37,65,102,"(4.697144,-74.140516)"
2020,Enero,Panamá,591,66,72,138,"(12.586067,-81.702563)"
2022,Junio,Singapur,702,0,1,1,"(3.541112,-76.384584)"
2019,Octubre,Grecia,300,27,84,111,"(4.697144,-74.140516)"
2015,Enero,Panamá,591,3,7,10,"(7.927209,-72.507910)"
2014,Junio,República de Irlanda,372,5,8,13,"(8.635765,-77.346578)"
2018,Agosto,Brasil,76,3,3,6,"(11.360009,-72.129330)"
2022,Agosto,Sudán,736,0,1,1,"(4.697144,-74.140516)"
2017,Abril,Suiza,756,6,8,14,"(8.635765,-77.346578)"
2016,Abril,Portugal,620,7,18,25,"(10.445761,-75.516429)"
2013,Diciembre,El Salvador,222,61,101,162,"(3.541112,-76.384584)"
2015,Septiembre,Arabia Saudita,682,0,3,3,"(10.445761,-75.516429)"
2022,Abril,Antigua y Barbuda,28,1,1,2,"(10.445761,-75.516429)"
2021,Marzo,Argentina,32,0,1,1,"(10.408582,-75.538003)"
2019,Julio,Botsuana,72,2,2,4,"(4.697144,-74.140516)"
2021,Octubre,Canadá,124,542,1188,1730,"(4.697144,-74.140516)"
2019,Octubre,China,156,0,1,1,"(3.893038,-77.067921)"
2016,Junio,Líbano,422,2,0,2,"(3.541112,-76.384584)"
2022,Diciembre,Sri Lanka,144,0,1,1,"(10.971302,-74.765397)"
2017,Septiembre,Egipto,818,2,0,2,"(10.445761,-75.516429)"
2015,Abril,Brasil,76,341,268,609,"(12.586067,-81.702563)"
2023,Febrero,Alemania,276,245,312,557,"(10.445761,-75.516429)"
2012,Abril,Nicaragua,558,1,0,1,"(4.815061,-75.736532)"
2021,Septiembre,Chile,152,14,72,86,"(10.886611,-74.776708)"
2017,Junio,Honduras,340,10,11,21,"(10.886611,-74.776708)"
2019,Mayo,Luxemburgo,442,0,1,1,"(10.445761,-75.516429)"
2018,Noviembre,República Checa,203,5,10,15,"(6.171601,-75.427454)"
2022,Abril,Francia,250,16,23,39,"(10.408582,-75.538003)"
2022,Febrero,Vietnam,704,2,4,6,"(4.697144,-74.140516)"
2015,Agosto,Canadá,124,6,10,16,"(8.635765,-77.346578)"
2018,Diciembre,Reino Unido de Gran Bretaña e Irlanda del Norte,826,21,25,46,"(11.247723,-74.213989)"
2013,Abril,Chipre,196,0,6,6,"(4.697144,-74.140516)"
2022,Enero,Guatemala,320,0,4,4,"(4.452882,-75.766298)"
2020,Febrero,Italia,380,1,1,2,"(1.813928,-78.763924)"
2015,Febrero,Chile,152,13,25,38,"(7.818934,-72.453226)"
2016,Marzo,Italia,380,12,27,39,"(10.886611,-74.776708)"
2014,Marzo,República Dominicana,214,24,37,61,"(3.541112,-76.384584)"
2018,Febrero,Camerún,120,0,1,1,"(6.171601,-75.427454)"
2022,Diciembre,Ecuador,218,83,61,144,"(1.813928,-78.763924)"
2015,Noviembre,Kazajistán,398,0,1,1,"(10.886611,-74.776708)"
2012,Septiembre,República de Corea,410,2,2,4,"(0.814836,-77.662532)"
2015,Octubre,República de Belarús,112,0,1,1,"(6.171601,-75.427454)"
2019,Febrero,Guyana,328,1,0,1,"(10.886611,-74.776708)"
2019,Diciembre,Brasil,76,42,46,88,"(3.541112,-76.384584)"
2018,Mayo,Francia,250,112,158,270,"(10.445761,-75.516429)"
2016,Julio,Uruguay,858,14,28,42,"(3.541112,-76.384584)"
2014,Noviembre,República Árabe de Yemen,887,0,1,1,"(6.171601,-75.427454)"
2016,Septiembre,Líbano,422,0,2,2,"(10.445761,-75.516429)"
2017,Diciembre,Venezuela,862,1,0,1,"(8.635765,-77.346578)"
2019,Julio,Bolivia,68,29,32,61,"(3.541112,-76.384584)"
2013,Mayo,República Dominicana,214,15,22,37,"(3.541112,-76.384584)"
2016,Noviembre,Panamá,591,2448,2183,4631,"(4.697144,-74.140516)"
2017,Diciembre,China,156,0,1,1,"(7.128456,-73.183637)"
2018,Marzo,Taiwán,158,2,1,3,"(7.818934,-72.453226)"
2015,Enero,Países Bajos,528,686,1118,1804,"(4.697144,-74.140516)"
2013,Octubre,Zambia,894,0,1,1,"(4.697144,-74.140516)"
2018,Agosto,Polonia,616,0,7,7,"(10.408582,-75.538003)"
2022,Diciembre,Bosnia y Herzegovina,70,4,7,11,"(4.697144,-74.140516)"
2014,Diciembre,Sri Lanka,144,0,1,1,"(4.697144,-74.140516)"
2019,Marzo,Australia,36,5,13,18,"(10.408582,-75.538003)"
2015,Septiembre,Paraguay,600,38,56,94,"(3.541112,-76.384584)"
2017,Junio,Madagascar,450,4,0,4,"(4.697144,-74.140516)"
2015,Noviembre,Trinidad y Tobago,780,8,12,20,"(6.171601,-75.427454)"
2022,Mayo,Francia,250,0,1,1,"(7.102626,-77.762647)"
2017,Julio,Finlandia,246,43,62,105,"(4.697144,-74.140516)"
2016,Enero,Suecia,752,16,13,29,"(0.814836,-77.662532)"
2018,Diciembre,España,724,0,2,2,"(4.452882,-75.766298)"
2017,Febrero,Desconocido,99999,0,1,1,"(3.893038,-77.067921)"
2014,Octubre,Honduras,340,20,22,42,"(3.541112,-76.384584)"
2017,Noviembre,Perú,604,248,314,562,"(3.541112,-76.384584)"
2018,Diciembre,Estonia,233,2,4,6,"(6.171601,-75.427454)"
2018,Diciembre,Suecia,752,1,2,3,"(7.128456,-73.183637)"
2014,Diciembre,Reino Unido de Gran Bretaña e Irlanda del Norte,826,3,8,11,"(-4.197703,-69.941278)"
2013,Agosto,España,724,2,7,9,"(0.814836,-77.662532)"
2012,Abril,Austria,40,6,6,12,"(3.541112,-76.384584)"
2020,Enero,Países Bajos,528,15,18,33,"(11.528919,-72.919681)"
2012,Agosto,Isla de Man,833,8,43,51,"(6.171601,-75.427454)"
2023,Marzo,Bélgica,56,2,1,3,"(11.117806,-74.232622)"
2019,Marzo,Hungría,348,0,1,1,"(11.360009,-72.129330)"
2019,Julio,República Checa,203,89,89,178,"(4.697144,-74.140516)"
2016,Marzo,Venezuela,862,1,2,3,"(-4.197703,-69.941278)"
2016,Diciembre,Bélgica,56,13,27,40,"(3.541112,-76.384584)"
2017,Mayo,Ecuador,218,28,15,43,"(10.408582,-75.538003)"
2020,Diciembre,Tailandia,764,4,1,5,"(4.697144,-74.140516)"
2020,Julio,Suiza,756,0,1,1,"(10.886611,-74.776708)"
2012,Julio,Tanzania,834,0,2,2,"(4.697144,-74.140516)"
2013,Marzo,Nueva Zelanda,554,0,2,2,"(7.818934,-72.453226)"
2023,Mayo,Lituania,440,3,8,11,"(6.171601,-75.427454)"
2022,Septiembre,México,484,7,3,10,"(-4.197703,-69.941278)"
2019,Julio,China,156,5,1,6,"(12.586067,-81.702563)"
2022,Septiembre,Luxemburgo,442,9,5,14,"(4.697144,-74.140516)"
2013,Marzo,Honduras,340,1,0,1,"(0.814836,-77.662532)"
2022,Agosto,España,724,387,510,897,"(10.445761,-75.516429)"
2022,Octubre,Estonia,233,0,2,2,"(3.541112,-76.384584)"
2018,Abril,Georgia,268,1,1,2,"(10.445761,-75.516429)"
2019,Marzo,Canadá,124,269,234,503,"(12.586067,-81.702563)"
2013,Octubre,Estonia,233,2,7,9,"(4.697144,-74.140516)"
2012,Julio,Jamaica,388,2,3,5,"(12.586067,-81.702563)"
2022,Noviembre,Tailandia,764,24,17,41,"(4.697144,-74.140516)"
2016,Octubre,España,724,9,8,17,"(12.586067,-81.702563)"
2014,Julio,El Salvador,222,3,11,14,"(10.445761,-75.516429)"
2023,Mayo,Italia,380,21,38,59,"(10.886611,-74.776708)"
2015,Junio,Austria,40,0,2,2,"(10.886611,-74.776708)"
2014,Octubre,Federación de Rusia,643,11,20,31,"(10.445761,-75.516429)"
2015,Abril,Eslovaquia,703,2,2,4,"(10.445761,-75.516429)"
2016,Septiembre,Chipre,196,1,0,1,"(3.541112,-76.384584)"
2018,Septiembre,Nicaragua,558,17,44,61,"(6.171601,-75.427454)"
2015,Enero,Austria,40,130,248,378,"(4.697144,-74.140516)"
2012,Febrero,Chile,152,136,97,233,"(10.445761,-75.516429)"
2014,Diciembre,Malasia,458,1,0,1,"(0.814836,-77.662532)"
2018,Diciembre,Trinidad y Tobago,780,1,1,2,"(11.247723,-74.213989)"
2019,Junio,Argentina,32,209,150,359,"(12.586067,-81.702563)"
2014,Junio,Federación de Rusia,643,0,3,3,"(11.247723,-74.213989)"
2021,Octubre,Suecia,752,0,2,2,"(4.815061,-75.736532)"
2022,Mayo,México,484,9,19,28,"(0.814836,-77.662532)"
2015,Agosto,Argentina,32,5,6,11,"(7.128456,-73.183637)"
2021,Diciembre,Islas Turcas y Caicos/Territorio Británico de Ultramar,796,0,2,2,"(10.445761,-75.516429)"
2019,Mayo,Austria,40,9,32,41,"(6.171601,-75.427454)"
2015,Febrero,Paraguay,600,7,4,11,"(3.541112,-76.384584)"
2017,Diciembre,República Árabe de Yemen,887,0,3,3,"(4.697144,-74.140516)"
2019,Julio,India,356,101,435,538,"(4.697144,-74.140516)"
2018,Agosto,Venezuela,862,34,33,67,"(6.185799,-67.483929)"
2019,Agosto,Costa Rica,188,17,22,39,"(10.886611,-74.776708)"
2021,Julio,Argentina,32,422,614,1036,"(4.697144,-74.140516)"
2022,Abril,República de Belarús,112,0,1,1,"(10.445761,-75.516429)"
2018,Enero,República de Corea,410,3,2,5,"(3.541112,-76.384584)"
2022,Julio,Paraguay,600,220,202,422,"(4.697144,-74.140516)"
2020,Diciembre,Ghana,288,0,1,1,"(4.452882,-75.766298)"
2015,Diciembre,Bélgica,56,0,1,1,"(10.971302,-74.765397)"
2021,Marzo,Ecuador,218,1101,1342,2443,"(4.697144,-74.140516)"
2022,Julio,Grecia,300,46,93,139,"(4.697144,-74.140516)"
2017,Marzo,Alemania,276,3,1,4,"(7.128456,-73.183637)"
2016,Enero,Brasil,76,7,8,15,"(4.815061,-75.736532)"
2016,Junio,República de Irlanda,372,10,13,23,"(0.814836,-77.662532)"
2023,Marzo,Irán,364,4,17,21,"(4.697144,-74.140516)"
2013,Julio,Qatar,634,0,2,2,"(3.541112,-76.384584)"
2020,Febrero,India,356,90,442,534,"(4.697144,-74.140516)"
2018,Septiembre,Nicaragua,558,0,2,2,"(7.128456,-73.183637)"
2014,Diciembre,España,724,172,439,611,"(6.171601,-75.427454)"
2018,Mayo,Argentina,32,3,6,9,"(-4.197703,-69.941278)"
2023,Febrero,China,156,1,0,1,"(7.128456,-73.183637)"
2013,Mayo,Singapur,702,6,11,17,"(4.697144,-74.140516)"
2017,Diciembre,Islandia,352,3,1,4,"(10.445761,-75.516429)"
2014,Abril,España,724,1,1,2,"(12.5744111,-81.703935)"
2019,Junio,Desconocido,99999,5,4,9,"(10.445761,-75.516429)"
2017,Enero,Honduras,340,1,4,5,"(4.815061,-75.736532)"
2014,Septiembre,Ecuador,218,371,445,816,"(6.171601,-75.427454)"
2012,Mayo,Bahamas,44,0,4,4,"(3.541112,-76.384584)"
2017,Septiembre,México,484,15,19,34,"(10.408582,-75.538003)"
2012,Marzo,Bolivia,68,259,411,670,"(4.697144,-74.140516)"
2017,Febrero,Brasil,76,40,41,81,"(10.886611,-74.776708)"
2021,Agosto,Andorra,20,4,4,8,"(4.697144,-74.140516)"
2018,Abril,Países Bajos,528,1,4,5,"(11.360009,-72.129330)"
2012,Diciembre,Antigua y Barbuda,28,0,1,1,"(4.697144,-74.140516)"
2022,Julio,Portugal,620,35,31,66,"(10.445761,-75.516429)"
2015,Octubre,Venezuela,862,1620,1959,3579,"(7.818934,-72.453226)"
2019,Enero,Venezuela,862,299,348,647,"(3.541112,-76.384584)"
2015,Julio,Dominica,212,2,1,3,"(3.541112,-76.384584)"
2016,Mayo,Estados Unidos de América,840,2306,5339,7645,"(6.171601,-75.427454)"
2014,Enero,Portugal,620,146,398,544,"(4.697144,-74.140516)"
2017,Agosto,Argentina,32,68,84,152,"(3.541112,-76.384584)"
2015,Agosto,Myanmar,104,1,3,4,"(4.697144,-74.140516)"
2020,Enero,Rumania,642,0,2,2,"(6.185799,-67.483929)"
2019,Octubre,Cuba,192,1,3,4,"(0.814836,-77.662532)"
2018,Febrero,Hong Kong,344,0,4,4,"(0.814836,-77.662532)"
2014,Octubre,Kazajistán,398,1,0,1,"(6.171601,-75.427454)"
2016,Junio,Costa Rica,188,3,0,3,"(4.815061,-75.736532)"
2019,Mayo,Afganistán,4,0,1,1,"(6.171601,-75.427454)"
2012,Enero,Ucrania,804,0,1,1,"(3.893038,-77.067921)"
2014,Marzo,Guyana,328,4,4,8,"(4.697144,-74.140516)"
2019,Diciembre,Mónaco,492,4,1,5,"(6.171601,-75.427454)"
2021,Junio,Venezuela,862,420,418,838,"(6.171601,-75.427454)"
2017,Diciembre,Finlandia,246,22,21,43,"(10.445761,-75.516429)"
2016,Mayo,Suecia,752,1,0,1,"(4.452882,-75.766298)"
2022,Octubre,Hong Kong,344,13,18,31,"(4.697144,-74.140516)"
2014,Mayo,Eslovaquia,703,2,0,2,"(10.445761,-75.516429)"
2013,Noviembre,Argentina,32,107,251,358,"(6.171601,-75.427454)"
2018,Junio,Francia,250,32,42,74,"(10.886611,-74.776708)"
2012,Julio,Italia,380,6,22,28,"(7.818934,-72.453226)"
2020,Noviembre,Costa Rica,188,1,2,3,"(7.128456,-73.183637)"
2017,Diciembre,Singapur,702,20,30,50,"(4.697144,-74.140516)"
2018,Octubre,Francia,250,0,1,1,"(9.402978,-75.681599)"
2017,Agosto,Irán,364,13,22,35,"(4.697144,-74.140516)"
2015,Julio,Australia,36,280,444,724,"(4.697144,-74.140516)"
2017,Junio,Alemania,276,1,2,3,"(4.815061,-75.736532)"
2019,Enero,Francia,250,0,1,1,"(11.360009,-72.129330)"
2016,Noviembre,Bélgica,56,1,5,6,"(10.886611,-74.776708)"
2016,Noviembre,Cuba,192,0,1,1,"(10.408582,-75.538003)"
2021,Febrero,México,484,37,71,108,"(10.445761,-75.516429)"
2013,Enero,Hungría,348,4,1,5,"(10.445761,-75.516429)"
2021,Febrero,Haití,332,14,16,30,"(4.697144,-74.140516)"
2013,Septiembre,República Checa,203,1,1,2,"(3.541112,-76.384584)"
2012,Agosto,Perú,604,0,1,1,"(3.893038,-77.067921)"
2019,Noviembre,Chile,152,0,1,1,"(4.452882,-75.766298)"
2018,Junio,Hungría,348,0,2,2,"(-4.223468,-69.945098)"
2020,Febrero,El Salvador,222,0,1,1,"(7.128456,-73.183637)"
2013,Marzo,Alemania,276,8,18,26,"(7.818934,-72.453226)"
2019,Julio,Cuba,192,0,3,3,"(0.814836,-77.662532)"
2014,Julio,República Checa,203,2,1,3,"(0.814836,-77.662532)"
2015,Agosto,Noruega,578,1,5,6,"(10.886611,-74.776708)"
2021,Diciembre,Iraq,368,1,0,1,"(3.541112,-76.384584)"
2014,Abril,Indonesia,360,7,6,13,"(6.171601,-75.427454)"
2021,Septiembre,Turkmenistán,795,0,1,1,"(0.814836,-77.662532)"
2017,Octubre,Estados Unidos de América,840,24,29,53,"(12.586067,-81.702563)"
2020,Enero,Venezuela,862,26,21,47,"(0.25129,-76.875963)"
2019,Marzo,Uruguay,858,70,105,175,"(6.171601,-75.427454)"
2014,Marzo,Bulgaria,100,19,14,33,"(4.697144,-74.140516)"
2013,Julio,Países Bajos,528,2,0,2,"(12.586067,-81.702563)"
2023,Febrero,Venezuela,862,21,23,44,"(11.117806,-74.232622)"
2017,Enero,Argentina,32,151,239,390,"(6.171601,-75.427454)"
2016,Agosto,Uganda,800,0,1,1,"(3.541112,-76.384584)"
2012,Octubre,Australia,36,14,21,35,"(3.541112,-76.384584)"
2017,Julio,Dinamarca,208,1,10,11,"(3.541112,-76.384584)"
2015,Abril,Nicaragua,558,51,76,127,"(4.697144,-74.140516)"
2020,Diciembre,México,484,0,1,1,"(12.586067,-81.702563)"
2023,Mayo,Ecuador,218,1041,972,2013,"(6.171601,-75.427454)"
2022,Mayo,Irán,364,0,1,1,"(10.886611,-74.776708)"
2023,Abril,Portugal,620,13,23,36,"(7.818934,-72.453226)"
2016,Septiembre,Hungría,348,0,2,2,"(10.886611,-74.776708)"
2020,Enero,Honduras,340,0,2,2,"(9.402978,-75.681599)"
2012,Abril,España,724,8,12,20,"(11.360009,-72.129330)"
2013,Noviembre,México,484,12,25,37,"(0.814836,-77.662532)"
2017,Junio,España,724,0,3,3,"(0.25129,-76.875963)"
2017,Agosto,Venezuela,862,5,8,13,"(12.586067,-81.702563)"
2012,Octubre,Austria,40,4,1,5,"(0.814836,-77.662532)"
2023,Febrero,Guatemala,320,152,230,382,"(6.171601,-75.427454)"
2014,Junio,Sudáfrica,710,1,3,4,"(6.171601,-75.427454)"
2016,Enero,Myanmar,104,0,1,1,"(4.697144,-74.140516)"
2019,Noviembre,Argentina,32,167,292,459,"(6.171601,-75.427454)"
2016,Enero,Federación de Rusia,643,1,0,1,"(0.25129,-76.875963)"
2020,Febrero,Costa Rica,188,5,10,15,"(4.815061,-75.736532)"
2019,Agosto,Austria,40,6,7,13,"(3.541112,-76.384584)"
2022,Julio,Cuba,192,0,1,1,"(7.128456,-73.183637)"
2012,Enero,Haití,332,2,1,3,"(10.445761,-75.516429)"
2017,Enero,Taiwán,158,50,65,115,"(4.697144,-74.140516)"
2022,Abril,Argentina,32,17,24,41,"(4.452882,-75.766298)"
2015,Enero,Federación de Rusia,643,0,2,2,"(-4.197703,-69.941278)"
2019,Febrero,Nicaragua,558,88,107,195,"(4.697144,-74.140516)"
2022,Junio,Turquía,792,7,12,19,"(10.445761,-75.516429)"
2020,Marzo,Austria,40,1,1,2,"(-4.223468,-69.945098)"
2022,Noviembre,Filipinas,608,8,9,17,"(6.171601,-75.427454)"
2014,Abril,Sri Lanka,144,0,1,1,"(3.893038,-77.067921)"
2019,Septiembre,Panamá,591,86,83,169,"(12.586067,-81.702563)"
2016,Noviembre,Reino Unido de Gran Bretaña e Irlanda del Norte,826,1,0,1,"(7.128456,-73.183637)"
2019,Marzo,Brasil,76,20,102,122,"(10.886611,-74.776708)"
2015,Abril,España,724,3,6,9,"(7.927209,-72.507910)"
2022,Agosto,Ucrania,804,21,13,34,"(6.171601,-75.427454)"
2014,Marzo,Venezuela,862,871,1317,2188,"(7.818934,-72.453226)"
2019,Enero,Rwanda,646,0,1,1,"(4.697144,-74.140516)"
2018,Abril,República Checa,203,0,2,2,"(-4.223468,-69.945098)"
2014,Diciembre,República de Corea,410,6,11,17,"(10.445761,-75.516429)"
2021,Julio,Alemania,276,1,1,2,"(7.818934,-72.453226)"
2015,Septiembre,República Dominicana,214,1,9,10,"(7.128456,-73.183637)"
2016,Enero,Desconocido,99999,0,1,1,"(3.541112,-76.384584)"
2018,Noviembre,Trinidad y Tobago,780,6,0,6,"(12.586067,-81.702563)"
2013,Noviembre,Reino Unido de Gran Bretaña e Irlanda del Norte,826,2,2,4,"(10.408582,-75.538003)"
2019,Septiembre,Israel,376,30,145,175,"(6.171601,-75.427454)"
2022,Febrero,Ecuador,218,1,4,5,"(8.36068,-72.409396)"
2019,Octubre,Filipinas,608,4,47,51,"(10.408582,-75.538003)"
2016,Septiembre,Paraguay,600,19,42,61,"(3.541112,-76.384584)"
2021,Agosto,Australia,36,2,5,7,"(3.541112,-76.384584)"
2023,Junio,España,724,15,27,42,"(8.364293,-72.405710)"
2012,Septiembre,Panamá,591,3,8,11,"(8.635765,-77.346578)"
2017,Octubre,India,356,0,3,3,"(4.815061,-75.736532)"
2021,Octubre,Japón,392,1,0,1,"(12.5744111,-81.703935)"
2021,Junio,Egipto,818,1,0,1,"(3.541112,-76.384584)"
2017,Enero,Bélgica,56,0,1,1,"(12.586067,-81.702563)"
2022,Marzo,Chile,152,50,61,111,"(10.445761,-75.516429)"
2014,Enero,República de Corea,410,2,3,5,"(10.445761,-75.516429)"
2023,Junio,Turquía,792,0,22,22,"(3.893038,-77.067921)"
2014,Septiembre,Malasia,458,0,2,2,"(10.408582,-75.538003)"
2012,Julio,República Democrática del Congo,180,1,1,2,"(4.697144,-74.140516)"
2016,Enero,Indonesia,360,1,1,2,"(10.886611,-74.776708)"
2015,Abril,Guatemala,320,233,529,762,"(4.697144,-74.140516)"
2015,Julio,Paraguay,600,1,2,3,"(0.814836,-77.662532)"
2019,Octubre,Myanmar,104,0,9,9,"(10.971302,-74.765397)"
2018,Diciembre,Australia,36,0,1,1,"(-4.197703,-69.941278)"
2020,Enero,Liechtenstein,438,3,4,7,"(4.697144,-74.140516)"
2019,Julio,Finlandia,246,0,1,1,"(4.815061,-75.736532)"
2014,Julio,Canadá,124,9,14,23,"(10.408582,-75.538003)"
2015,Noviembre,Chile,152,5,4,9,"(8.635765,-77.346578)"
2020,Agosto,Finlandia,246,0,1,1,"(4.697144,-74.140516)"
2015,Enero,Eslovaquia,703,0,6,6,"(3.541112,-76.384584)"
2015,Abril,Australia,36,1,1,2,"(0.25129,-76.875963)"
2012,Septiembre,Suiza,756,1,3,4,"(10.886611,-74.776708)"
2019,Julio,Níger,562,0,1,1,"(4.697144,-74.140516)"
2020,Febrero,Mauricio,480,0,2,2,"(10.445761,-75.516429)"
2012,Julio,Trinidad y Tobago,780,17,25,42,"(6.171601,-75.427454)"
2017,Diciembre,México,484,0,1,1,"(8.36068,-72.409396)"
2014,Mayo,Túnez,788,0,1,1,"(3.541112,-76.384584)"
2014,Octubre,Alemania,276,7,9,16,"(-4.197703,-69.941278)"
2014,Febrero,Eslovaquia,703,14,17,31,"(4.697144,-74.140516)"
2020,Diciembre,Países Bajos,528,4,3,7,"(7.128456,-73.183637)"
2013,Febrero,Cuba,192,1,0,1,"(12.586067,-81.702563)"
2017,Julio,Perú,604,1,1,2,"(-0.193180,-74.784874)"
2023,Mayo,Jamaica,388,1,0,1,"(7.128456,-73.183637)"
2013,Marzo,República de Corea,410,0,1,1,"(8.635765,-77.346578)"
2015,Junio,Marruecos,504,14,8,22,"(4.697144,-74.140516)"
2015,Agosto,Chile,152,11,21,32,"(10.886611,-74.776708)"
2019,Marzo,México,484,0,2,2,"(-4.197703,-69.941278)"
2015,Septiembre,Costa Rica,188,721,1092,1813,"(4.697144,-74.140516)"
2012,Mayo,Taiwán,158,2,1,3,"(10.445761,-75.516429)"
2012,Septiembre,Ghana,288,0,1,1,"(7.818934,-72.453226)"
2015,Agosto,Granada,308,1,4,5,"(4.697144,-74.140516)"
2014,Junio,Guatemala,320,2,4,6,"(0.814836,-77.662532)"
2015,Octubre,Bélgica,56,0,1,1,"(7.128456,-73.183637)"
2019,Junio,Estados Unidos de América,840,287,358,645,"(4.452882,-75.766298)"
2021,Julio,Australia,36,2,19,21,"(6.171601,-75.427454)"
2012,Diciembre,Dinamarca,208,62,131,193,"(4.697144,-74.140516)"
2017,Febrero,Nicaragua,558,0,10,10,"(10.408582,-75.538003)"
2021,Febrero,Perú,604,542,804,1346,"(4.697144,-74.140516)"
2016,Agosto,Malta,470,0,1,1,"(0.814836,-77.662532)"
2012,Diciembre,Turquía,792,0,1,1,"(8.635765,-77.346578)"
2022,Junio,Nicaragua,558,0,1,1,"(0.25129,-76.875963)"
2014,Diciembre,Federación de Rusia,643,13,3,16,"(0.814836,-77.662532)"
2017,Noviembre,Israel,376,4,30,34,"(10.445761,-75.516429)"
2013,Marzo,México,484,4,15,19,"(4.815061,-75.736532)"
2018,Septiembre,Palestina,99999,1,1,2,"(6.171601,-75.427454)"
2019,Enero,Italia,380,2,8,10,"(11.117806,-74.232622)"
2017,Marzo,Bolivia,68,9,13,22,"(0.814836,-77.662532)"
2012,Junio,Sri Lanka,144,1,0,1,"(10.445761,-75.516429)"
2014,Mayo,China,156,0,24,24,"(10.408582,-75.538003)"
2018,Mayo,Bélgica,56,0,2,2,"(7.818934,-72.453226)"
2017,Noviembre,San Cristóbal y Nevis,659,4,9,13,"(4.697144,-74.140516)"
2012,Agosto,Alemania,276,41,59,100,"(3.541112,-76.384584)"
2022,Mayo,Brasil,76,130,123,253,"(-4.197703,-69.941278)"
2022,Junio,Nueva Zelanda,554,0,1,1,"(4.815061,-75.736532)"
2014,Julio,Japón,392,7,27,34,"(6.171601,-75.427454)"
2019,Mayo,Federación de Rusia,643,1,9,10,"(10.408582,-75.538003)"
2020,Enero,San Marino,674,1,0,1,"(4.697144,-74.140516)"
2018,Mayo,Hungría,348,1,0,1,"(10.886611,-74.776708)"
2016,Mayo,Bélgica,56,2,0,2,"(12.586067,-81.702563)"
2020,Enero,Estados Unidos de América,840,15,23,38,"(7.818934,-72.453226)"
2015,Noviembre,República de Corea,410,0,2,2,"(7.927209,-72.507910)"
2017,Septiembre,Australia,36,288,471,759,"(4.697144,-74.140516)"
2018,Diciembre,Cuba,192,22,42,64,"(3.541112,-76.384584)"
2015,Diciembre,Chile,152,1,0,1,"(7.927209,-72.507910)"
2017,Junio,Venezuela,862,240,293,533,"(8.36068,-72.409396)"
2012,Febrero,Letonia,428,0,1,1,"(6.171601,-75.427454)"
2014,Agosto,Indonesia,360,0,1,1,"(10.886611,-74.776708)"
2013,Junio,Ucrania,804,0,3,3,"(0.814836,-77.662532)"
2015,Septiembre,Suecia,752,3,3,6,"(0.814836,-77.662532)"
2016,Diciembre,El Salvador,222,1,1,2,"(4.452882,-75.766298)"
2018,Abril,Estados Unidos de América,840,475,895,1370,"(10.886611,-74.776708)"
2013,Enero,Austria,40,3,8,11,"(10.445761,-75.516429)"
2017,Octubre,Israel,376,13,55,68,"(10.445761,-75.516429)"
2012,Agosto,Venezuela,862,1,9,10,"(4.815061,-75.736532)"
2016,Septiembre,Panamá,591,3,4,7,"(8.635765,-77.346578)"
2017,Julio,Refugiado,99999,2,1,3,"(6.171601,-75.427454)"
2012,Agosto,Dinamarca,208,42,97,139,"(4.697144,-74.140516)"
2015,Abril,Uruguay,858,79,75,154,"(10.445761,-75.516429)"
2020,Enero,Israel,376,0,1,1,"(4.815061,-75.736532)"
2015,Junio,Bélgica,56,1,0,1,"(11.360009,-72.129330)"
2020,Noviembre,Desconocido,99999,2,0,2,"(6.171601,-75.427454)"
2018,Agosto,Estados Unidos de América,840,696,1121,1817,"(10.886611,-74.776708)"
2020,Febrero,Trinidad y Tobago,780,3,3,6,"(7.128456,-73.183637)"
2013,Mayo,Trinidad y Tobago,780,11,35,46,"(4.697144,-74.140516)"
2017,Octubre,Nicaragua,558,0,2,2,"(10.886611,-74.776708)"
2014,Noviembre,Zimbabue,716,2,5,7,"(4.697144,-74.140516)"
2015,Julio,Taiwán,158,4,3,7,"(0.814836,-77.662532)"
2017,Abril,San  Vicente y las Granadinas,670,0,2,2,"(4.697144,-74.140516)"
2014,Febrero,Ghana,288,5,2,7,"(4.697144,-74.140516)"
2012,Julio,Panamá,591,47,74,121,"(10.886611,-74.776708)"
2017,Diciembre,México,484,22,39,61,"(4.815061,-75.736532)"
2017,Enero,España,724,6,12,18,"(-4.197703,-69.941278)"
2021,Diciembre,Suiza,756,11,17,28,"(10.886611,-74.776708)"
2013,Marzo,Eslovenia,705,9,29,38,"(4.697144,-74.140516)"
2023,Febrero,República de Corea,410,0,4,4,"(1.813928,-78.763924)"
2013,Mayo,Ecuador,218,104,140,244,"(7.818934,-72.453226)"
2018,Noviembre,Nueva Zelanda,554,4,4,8,"(10.408582,-75.538003)"
2015,Septiembre,Dinamarca,208,50,120,170,"(4.697144,-74.140516)"
2012,Marzo,Países Bajos,528,0,1,1,"(10.408582,-75.538003)"
2016,Noviembre,Nigeria,566,0,1,1,"(0.814836,-77.662532)"
2014,Agosto,Costa de Marfil,384,1,4,5,"(4.697144,-74.140516)"
2012,Abril,Dinamarca,208,5,11,16,"(6.171601,-75.427454)"
2013,Agosto,Barbados,52,1,2,3,"(4.697144,-74.140516)"
2017,Enero,España,724,18,51,69,"(10.886611,-74.776708)"
2018,Noviembre,Suecia,752,10,13,23,"(3.541112,-76.384584)"
2022,Febrero,Albania,8,5,27,32,"(4.697144,-74.140516)"
2016,Octubre,Georgia,268,5,6,11,"(4.697144,-74.140516)"
2017,Abril,El Salvador,222,1,0,1,"(4.452882,-75.766298)"
2014,Agosto,Panamá,591,0,5,5,"(8.635765,-77.346578)"
2023,Mayo,Suiza,756,0,1,1,"(7.128456,-73.183637)"
2015,Julio,Países Bajos,528,110,157,267,"(3.541112,-76.384584)"
2016,Noviembre,Mauricio,480,0,1,1,"(10.971302,-74.765397)"
2021,Octubre,Mauritania,478,0,1,1,"(6.171601,-75.427454)"
2018,Julio,Australia,36,34,31,65,"(0.814836,-77.662532)"
2014,Diciembre,Filipinas,608,0,2,2,"(1.813928,-78.763924)"
2015,Noviembre,Finlandia,246,0,1,1,"(4.815061,-75.736532)"
2015,Diciembre,Surinam,740,3,5,8,"(4.697144,-74.140516)"
2022,Marzo,Hong Kong,344,14,11,25,"(4.697144,-74.140516)"
2014,Septiembre,Países Bajos,528,2,4,6,"(8.635765,-77.346578)"
2018,Diciembre,Cuba,192,2,3,5,"(0.814836,-77.662532)"
2013,Octubre,Uruguay,858,148,316,464,"(4.697144,-74.140516)"
2014,Enero,Brasil,76,12,21,33,"(7.818934,-72.453226)"
2020,Enero,Eslovenia,705,25,46,71,"(4.697144,-74.140516)"
2019,Diciembre,Estados Unidos de América,840,1,0,1,"(7.088729,-70.740253)"
2019,Agosto,Dinamarca,208,0,1,1,"(8.635765,-77.346578)"
2018,Octubre,San  Vicente y las Granadinas,670,1,1,2,"(4.697144,-74.140516)"
2014,Marzo,Chile,152,86,193,279,"(6.171601,-75.427454)"
2012,Marzo,Paraguay,600,5,6,11,"(6.171601,-75.427454)"
2013,Abril,Serbia,688,1,0,1,"(0.814836,-77.662532)"
2018,Septiembre,Zimbabue,716,3,4,7,"(4.697144,-74.140516)"
2017,Febrero,Italia,380,2,1,3,"(0.25129,-76.875963)"
2012,Junio,Estados Unidos de América,840,0,1,1,"(11.528919,-72.919681)"
2013,Diciembre,Perú,604,0,1,1,"(4.452882,-75.766298)"
2023,Marzo,Alemania,276,1,1,2,"(4.452882,-75.766298)"
2019,Abril,Islas Caimán/Territorio Británico de Ultramar,136,0,1,1,"(10.886611,-74.776708)"
2015,Octubre,República Checa,203,1,3,4,"(0.814836,-77.662532)"
2014,Diciembre,Túnez,788,0,6,6,"(4.697144,-74.140516)"
2015,Julio,Mónaco,492,0,1,1,"(4.697144,-74.140516)"
2013,Agosto,República Árabe de Yemen,887,1,0,1,"(4.697144,-74.140516)"
2015,Julio,España,724,18,54,72,"(10.886611,-74.776708)"
2016,Diciembre,Israel,376,14,57,71,"(6.171601,-75.427454)"
2020,Febrero,República Dominicana,214,3,3,6,"(7.128456,-73.183637)"
2014,Marzo,Estados Unidos de América,840,0,6,6,"(12.5744111,-81.703935)"
2014,Noviembre,Rumania,642,0,1,1,"(0.814836,-77.662532)"
2016,Septiembre,Islas Caimán/Territorio Británico de Ultramar,136,1,0,1,"(10.886611,-74.776708)"
2014,Agosto,Malta,470,0,1,1,"(4.815061,-75.736532)"
2013,Septiembre,Ucrania,804,0,1,1,"(6.171601,-75.427454)"
2014,Febrero,Ucrania,804,0,1,1,"(6.171601,-75.427454)"
2014,Mayo,Rumania,642,0,1,1,"(10.445761,-75.516429)"
2012,Enero,Honduras,340,1,14,15,"(10.445761,-75.516429)"
2012,Mayo,Brasil,76,0,2,2,"(7.927209,-72.507910)"
2017,Octubre,Bolivia,68,19,17,36,"(12.586067,-81.702563)"
2021,Julio,Egipto,818,4,8,12,"(4.697144,-74.140516)"
2020,Septiembre,Guatemala,320,1,2,3,"(3.541112,-76.384584)"
2019,Marzo,Uganda,800,0,1,1,"(3.541112,-76.384584)"
2018,Mayo,Panamá,591,5,7,12,"(8.635765,-77.346578)"
2012,Agosto,Polonia,616,0,2,2,"(3.541112,-76.384584)"
2017,Octubre,Ecuador,218,0,1,1,"(11.247723,-74.213989)"
2017,Marzo,Turquía,792,0,1,1,"(9.402978,-75.681599)"
2018,Diciembre,Eslovenia,705,0,1,1,"(10.445761,-75.516429)"
2015,Septiembre,República Checa,203,0,1,1,"(-4.197703,-69.941278)"
2022,Febrero,Singapur,702,8,8,16,"(4.697144,-74.140516)"
2023,Mayo,Chipre,196,5,8,13,"(4.697144,-74.140516)"
2022,Enero,Venezuela,862,46,38,84,"(6.185799,-67.483929)"
2015,Julio,República Checa,203,0,1,1,"(10.445761,-75.516429)"
2016,Octubre,Costa Rica,188,1065,1369,2434,"(4.697144,-74.140516)"
2022,Enero,Palestina,99999,2,0,2,"(4.697144,-74.140516)"
2015,Julio,Chile,152,137,109,246,"(10.445761,-75.516429)"
2017,Enero,Turquía,792,0,1,1,"(3.893038,-77.067921)"
2020,Enero,Uruguay,858,0,5,5,"(4.815061,-75.736532)"
2014,Junio,Sudáfrica,710,2,3,5,"(0.814836,-77.662532)"
2019,Noviembre,Suiza,756,3,4,7,"(4.815061,-75.736532)"
2016,Marzo,Alemania,276,118,179,297,"(6.171601,-75.427454)"
2022,Septiembre,Desconocido,99999,0,1,1,"(12.586067,-81.702563)"
2021,Mayo,Hong Kong,344,2,1,3,"(4.697144,-74.140516)"
2016,Agosto,Nicaragua,558,1,4,5,"(7.128456,-73.183637)"
2016,Septiembre,Israel,376,3,10,13,"(3.541112,-76.384584)"
2021,Julio,Chile,152,0,2,2,"(7.128456,-73.183637)"
2020,Febrero,Canadá,124,1963,2353,4316,"(10.445761,-75.516429)"
2012,Agosto,República Dominicana,214,7,3,10,"(7.927209,-72.507910)"
2017,Marzo,República de Belarús,112,1,0,1,"(10.445761,-75.516429)"
2014,Marzo,Egipto,818,4,14,18,"(4.697144,-74.140516)"
2014,Octubre,Suecia,752,96,217,313,"(4.697144,-74.140516)"
2017,Mayo,Argentina,32,6,9,15,"(0.25129,-76.875963)"
2021,Marzo,Australia,36,5,26,31,"(6.171601,-75.427454)"
2021,Enero,Perú,604,5,12,17,"(4.815061,-75.736532)"
2020,Marzo,Albania,8,0,1,1,"(3.541112,-76.384584)"
2018,Febrero,Estados Unidos de América,840,27,39,66,"(12.586067,-81.702563)"
2023,Junio,Ecuador,218,6006,6069,12075,"(4.697144,-74.140516)"
2020,Marzo,Trinidad y Tobago,780,11,28,39,"(4.697144,-74.140516)"
2019,Septiembre,Suecia,752,1,0,1,"(8.635765,-77.346578)"
2019,Febrero,Suecia,752,3,3,6,"(12.586067,-81.702563)"
2018,Agosto,Rumania,642,9,5,14,"(6.171601,-75.427454)"
2017,Abril,Guatemala,320,2,7,9,"(4.815061,-75.736532)"
2018,Agosto,Perú,604,43,31,74,"(-4.197703,-69.941278)"
2020,Diciembre,Reino Unido de Gran Bretaña e Irlanda del Norte,826,0,1,1,"(0.814836,-77.662532)"
2022,Enero,Alemania,276,8,10,18,"(0.814836,-77.662532)"
2019,Septiembre,Albania,8,0,1,1,"(4.815061,-75.736532)"
2022,Enero,Perú,604,1,1,2,"(8.36068,-72.409396)"
2018,Septiembre,Portugal,620,0,2,2,"(8.36068,-72.409396)"
2018,Noviembre,Países Bajos,528,3,2,5,"(-4.223468,-69.945098)"
2023,Mayo,Países Bajos,528,25,17,42,"(10.408582,-75.538003)"
2018,Abril,España,724,6,5,11,"(-4.223468,-69.945098)"
2018,Noviembre,Argentina,32,3300,4441,7741,"(4.697144,-74.140516)"
2014,Mayo,Francia,250,10,15,25,"(-4.197703,-69.941278)"
2015,Mayo,Portugal,620,2,12,14,"(3.541112,-76.384584)"
2019,Julio,Federación de Rusia,643,19,15,34,"(6.171601,-75.427454)"
2013,Abril,República de Belarús,112,0,1,1,"(4.697144,-74.140516)"
2018,Junio,Singapur,702,0,1,1,"(9.402978,-75.681599)"
2020,Diciembre,Cuba,192,6,21,27,"(10.886611,-74.776708)"
2022,Agosto,Nueva Zelanda,554,30,65,95,"(4.697144,-74.140516)"
2021,Julio,Reino Unido de Gran Bretaña e Irlanda del Norte,826,0,1,1,"(11.247723,-74.213989)"
2020,Agosto,Noruega,578,4,7,11,"(4.697144,-74.140516)"
2018,Julio,San  Vicente y las Granadinas,670,7,9,16,"(10.886611,-74.776708)"
2019,Agosto,Uganda,800,1,0,1,"(4.697144,-74.140516)"
2012,Febrero,Territorio Antártico Británico/Territorio Británico de Ultramar,260,1,4,5,"(4.697144,-74.140516)"
2013,Enero,Italia,380,0,1,1,"(3.893038,-77.067921)"
2015,Agosto,Suiza,756,28,53,81,"(6.171601,-75.427454)"
2020,Diciembre,Paraguay,600,57,50,107,"(4.697144,-74.140516)"
2023,Febrero,Singapur,702,0,1,1,"(10.408582,-75.538003)"
2017,Mayo,Japón,392,0,1,1,"(-4.223468,-69.945098)"
2022,Diciembre,Jamaica,388,0,1,1,"(12.5744111,-81.703935)"
2012,Octubre,Suiza,756,1,1,2,"(11.528919,-72.919681)"
2018,Noviembre,Marruecos,504,1,0,1,"(10.886611,-74.776708)"
2013,Noviembre,Ucrania,804,0,1,1,"(10.971302,-74.765397)"
2016,Diciembre,Nigeria,566,0,1,1,"(-4.197703,-69.941278)"
2022,Diciembre,Nicaragua,558,0,1,1,"(0.814836,-77.662532)"
2018,Junio,Costa Rica,188,5,3,8,"(0.814836,-77.662532)"
2019,Junio,Polonia,616,1,3,4,"(8.635765,-77.346578)"
2021,Enero,Perú,604,44,79,123,"(3.541112,-76.384584)"
2020,Diciembre,Estados Unidos de América,840,1,2,3,"(7.818934,-72.453226)"
2014,Junio,Etiopia,231,1,0,1,"(4.697144,-74.140516)"
2014,Septiembre,Venezuela,862,640,723,1363,"(7.927209,-72.507910)"
2013,Junio,Estados Unidos de América,840,1526,1916,3442,"(3.541112,-76.384584)"
2013,Agosto,República Democrática del Congo,180,4,5,9,"(4.697144,-74.140516)"
2015,Febrero,Guatemala,320,3,5,8,"(10.408582,-75.538003)"
2016,Febrero,Federación de Rusia,643,2,1,3,"(10.886611,-74.776708)"
2017,Febrero,Perú,604,175,355,530,"(0.814836,-77.662532)"
2013,Agosto,España,724,148,280,428,"(4.697144,-74.140516)"
2021,Marzo,Argentina,32,0,3,3,"(10.971302,-74.765397)"
2022,Enero,India,356,68,162,231,"(4.697144,-74.140516)"
2022,Julio,Bolivia,68,1,1,2,"(7.927209,-72.507910)"
2019,Febrero,Panamá,591,84,89,173,"(4.815061,-75.736532)"
2016,Julio,Filipinas,608,2,5,7,"(3.541112,-76.384584)"
2020,Octubre,Bahamas,44,1,2,3,"(4.697144,-74.140516)"
2017,Febrero,El Salvador,222,15,17,32,"(10.445761,-75.516429)"
2015,Septiembre,Australia,36,253,403,656,"(4.697144,-74.140516)"
2018,Noviembre,Perú,604,556,869,1425,"(6.171601,-75.427454)"
2017,Noviembre,Paraguay,600,84,55,139,"(12.586067,-81.702563)"
2012,Marzo,Rumania,642,0,1,1,"(7.818934,-72.453226)"
2013,Octubre,Argelia,12,0,1,1,"(0.814836,-77.662532)"
2019,Noviembre,Bolivia,68,1,2,3,"(10.886611,-74.776708)"
2019,Enero,Bolivia,68,0,1,1,"(6.185799,-67.483929)"
2014,Septiembre,Croacia,191,0,1,1,"(10.886611,-74.776708)"
2020,Febrero,Venezuela,862,2,1,3,"(0.812436,-77.847006)"
2015,Septiembre,Zambia,894,5,5,10,"(4.697144,-74.140516)"
2013,Noviembre,Paraguay,600,4,2,6,"(11.360009,-72.129330)"
2021,Enero,Grecia,300,0,5,5,"(6.171601,-75.427454)"
2013,Febrero,Paraguay,600,0,2,2,"(7.818934,-72.453226)"
2018,Enero,Andorra,20,3,11,14,"(4.697144,-74.140516)"
2021,Abril,Estados Unidos de América,840,2,2,4,"(11.247723,-74.213989)"
2015,Diciembre,Guatemala,320,0,1,1,"(4.452882,-75.766298)"
2021,Julio,Palestina,99999,3,2,5,"(4.697144,-74.140516)"
2014,Junio,Federación de Rusia,643,3,2,5,"(10.445761,-75.516429)"
2013,Marzo,Turquía,792,3,4,7,"(10.445761,-75.516429)"
2017,Enero,Reino Unido de Gran Bretaña e Irlanda del Norte,826,14,27,41,"(-4.197703,-69.941278)"
2014,Julio,Emiratos Árabes,784,0,2,2,"(4.697144,-74.140516)"
2017,Septiembre,China,156,34,60,94,"(6.171601,-75.427454)"
2018,Mayo,Reino Unido de Gran Bretaña e Irlanda del Norte,826,1,1,2,"(4.815061,-75.736532)"
2022,Octubre,Estados Unidos de América,840,13,38,51,"(10.408582,-75.538003)"
2016,Marzo,Honduras,340,6,6,12,"(10.886611,-74.776708)"
2023,Junio,Bélgica,56,8,12,20,"(0.814836,-77.662532)"
2016,Mayo,Macedonia,807,0,1,1,"(4.697144,-74.140516)"
2019,Febrero,Bélgica,56,18,36,54,"(3.541112,-76.384584)"
2014,Marzo,San Cristóbal y Nevis,659,1,1,2,"(4.697144,-74.140516)"
2017,Diciembre,Guatemala,320,0,1,1,"(11.360009,-72.129330)"
2014,Enero,Países Bajos,528,1,1,2,"(6.171601,-75.427454)"
2013,Noviembre,Brasil,76,61,78,139,"(-4.197703,-69.941278)"
2017,Junio,Noruega,578,1,1,2,"(10.886611,-74.776708)"
2013,Octubre,Sierra Leona,694,0,2,2,"(10.445761,-75.516429)"
2023,Febrero,Chile,152,1,1,2,"(8.635765,-77.346578)"
2020,Septiembre,España,724,7,9,16,"(6.171601,-75.427454)"
2017,Abril,Singapur,702,10,21,31,"(4.697144,-74.140516)"
2023,Febrero,Cuba,192,1,16,17,"(10.886611,-74.776708)"
2013,Noviembre,Chipre,196,1,0,1,"(3.541112,-76.384584)"
2019,Octubre,Alemania,276,1951,2793,4744,"(4.697144,-74.140516)"
2019,Diciembre,Etiopia,231,7,55,62,"(4.697144,-74.140516)"
2022,Octubre,España,724,23,39,62,"(10.886611,-74.776708)"
2022,Agosto,Jamaica,388,16,22,38,"(10.445761,-75.516429)"
2021,Noviembre,España,724,56,95,151,"(3.541112,-76.384584)"
2013,Febrero,Lituania,440,0,2,2,"(10.408582,-75.538003)"
2013,Julio,India,356,0,1,1,"(12.586067,-81.702563)"
2018,Marzo,Zimbabue,716,1,1,2,"(6.171601,-75.427454)"
2013,Septiembre,Brasil,76,7,24,31,"(10.886611,-74.776708)"
2022,Abril,Santa Lucia,662,0,1,1,"(3.541112,-76.384584)"
2018,Junio,China,156,5,8,13,"(0.814836,-77.662532)"
2022,Noviembre,Nueva Zelanda,554,58,99,157,"(4.697144,-74.140516)"
2012,Septiembre,Chile,152,112,119,231,"(10.445761,-75.516429)"
2023,Febrero,Barbados,52,0,1,1,"(10.445761,-75.516429)"
2019,Noviembre,Australia,36,1,1,2,"(7.128456,-73.183637)"
2019,Septiembre,República Dominicana,214,1,0,1,"(4.452882,-75.766298)"
2015,Diciembre,Nueva Zelanda,554,8,17,25,"(6.171601,-75.427454)"
2023,Abril,Turquía,792,0,4,4,"(10.886611,-74.776708)"
2023,Febrero,Albania,8,1,4,5,"(10.445761,-75.516429)"
2016,Febrero,Israel,376,1,1,2,"(7.818934,-72.453226)"
2019,Junio,Canadá,124,0,1,1,"(11.360009,-72.129330)"
2022,Diciembre,Taiwán,158,1,1,2,"(7.818934,-72.453226)"
2018,Abril,Emiratos Árabes,784,2,9,11,"(4.697144,-74.140516)"
2023,Enero,Ucrania,804,2,1,3,"(10.886611,-74.776708)"
2017,Octubre,Bélgica,56,0,1,1,"(-4.197703,-69.941278)"
2019,Junio,India,356,1,15,16,"(3.541112,-76.384584)"
2012,Abril,Guyana,328,1,1,2,"(6.171601,-75.427454)"
2022,Agosto,Lituania,440,5,8,13,"(6.171601,-75.427454)"
2014,Marzo,Turquía,792,2,5,7,"(6.171601,-75.427454)"
2016,Diciembre,Sudáfrica,710,1,1,2,"(0.814836,-77.662532)"
2020,Enero,Portugal,620,5,6,11,"(10.886611,-74.776708)"
2013,Febrero,Honduras,340,1,3,4,"(12.586067,-81.702563)"
2015,Abril,Cuba,192,283,394,677,"(4.697144,-74.140516)"
2016,Octubre,Belice,84,1,1,2,"(3.541112,-76.384584)"
2020,Enero,Australia,36,16,28,44,"(3.541112,-76.384584)"
2022,Diciembre,Eslovaquia,703,49,70,119,"(4.697144,-74.140516)"
2015,Febrero,República Dominicana,214,13,32,45,"(10.445761,-75.516429)"
2017,Julio,República Democrática del Congo,180,0,2,2,"(0.814836,-77.662532)"
2016,Septiembre,India,356,0,9,9,"(10.408582,-75.538003)"
2018,Agosto,Montenegro,499,0,1,1,"(-4.197703,-69.941278)"
2019,Agosto,República de Tayikistán,762,2,0,2,"(4.697144,-74.140516)"
2020,Septiembre,Bahréin,48,0,1,1,"(4.697144,-74.140516)"
2015,Febrero,Trinidad y Tobago,780,0,1,1,"(11.360009,-72.129330)"
2018,Noviembre,México,484,22,33,55,"(0.814836,-77.662532)"
2015,Agosto,Brasil,76,0,1,1,"(4.452882,-75.766298)"
2018,Febrero,Grecia,300,0,1,1,"(11.247723,-74.213989)"
2018,Enero,Uruguay,858,1,0,1,"(-4.223468,-69.945098)"
2012,Julio,Singapur,702,5,15,20,"(4.697144,-74.140516)"
2023,Febrero,Sudáfrica,710,4,5,9,"(10.445761,-75.516429)"
2018,Diciembre,Burkina Faso,854,1,1,2,"(4.697144,-74.140516)"
2019,Septiembre,Malasia,458,12,14,26,"(4.697144,-74.140516)"
2018,Septiembre,Georgia,268,0,4,4,"(10.445761,-75.516429)"
2023,Abril,Ecuador,218,1,1,2,"(-4.223468,-69.945098)"
2019,Junio,Guatemala,320,13,26,39,"(3.541112,-76.384584)"
2015,Agosto,Indonesia,360,0,1,1,"(10.886611,-74.776708)"
2019,Junio,Bulgaria,100,1,2,3,"(10.445761,-75.516429)"
2016,Diciembre,Ecuador,218,58,61,119,"(1.813928,-78.763924)"
2018,Noviembre,Bolivia,68,0,2,2,"(10.886611,-74.776708)"
2022,Noviembre,Austria,40,1,2,3,"(10.886611,-74.776708)"
2018,Abril,Ecuador,218,4,7,11,"(10.886611,-74.776708)"
2023,Febrero,Taiwán,158,1,0,1,"(10.445761,-75.516429)"
2023,Mayo,Venezuela,862,197,202,399,"(7.088729,-70.740253)"
2015,Agosto,Alemania,276,11,10,21,"(7.818934,-72.453226)"
2020,Enero,República Árabe Siria,760,0,6,6,"(4.697144,-74.140516)"
2015,Febrero,Rumania,642,50,63,113,"(4.697144,-74.140516)"
2015,Mayo,Dinamarca,208,4,5,9,"(10.408582,-75.538003)"
2014,Febrero,Federación de Rusia,643,0,1,1,"(3.893038,-77.067921)"
2013,Julio,Bermudas/Territorio Británico de Ultramar,60,0,1,1,"(10.445761,-75.516429)"
2014,Mayo,Taiwán,158,4,3,7,"(3.541112,-76.384584)"
2017,Junio,Chile,152,0,1,1,"(-4.197703,-69.941278)"
2019,Febrero,Refugiado,99999,2,4,6,"(4.697144,-74.140516)"
2019,Noviembre,Turquía,792,0,1,1,"(9.402978,-75.681599)"
2017,Enero,Reino Unido de Gran Bretaña e Irlanda del Norte,826,1,1,2,"(7.128456,-73.183637)"
2019,Noviembre,Gambia,270,0,1,1,"(4.697144,-74.140516)"
2021,Febrero,Panamá,591,0,3,3,"(1.813928,-78.763924)"
2019,Marzo,Ghana,288,0,2,2,"(6.171601,-75.427454)"
2013,Marzo,México,484,136,208,344,"(10.445761,-75.516429)"
2016,Octubre,Panamá,591,0,2,2,"(0.814836,-77.662532)"
2017,Octubre,San Cristóbal y Nevis,659,0,3,3,"(10.445761,-75.516429)"
2015,Noviembre,Costa Rica,188,881,1324,2205,"(4.697144,-74.140516)"
2018,Junio,Argentina,32,3,17,20,"(7.818934,-72.453226)"
2018,Mayo,Italia,380,0,2,2,"(0.25129,-76.875963)"
2017,Septiembre,Paraguay,600,17,15,32,"(3.541112,-76.384584)"
2022,Septiembre,Italia,380,732,1526,2259,"(4.697144,-74.140516)"
2013,Junio,Nueva Zelanda,554,0,2,2,"(8.635765,-77.346578)"
2017,Diciembre,Argentina,32,4,3,7,"(4.815061,-75.736532)"
2016,Septiembre,Nueva Zelanda,554,50,83,133,"(4.697144,-74.140516)"
2015,Octubre,México,484,11,29,40,"(7.128456,-73.183637)"
2012,Septiembre,China,156,2,0,2,"(8.635765,-77.346578)"
2018,Febrero,India,356,5,59,64,"(6.171601,-75.427454)"
2014,Octubre,Dominica,212,2,0,2,"(10.445761,-75.516429)"
2020,Marzo,Federación de Rusia,643,12,12,24,"(10.445761,-75.516429)"
2012,Septiembre,Argentina,32,0,1,1,"(6.185799,-67.483929)"
2018,Octubre,Líbano,422,1,1,2,"(6.171601,-75.427454)"
2012,Abril,Taiwán,158,0,1,1,"(10.445761,-75.516429)"
2019,Febrero,Suiza,756,2,0,2,"(7.818934,-72.453226)"
2014,Octubre,Filipinas,608,0,33,33,"(10.408582,-75.538003)"
2017,Mayo,España,724,3,10,13,"(4.815061,-75.736532)"
2019,Mayo,Francia,250,60,88,148,"(3.541112,-76.384584)"
2015,Junio,España,724,1,0,1,"(4.452882,-75.766298)"
2012,Enero,Aruba,533,0,1,1,"(3.541112,-76.384584)"
2022,Diciembre,Emiratos Árabes,784,10,13,23,"(4.697144,-74.140516)"
2014,Marzo,Filipinas,608,1,0,1,"(12.586067,-81.702563)"
2017,Abril,Honduras,340,2,0,2,"(7.128456,-73.183637)"
2014,Febrero,Suecia,752,18,16,34,"(10.445761,-75.516429)"
2016,Julio,Estados Unidos de América,840,303,334,637,"(4.815061,-75.736532)"
2022,Abril,Costa Rica,188,6,5,11,"(12.586067,-81.702563)"
2018,Mayo,Panamá,591,23,26,49,"(12.586067,-81.702563)"
2019,Agosto,Canadá,124,214,446,660,"(6.171601,-75.427454)"
2014,Julio,Malasia,458,0,1,1,"(3.541112,-76.384584)"
2016,Febrero,Finlandia,246,7,7,14,"(10.445761,-75.516429)"
2020,Marzo,Italia,380,4,5,9,"(12.586067,-81.702563)"
2018,Diciembre,Filipinas,608,49,35,84,"(4.697144,-74.140516)"
2017,Abril,Dinamarca,208,14,20,34,"(10.445761,-75.516429)"
2015,Abril,Irán,364,1,1,2,"(10.445761,-75.516429)"
2023,Junio,Suiza,756,5,1,6,"(8.635765,-77.346578)"
2020,Enero,Egipto,818,3,6,9,"(6.171601,-75.427454)"
2015,Mayo,Brasil,76,0,2,2,"(8.635765,-77.346578)"
2013,Febrero,Estados Unidos de América,840,7,10,17,"(7.927209,-72.507910)"
2014,Noviembre,Países Bajos,528,1,0,1,"(-4.223468,-69.945098)"
2015,Octubre,Granada,308,1,1,2,"(10.408582,-75.538003)"
2019,Mayo,Etiopia,231,0,1,1,"(10.445761,-75.516429)"
2018,Septiembre,Dinamarca,208,11,23,34,"(10.445761,-75.516429)"
2021,Julio,China,156,1,1,2,"(7.818934,-72.453226)"
2012,Diciembre,Liechtenstein,438,4,6,10,"(4.697144,-74.140516)"
2022,Junio,Costa Rica,188,0,1,1,"(8.635765,-77.346578)"
2019,Octubre,Venezuela,862,10460,9905,20366,"(4.697144,-74.140516)"
2016,Julio,Portugal,620,1,4,5,"(10.886611,-74.776708)"
2018,Enero,Eslovaquia,703,1,0,1,"(10.886611,-74.776708)"
2015,Junio,Venezuela,862,0,1,1,"(8.635765,-77.346578)"
2017,Junio,Bélgica,56,10,21,31,"(3.541112,-76.384584)"
2019,Agosto,Nueva Zelanda,554,8,11,19,"(10.445761,-75.516429)"
2017,Octubre,Desconocido,99999,3,8,11,"(10.445761,-75.516429)"
2014,Marzo,Canadá,124,0,3,3,"(11.360009,-72.129330)"
2014,Julio,Perú,604,429,469,898,"(6.171601,-75.427454)"
2014,Octubre,República de Corea,410,1,2,3,"(-4.197703,-69.941278)"
2018,Febrero,Noruega,578,3,5,8,"(3.541112,-76.384584)"
2019,Marzo,Zimbabue,716,2,0,2,"(10.445761,-75.516429)"
2012,Septiembre,Estados Unidos de América,840,724,1524,2248,"(10.445761,-75.516429)"
2012,Septiembre,Argentina,32,27,45,72,"(7.818934,-72.453226)"
2022,Mayo,Venezuela,862,444,351,795,"(8.36068,-72.409396)"
2018,Abril,Taiwán,158,6,16,22,"(6.171601,-75.427454)"
2018,Diciembre,Filipinas,608,1,0,1,"(8.36068,-72.409396)"
2020,Diciembre,Perú,604,0,10,10,"(10.408582,-75.538003)"
2012,Diciembre,Venezuela,862,11,12,23,"(7.128456,-73.183637)"
2021,Octubre,Argentina,32,99,169,268,"(6.171601,-75.427454)"
2017,Julio,Bermudas/Territorio Británico de Ultramar,60,0,3,3,"(4.697144,-74.140516)"
2016,Marzo,Malasia,458,1,3,4,"(6.171601,-75.427454)"
2017,Octubre,Países Bajos,528,3,3,6,"(11.360009,-72.129330)"
2012,Agosto,Federación de Rusia,643,0,1,1,"(10.408582,-75.538003)"
2022,Abril,España,724,8,14,22,"(4.815061,-75.736532)"
2021,Agosto,Chile,152,0,1,1,"(6.17134,-75.427194)"
2018,Febrero,Serbia,688,2,0,2,"(10.445761,-75.516429)"
2022,Diciembre,Austria,40,5,2,7,"(0.814836,-77.662532)"
2013,Octubre,Estados Unidos de América,840,7,8,15,"(12.586067,-81.702563)"
2013,Noviembre,República Dominicana,214,0,1,1,"(1.813928,-78.763924)"
2019,Agosto,Albania,8,5,8,13,"(4.697144,-74.140516)"
2021,Junio,Venezuela,862,1,5,6,"(4.815061,-75.736532)"
2018,Octubre,Bulgaria,100,35,44,79,"(4.697144,-74.140516)"
2022,Junio,Reino Unido de Gran Bretaña e Irlanda del Norte,826,0,2,2,"(11.117806,-74.232622)"
2022,Abril,Venezuela,862,467,427,894,"(8.36068,-72.409396)"
2023,Mayo,Ecuador,218,1437,983,2420,"(10.445761,-75.516429)"
2015,Agosto,Brasil,76,129,93,222,"(12.586067,-81.702563)"
2013,Agosto,Brasil,76,2636,4057,6693,"(4.697144,-74.140516)"
2020,Enero,República de Corea,410,10,7,17,"(0.814836,-77.662532)"
2019,Agosto,México,484,27,18,45,"(7.818934,-72.453226)"
2021,Julio,Federación de Rusia,643,0,3,3,"(10.886611,-74.776708)"
2016,Diciembre,República Checa,203,1,0,1,"(10.408582,-75.538003)"
2017,Febrero,Estados Unidos de América,840,912,1384,2296,"(3.541112,-76.384584)"
2017,Diciembre,Trinidad y Tobago,780,6,21,27,"(6.171601,-75.427454)"
2018,Junio,Barbados,52,3,2,5,"(6.171601,-75.427454)"
2014,Julio,Guatemala,320,44,67,111,"(6.171601,-75.427454)"
2014,Abril,Sudáfrica,710,0,1,1,"(-4.197703,-69.941278)"
2016,Noviembre,Jamaica,388,3,2,5,"(10.445761,-75.516429)"
2015,Noviembre,Alemania,276,22,36,58,"(10.408582,-75.538003)"
2017,Noviembre,República Árabe de Yemen,887,0,1,1,"(4.697144,-74.140516)"
2014,Julio,Estados Unidos de América,840,26,56,82,"(10.408582,-75.538003)"
2022,Diciembre,Paraguay,600,1,0,1,"(0.814836,-77.662532)"
2016,Noviembre,Suecia,752,12,22,34,"(10.445761,-75.516429)"
2015,Junio,Bangladesh,50,0,1,1,"(4.697144,-74.140516)"
2012,Abril,Islas Caimán/Territorio Británico de Ultramar,136,0,1,1,"(12.586067,-81.702563)"
2016,Abril,Federación de Rusia,643,114,162,276,"(4.697144,-74.140516)"
2017,Febrero,Dinamarca,208,0,2,2,"(10.886611,-74.776708)"
2021,Abril,Panamá,591,0,4,4,"(10.408582,-75.538003)"
2021,Enero,Etiopia,231,0,1,1,"(10.445761,-75.516429)"
2018,Agosto,Brasil,76,0,2,2,"(3.866713,-67.927521)"
2015,Febrero,Togo,768,0,4,4,"(4.697144,-74.140516)"
2018,Julio,Dinamarca,208,5,13,18,"(3.541112,-76.384584)"
2014,Abril,República Checa,203,0,2,2,"(10.445761,-75.516429)"
2016,Abril,Brasil,76,2,1,3,"(11.360009,-72.129330)"
2017,Agosto,Kenia,404,3,6,9,"(3.541112,-76.384584)"
2021,Abril,Estados Unidos de América,840,0,1,1,"(12.586067,-81.702563)"
2019,Febrero,Canadá,124,12,22,34,"(4.815061,-75.736532)"
2018,Abril,Suiza,756,6,4,10,"(-4.197703,-69.941278)"
2017,Septiembre,Ucrania,804,32,13,45,"(4.697144,-74.140516)"
2019,Septiembre,República de Corea,410,0,2,2,"(-4.223468,-69.945098)"
2014,Febrero,Suiza,756,0,2,2,"(7.128456,-73.183637)"
2015,Julio,Jamaica,388,1,0,1,"(4.815061,-75.736532)"
2013,Marzo,Canadá,124,2,5,7,"(11.360009,-72.129330)"
2012,Septiembre,Islandia,352,0,2,2,"(6.171601,-75.427454)"
2013,Julio,Territorio Antártico Británico/Territorio Británico de Ultramar,260,1,2,3,"(7.818934,-72.453226)"
2017,Junio,Países Bajos,528,1,1,2,"(-4.197703,-69.941278)"
2012,Enero,Rwanda,646,1,1,2,"(4.697144,-74.140516)"
2019,Junio,Bolivia,68,0,1,2,"(-4.197703,-69.941278)"
2020,Abril,Panamá,591,0,14,14,"(4.697144,-74.140516)"
2014,Septiembre,Brasil,76,32,93,125,"(3.541112,-76.384584)"
2023,Mayo,Suiza,756,0,2,2,"(0.25129,-76.875963)"
2015,Febrero,Cuba,192,6,16,22,"(10.886611,-74.776708)"
2021,Mayo,Noruega,578,12,30,42,"(4.697144,-74.140516)"
2016,Noviembre,Zambia,894,0,1,1,"(3.541112,-76.384584)"
2012,Noviembre,Haití,332,9,13,22,"(4.697144,-74.140516)"
2015,Octubre,Chile,152,39,51,90,"(0.814836,-77.662532)"
2022,Julio,Mozambique,508,0,1,1,"(0.25129,-76.875963)"
2020,Marzo,Argentina,32,7,6,13,"(0.25129,-76.875963)"
2014,Agosto,Australia,36,1,4,5,"(7.818934,-72.453226)"
2022,Marzo,España,724,256,468,724,"(6.171601,-75.427454)"
2012,Febrero,Federación de Rusia,643,5,2,7,"(10.445761,-75.516429)"
2022,Noviembre,Indonesia,360,2,1,3,"(10.445761,-75.516429)"
2021,Septiembre,Macedonia,807,9,3,12,"(4.697144,-74.140516)"
2022,Septiembre,Federación de Rusia,643,0,4,4,"(3.893038,-77.067921)"
2016,Diciembre,Reino Unido de Gran Bretaña e Irlanda del Norte,826,3,1,4,"(4.452882,-75.766298)"
2014,Noviembre,Perú,604,0,5,5,"(4.815061,-75.736532)"
2015,Enero,México,484,2809,5278,8087,"(4.697144,-74.140516)"
2012,Mayo,Japón,392,1,3,4,"(10.886611,-74.776708)"
2019,Marzo,Italia,380,105,216,321,"(10.445761,-75.516429)"
2017,Agosto,Desconocido,99999,1,0,1,"(7.128456,-73.183637)"
2015,Noviembre,Venezuela,862,5,3,8,"(12.586067,-81.702563)"
2014,Octubre,Surinam,740,13,18,31,"(4.697144,-74.140516)"
2014,Julio,República de Irlanda,372,1,0,1,"(4.815061,-75.736532)"
2013,Julio,República de Irlanda,372,2,16,18,"(10.445761,-75.516429)"
2018,Agosto,Montenegro,499,1,3,4,"(4.697144,-74.140516)"
2020,Febrero,Estados Unidos de América,840,0,1,1,"(6.185799,-67.483929)"
2014,Enero,Desconocido,99999,0,1,1,"(11.528919,-72.919681)"
2015,Mayo,Dinamarca,208,11,10,21,"(0.814836,-77.662532)"
2016,Diciembre,Perú,604,11,25,36,"(11.360009,-72.129330)"
2023,Abril,Guatemala,320,2,5,7,"(8.364293,-72.405710)"
2015,Junio,Suiza,756,25,25,50,"(0.814836,-77.662532)"
2016,Marzo,Bulgaria,100,0,9,9,"(10.408582,-75.538003)"
2022,Marzo,Nigeria,566,0,1,1,"(3.541112,-76.384584)"
2013,Noviembre,Venezuela,862,0,1,1,"(12.5744111,-81.703935)"
2012,Abril,Brasil,76,26,64,90,"(6.171601,-75.427454)"
2019,Febrero,Cuba,192,0,1,1,"(4.452882,-75.766298)"
2018,Enero,Vietnam,704,3,8,11,"(4.697144,-74.140516)"
2017,Octubre,Canadá,124,50,62,112,"(3.541112,-76.384584)"
2022,Febrero,Estados Unidos de América,840,4876,7469,12347,"(10.445761,-75.516429)"
2019,Diciembre,Arabia Saudita,682,0,5,5,"(10.445761,-75.516429)"
2017,Julio,Chile,152,148,122,270,"(10.408582,-75.538003)"
2018,Abril,México,484,0,1,1,"(6.228046,-77.404104)"
2019,Octubre,Dinamarca,208,0,6,6,"(10.408582,-75.538003)"
2019,Enero,Serbia,688,0,2,2,"(10.408582,-75.538003)"
2017,Marzo,Países Bajos,528,0,1,1,"(4.815061,-75.736532)"
2022,Noviembre,Federación de Rusia,643,0,1,1,"(7.916725,-72.462544)"
2018,Mayo,Indonesia,360,0,2,2,"(0.814836,-77.662532)"
2021,Junio,Honduras,340,5,9,14,"(10.886611,-74.776708)"
2017,Septiembre,Bolivia,68,1,0,1,"(8.36068,-72.409396)"
2016,Octubre,Costa Rica,188,6,2,8,"(0.814836,-77.662532)"
2015,Septiembre,Desconocido,99999,0,3,3,"(3.541112,-76.384584)"
2022,Mayo,Nepal,524,0,1,1,"(6.171601,-75.427454)"
2018,Junio,Malasia,458,1,0,1,"(0.814836,-77.662532)"
2012,Noviembre,República de Corea,410,2,4,6,"(7.818934,-72.453226)"
2014,Mayo,Croacia,191,0,2,2,"(3.541112,-76.384584)"
2013,Junio,Panamá,591,0,1,1,"(6.185799,-67.483929)"
2014,Septiembre,Polonia,616,6,5,11,"(6.171601,-75.427454)"
2013,Septiembre,Curazao,99999,1,2,3,"(4.697144,-74.140516)"
2017,Mayo,Japón,392,0,5,5,"(4.815061,-75.736532)"
2018,Noviembre,Jordania,400,1,0,1,"(6.171601,-75.427454)"
2019,Diciembre,República Árabe Siria,760,2,2,4,"(10.445761,-75.516429)"
2017,Diciembre,Suecia,752,1,1,2,"(7.128456,-73.183637)"
2018,Agosto,Libia,434,0,1,1,"(4.697144,-74.140516)"
2017,Abril,Chile,152,25,74,99,"(6.171601,-75.427454)"
2019,Mayo,Trinidad y Tobago,780,6,12,18,"(10.445761,-75.516429)"
2016,Diciembre,Argentina,32,1,2,3,"(8.36068,-72.409396)"
2012,Abril,Taiwán,158,1,2,3,"(3.541112,-76.384584)"
2016,Octubre,Suiza,756,22,27,49,"(10.445761,-75.516429)"
2022,Noviembre,Vietnam,704,13,13,26,"(4.697144,-74.140516)"
2013,Mayo,Costa Rica,188,0,4,4,"(7.818934,-72.453226)"
2015,Febrero,Francia,250,1432,2349,3781,"(4.697144,-74.140516)"
2014,Diciembre,Chile,152,49,114,163,"(6.171601,-75.427454)"
2013,Julio,Australia,36,56,79,135,"(3.541112,-76.384584)"
2016,Octubre,Perú,604,235,167,402,"(12.586067,-81.702563)"
2021,Enero,República de Corea,410,2,5,7,"(6.171601,-75.427454)"
2016,Septiembre,Austria,40,1,0,1,"(12.586067,-81.702563)"
2019,Abril,España,724,2,2,4,"(8.635765,-77.346578)"
2016,Abril,Etiopia,231,0,3,3,"(4.697144,-74.140516)"
2013,Julio,Indonesia,360,14,34,48,"(4.697144,-74.140516)"
2017,Septiembre,México,484,4473,7467,11940,"(4.697144,-74.140516)"
2016,Enero,Panamá,591,3,8,11,"(7.927209,-72.507910)"
2023,Mayo,Suecia,752,3,2,5,"(10.408582,-75.538003)"
2013,Febrero,Ecuador,218,383,447,830,"(6.171601,-75.427454)"
2019,Abril,República Árabe Siria,760,0,4,4,"(4.697144,-74.140516)"
2017,Septiembre,Hungría,348,0,1,1,"(10.971302,-74.765397)"
2018,Mayo,Venezuela,862,33579,37933,71512,"(7.818934,-72.453226)"
2012,Noviembre,Ghana,288,0,2,2,"(6.171601,-75.427454)"
2016,Junio,Panamá,591,3,1,4,"(8.635765,-77.346578)"
2017,Junio,Brasil,76,728,539,1267,"(10.445761,-75.516429)"
2022,Febrero,Paraguay,600,0,1,1,"(4.815061,-75.736532)"
2012,Mayo,Ecuador,218,407,535,942,"(6.171601,-75.427454)"
2021,Octubre,Uruguay,858,0,1,1,"(4.452882,-75.766298)"
2023,Abril,Taiwán,158,50,46,96,"(4.697144,-74.140516)"
2015,Octubre,Países Bajos,528,0,3,3,"(-4.197703,-69.941278)"
2022,Marzo,Afganistán,4,0,2,2,"(4.697144,-74.140516)"
2023,Junio,Egipto,818,13,26,39,"(4.697144,-74.140516)"
2016,Agosto,Portugal,620,0,3,3,"(4.815061,-75.736532)"
2016,Febrero,Kenia,404,5,17,22,"(4.697144,-74.140516)"
2018,Febrero,Paraguay,600,0,2,2,"(11.360009,-72.129330)"
2013,Octubre,Cuba,192,0,1,1,"(4.452882,-75.766298)"
2019,Agosto,Federación de Rusia,643,0,1,1,"(3.893038,-77.067921)"
2021,Septiembre,Estados Unidos de América,840,1,1,2,"(11.247723,-74.213989)"
2022,Noviembre,Belice,84,1,0,1,"(4.815061,-75.736532)"
2012,Octubre,Nicaragua,558,0,1,1,"(4.452882,-75.766298)"
2015,Agosto,Países Bajos,528,5,8,13,"(-4.197703,-69.941278)"
2023,Marzo,Suiza,756,0,1,1,"(6.18189,-67.47535)"
2022,Noviembre,Bangladesh,50,6,8,14,"(4.697144,-74.140516)"
2023,Abril,Santa Sede/Ciudad del Vaticano,336,0,2,2,"(4.697144,-74.140516)"
2023,Enero,Rumania,642,8,18,26,"(3.541112,-76.384584)"
2018,Abril,Federación de Rusia,643,2,0,2,"(-4.223468,-69.945098)"
2018,Febrero,Brasil,76,0,2,2,"(6.185799,-67.483929)"
2012,Febrero,Taiwán,158,0,1,1,"(0.814836,-77.662532)"
2019,Noviembre,Suecia,752,43,55,98,"(10.445761,-75.516429)"
2012,Enero,Australia,36,5,9,14,"(8.635765,-77.346578)"
2013,Mayo,Kuwait,414,1,1,2,"(4.697144,-74.140516)"
2012,Abril,Bélgica,56,3,4,7,"(10.445761,-75.516429)"
2018,Julio,San  Vicente y las Granadinas,670,0,6,6,"(3.541112,-76.384584)"
2013,Marzo,Ecuador,218,5,3,8,"(7.927209,-72.507910)"
2018,Noviembre,Desconocido,99999,1,0,1,"(7.088729,-70.740253)"
2018,Febrero,Malta,470,5,15,20,"(4.697144,-74.140516)"
2022,Enero,España,724,11,23,34,"(4.815061,-75.736532)"
2013,Noviembre,Uruguay,858,0,2,2,"(7.128456,-73.183637)"
2016,Septiembre,Panamá,591,5,14,19,"(7.128456,-73.183637)"
2022,Enero,Taiwán,158,1,0,1,"(0.814836,-77.662532)"
2013,Abril,Líbano,422,0,1,1,"(3.541112,-76.384584)"
2018,Mayo,Italia,380,0,1,1,"(0.812436,-77.847006)"
2020,Enero,Etiopia,231,0,1,1,"(10.445761,-75.516429)"
2022,Diciembre,Japón,392,0,1,1,"(10.408582,-75.538003)"
2023,Febrero,Estados Unidos de América,840,12115,20251,32370,"(4.697144,-74.140516)"
2016,Noviembre,Austria,40,150,292,442,"(4.697144,-74.140516)"
2019,Octubre,El Salvador,222,24,43,67,"(6.171601,-75.427454)"
2016,Julio,Israel,376,3,13,16,"(-4.197703,-69.941278)"
2022,Marzo,Venezuela,862,25,17,42,"(6.185799,-67.483929)"
2017,Febrero,Cuba,192,0,1,1,"(13.3387613,-81.372937)"
2015,Julio,Estados Unidos de América,840,1640,2055,3695,"(3.541112,-76.384584)"
2012,Diciembre,Nueva Zelanda,554,2,4,6,"(8.635765,-77.346578)"
2016,Marzo,Brasil,76,4,18,22,"(10.886611,-74.776708)"
2017,Abril,Canadá,124,145,189,334,"(10.445761,-75.516429)"
2023,Mayo,Eslovaquia,703,4,5,9,"(6.171601,-75.427454)"
2018,Marzo,Estados Unidos de América,840,6,8,14,"(-4.223468,-69.945098)"
2014,Febrero,Japón,392,113,490,603,"(4.697144,-74.140516)"
2012,Junio,Eslovenia,705,3,2,5,"(6.171601,-75.427454)"
2021,Enero,Reino Unido de Gran Bretaña e Irlanda del Norte,826,61,185,246,"(4.697144,-74.140516)"
2019,Septiembre,Grecia,300,0,2,2,"(3.893038,-77.067921)"
2013,Diciembre,Estados Unidos de América,840,489,721,1210,"(10.886611,-74.776708)"
2016,Julio,Ecuador,218,49,155,204,"(1.813928,-78.763924)"
2017,Septiembre,Reino Unido de Gran Bretaña e Irlanda del Norte,826,91,162,253,"(10.445761,-75.516429)"
2018,Marzo,México,484,21,43,64,"(0.814836,-77.662532)"
2021,Diciembre,Ghana,288,0,1,1,"(6.171601,-75.427454)"
2022,Enero,Chile,152,12,13,25,"(10.886611,-74.776708)"
2015,Febrero,Estados Unidos de América,840,32,37,69,"(7.818934,-72.453226)"
2014,Noviembre,Suecia,752,11,17,28,"(6.171601,-75.427454)"
2014,Agosto,Cuba,192,0,1,1,"(11.360009,-72.129330)"
2012,Febrero,Austria,40,2,2,4,"(10.408582,-75.538003)"
2016,Junio,Líbano,422,6,14,20,"(4.697144,-74.140516)"
2012,Marzo,Kazajistán,398,1,3,4,"(4.697144,-74.140516)"
2022,Noviembre,Dinamarca,208,14,30,44,"(6.171601,-75.427454)"
2020,Noviembre,Países Bajos,528,12,61,73,"(6.171601,-75.427454)"
2023,Febrero,China,156,16,20,36,"(3.541112,-76.384584)"
2022,Noviembre,Sudán,736,0,2,2,"(4.697144,-74.140516)"
2022,Febrero,Alemania,276,0,1,1,"(-0.193180,-74.784874)"
2020,Noviembre,Belice,84,0,1,1,"(10.445761,-75.516429)"
2022,Marzo,El Salvador,222,1,2,3,"(4.815061,-75.736532)"
2022,Noviembre,Cuba,192,139,181,320,"(4.697144,-74.140516)"
2013,Enero,Filipinas,608,19,41,60,"(4.697144,-74.140516)"
2019,Febrero,México,484,350,924,1274,"(6.171601,-75.427454)"
2013,Marzo,Camerún,120,0,1,1,"(4.697144,-74.140516)"
2014,Julio,Canadá,124,886,1512,2398,"(4.697144,-74.140516)"
2016,Diciembre,Alemania,276,2,0,2,"(-0.193180,-74.784874)"
2018,Abril,Israel,376,0,1,1,"(4.815061,-75.736532)"
2023,Junio,Italia,380,16,42,58,"(10.886611,-74.776708)"
2021,Octubre,México,484,2,1,3,"(0.814836,-77.662532)"
2016,Abril,Lituania,440,3,1,4,"(0.814836,-77.662532)"
2019,Septiembre,Guatemala,320,121,176,297,"(6.171601,-75.427454)"
2013,Diciembre,Mongolia,496,0,1,1,"(4.697144,-74.140516)"
2018,Noviembre,República Dominicana,214,4,3,7,"(7.818934,-72.453226)"
2019,Agosto,Serbia,688,1,3,4,"(10.445761,-75.516429)"
2018,Noviembre,Venezuela,862,4,6,10,"(-4.197703,-69.941278)"
2019,Septiembre,España,724,31,51,82,"(7.818934,-72.453226)"
2017,Junio,Mónaco,492,1,0,1,"(4.697144,-74.140516)"
2022,Octubre,Sri Lanka,144,2,3,5,"(4.697144,-74.140516)"
2019,Septiembre,Bolivia,68,17,35,53,"(6.171601,-75.427454)"
2012,Julio,Suecia,752,6,7,13,"(10.445761,-75.516429)"
2017,Febrero,Turquía,792,3,2,5,"(10.886611,-74.776708)"
2013,Julio,Suecia,752,1,1,2,"(4.815061,-75.736532)"
2012,Junio,El Salvador,222,0,1,1,"(7.818934,-72.453226)"
2022,Junio,Finlandia,246,57,56,113,"(4.697144,-74.140516)"
2017,Febrero,Jamaica,388,0,1,1,"(10.408582,-75.538003)"
2016,Enero,República de Kosovo,901,0,3,3,"(4.697144,-74.140516)"
2018,Junio,Hungría,348,1,1,2,"(10.886611,-74.776708)"
2017,Septiembre,Canadá,124,1,1,2,"(0.25129,-76.875963)"
2015,Julio,Venezuela,862,1014,1092,2106,"(6.171601,-75.427454)"
2016,Octubre,Croacia,191,1,1,2,"(10.445761,-75.516429)"
2018,Agosto,Brasil,76,45,73,118,"(3.541112,-76.384584)"
2021,Noviembre,Canadá,124,162,493,655,"(6.171601,-75.427454)"
2019,Agosto,Guatemala,320,1,3,4,"(7.128456,-73.183637)"
2018,Mayo,Portugal,620,10,42,52,"(6.171601,-75.427454)"
2015,Marzo,Singapur,702,2,3,5,"(6.171601,-75.427454)"
2012,Marzo,República de Corea,410,0,3,3,"(-4.197703,-69.941278)"
2017,Noviembre,México,484,4418,7748,12166,"(4.697144,-74.140516)"
2013,Agosto,Canadá,124,10,7,17,"(0.814836,-77.662532)"
2014,Febrero,República Dominicana,214,0,1,1,"(4.452882,-75.766298)"
2013,Mayo,Eslovenia,705,1,5,6,"(3.541112,-76.384584)"
2016,Marzo,Japón,392,0,1,1,"(0.25129,-76.875963)"
2023,Marzo,Chile,152,14,14,28,"(11.117806,-74.232622)"
2014,Julio,Bélgica,56,5,19,24,"(10.445761,-75.516429)"
2012,Mayo,Desconocido,99999,0,1,1,"(10.445761,-75.516429)"
2021,Abril,China,156,1,0,1,"(4.815061,-75.736532)"
2013,Enero,Grecia,300,0,2,2,"(11.247723,-74.213989)"
2019,Julio,Pakistán,586,0,2,2,"(0.814836,-77.662532)"
2018,Diciembre,Uruguay,858,0,1,1,"(11.360009,-72.129330)"
2022,Julio,Reino Unido de Gran Bretaña e Irlanda del Norte,826,1,0,1,"(4.452882,-75.766298)"
2013,Mayo,Honduras,340,15,36,51,"(3.541112,-76.384584)"
2019,Diciembre,Montenegro,499,4,9,13,"(4.697144,-74.140516)"
2013,Julio,Guatemala,320,0,1,1,"(10.408582,-75.538003)"
2016,Agosto,Burkina Faso,854,0,3,3,"(4.697144,-74.140516)"
2018,Mayo,Portugal,620,0,1,1,"(-4.223468,-69.945098)"
2015,Enero,Malta,470,0,1,1,"(10.445761,-75.516429)"
2013,Mayo,Hungría,348,0,1,1,"(3.541112,-76.384584)"
2018,Enero,Francia,250,2,14,16,"(7.818934,-72.453226)"
2020,Octubre,Cuba,192,4,10,14,"(6.171601,-75.427454)"
2016,Junio,Federación de Rusia,643,0,1,1,"(7.818934,-72.453226)"
2012,Noviembre,Perú,604,25,38,63,"(-4.197703,-69.941278)"
2019,Enero,Austria,40,4,8,12,"(10.886611,-74.776708)"
2012,Diciembre,Guatemala,320,0,2,2,"(4.452882,-75.766298)"
2022,Mayo,Chile,152,2,2,4,"(4.815061,-75.736532)"
2016,Junio,Iraq,368,0,1,1,"(6.171601,-75.427454)"
2013,Junio,República de Corea,410,3,8,11,"(3.541112,-76.384584)"
2017,Octubre,Uzbekistán,860,0,1,1,"(6.171601,-75.427454)"
2016,Junio,Alemania,276,1,5,6,"(4.815061,-75.736532)"
2022,Octubre,Chile,152,402,554,956,"(3.541112,-76.384584)"
2015,Febrero,Venezuela,862,1,7,8,"(4.815061,-75.736532)"
2016,Febrero,República de Belarús,112,9,37,46,"(-4.197703,-69.941278)"
2022,Junio,Sierra Leona,694,0,1,1,"(3.541112,-76.384584)"
2019,Septiembre,Tanzania,834,0,1,1,"(3.541112,-76.384584)"
2020,Febrero,Uzbekistán,860,1,5,6,"(4.697144,-74.140516)"
2015,Enero,Estados Unidos de América,840,17,19,36,"(11.247723,-74.213989)"
2012,Febrero,Rumania,642,0,4,4,"(10.408582,-75.538003)"
2019,Noviembre,Francia,250,192,331,523,"(6.171601,-75.427454)"
2012,Agosto,Suiza,756,13,36,49,"(6.171601,-75.427454)"
2023,Marzo,República Checa,203,87,105,192,"(4.697144,-74.140516)"
2022,Abril,Brasil,76,47,79,126,"(3.541112,-76.384584)"
2022,Septiembre,Argentina,32,3,2,5,"(-4.197703,-69.941278)"
2022,Abril,República de Corea,410,1,0,1,"(4.815061,-75.736532)"
2019,Abril,Federación de Rusia,643,0,5,5,"(3.893038,-77.067921)"
2016,Agosto,Suiza,756,0,1,1,"(4.452882,-75.766298)"
2018,Diciembre,Polonia,616,31,43,74,"(10.445761,-75.516429)"
2012,Agosto,Liechtenstein,438,0,1,1,"(6.171601,-75.427454)"
2022,Julio,Camerún,120,1,11,12,"(4.697144,-74.140516)"
2012,Diciembre,Taiwán,158,3,1,4,"(10.445761,-75.516429)"
2018,Abril,Finlandia,246,3,15,18,"(6.171601,-75.427454)"
2013,Marzo,Bélgica,56,105,265,370,"(4.697144,-74.140516)"
2017,Junio,El Salvador,222,3,3,6,"(10.886611,-74.776708)"
2022,Agosto,España,724,30,44,74,"(10.886611,-74.776708)"
2022,Marzo,Rumania,642,10,11,21,"(10.445761,-75.516429)"
2012,Septiembre,Chile,152,1,2,3,"(4.815061,-75.736532)"
2017,Abril,El Salvador,222,2,5,7,"(0.814836,-77.662532)"
2018,Noviembre,Argentina,32,5,8,13,"(0.25129,-76.875963)"
2017,Julio,República de Belarús,112,2,4,6,"(4.697144,-74.140516)"
2012,Octubre,Italia,380,21,84,105,"(3.541112,-76.384584)"
2016,Noviembre,Ucrania,804,0,1,1,"(3.893038,-77.067921)"
2018,Diciembre,Alemania,276,172,317,489,"(6.171601,-75.427454)"
2019,Julio,Benín,204,0,1,1,"(3.541112,-76.384584)"
2018,Enero,Argentina,32,11,29,40,"(7.818934,-72.453226)"
2020,Enero,Grecia,300,0,4,4,"(3.541112,-76.384584)"
2017,Julio,Italia,380,3,3,6,"(12.586067,-81.702563)"
2022,Septiembre,República de Irlanda,372,18,53,71,"(6.171601,-75.427454)"
2020,Febrero,Uruguay,858,27,19,46,"(10.408582,-75.538003)"
2014,Mayo,Brasil,76,6,9,15,"(11.360009,-72.129330)"
2013,Octubre,Panamá,591,72,144,216,"(3.541112,-76.384584)"
2012,Abril,Ecuador,218,435,553,988,"(6.171601,-75.427454)"
2018,Diciembre,Kenia,404,9,15,24,"(4.697144,-74.140516)"
2013,Diciembre,Costa Rica,188,53,62,115,"(10.445761,-75.516429)"
2013,Mayo,Costa Rica,188,10,26,36,"(10.886611,-74.776708)"
2018,Noviembre,Jamaica,388,3,5,8,"(3.541112,-76.384584)"
2019,Septiembre,Argentina,32,3,11,14,"(0.25129,-76.875963)"
2021,Septiembre,Líbano,422,1,0,1,"(3.541112,-76.384584)"
2022,Marzo,Cuba,192,25,43,68,"(6.171601,-75.427454)"
2021,Julio,Serbia,688,0,1,1,"(10.886611,-74.776708)"
2022,Enero,Suecia,752,14,38,52,"(6.171601,-75.427454)"
2012,Marzo,España,724,1,6,7,"(8.635765,-77.346578)"
2018,Agosto,Bulgaria,100,0,4,4,"(10.971302,-74.765397)"
2022,Julio,Belice,84,8,6,14,"(6.171601,-75.427454)"
2017,Octubre,Reino Unido de Gran Bretaña e Irlanda del Norte,826,29,24,53,"(10.408582,-75.538003)"
2023,Junio,Brasil,76,5,14,19,"(4.815061,-75.736532)"
2015,Diciembre,El Salvador,222,1,1,2,"(7.927209,-72.507910)"
2021,Diciembre,India,356,0,1,1,"(10.971302,-74.765397)"
2014,Marzo,Filipinas,608,0,13,13,"(10.408582,-75.538003)"
2016,Septiembre,Canadá,124,641,1211,1852,"(4.697144,-74.140516)"
2022,Junio,Uzbekistán,860,0,1,1,"(6.171601,-75.427454)"
2021,Febrero,Israel,376,0,13,13,"(10.445761,-75.516429)"
2013,Julio,México,484,113,212,325,"(3.541112,-76.384584)"
2016,Mayo,Cuba,192,13,16,29,"(10.445761,-75.516429)"
2023,Junio,Arabia Saudita,682,0,4,4,"(6.171601,-75.427454)"
2017,Julio,Desconocido,99999,3,5,8,"(6.171601,-75.427454)"
2019,Noviembre,Ucrania,804,0,7,7,"(3.541112,-76.384584)"
2016,Abril,Turquía,792,0,42,42,"(10.445761,-75.516429)"
2018,Diciembre,Panamá,591,1756,2053,3809,"(4.697144,-74.140516)"
2018,Enero,Grecia,300,1,2,3,"(0.814836,-77.662532)"
2015,Enero,Indonesia,360,0,1,1,"(0.814836,-77.662532)"
2015,Junio,Cuba,192,0,7,7,"(10.408582,-75.538003)"
2012,Octubre,México,484,6,22,28,"(7.818934,-72.453226)"
2020,Enero,México,484,0,1,1,"(6.17134,-75.427194)"
2019,Octubre,Israel,376,3,8,11,"(0.814836,-77.662532)"
2021,Noviembre,Lituania,440,1,0,1,"(11.117806,-74.232622)"
2019,Diciembre,República Checa,203,6,3,9,"(10.445761,-75.516429)"
2016,Junio,Ucrania,804,0,1,1,"(3.541112,-76.384584)"
2015,Abril,Israel,376,0,2,2,"(10.408582,-75.538003)"
2021,Enero,Austria,40,1,0,1,"(10.886611,-74.776708)"
2017,Enero,Singapur,702,0,1,1,"(10.886611,-74.776708)"
2012,Enero,Nepal,524,0,3,3,"(4.697144,-74.140516)"
2013,Octubre,Venezuela,862,0,2,2,"(-4.197703,-69.941278)"
2015,Julio,Aruba,533,1,3,4,"(7.128456,-73.183637)"
2012,Febrero,San Cristóbal y Nevis,659,1,1,2,"(4.697144,-74.140516)"
2016,Abril,Líbano,422,9,21,30,"(4.697144,-74.140516)"
2019,Julio,Panamá,591,1,1,2,"(11.360009,-72.129330)"
2014,Julio,Ghana,288,0,1,1,"(12.586067,-81.702563)"
2018,Agosto,Filipinas,608,5,5,10,"(6.171601,-75.427454)"
2022,Octubre,India,356,0,2,2,"(11.247723,-74.213989)"
2021,Julio,Estados Unidos de América,840,1034,1761,2795,"(10.886611,-74.776708)"
2019,Febrero,Estados Unidos de América,840,22,48,70,"(7.128456,-73.183637)"
2012,Julio,Suecia,752,112,164,276,"(4.697144,-74.140516)"
2018,Agosto,Bangladesh,50,1,0,1,"(10.445761,-75.516429)"
2013,Septiembre,República Dominicana,214,215,370,585,"(4.697144,-74.140516)"
2018,Abril,Kuwait,414,0,7,7,"(4.697144,-74.140516)"
2012,Febrero,Francia,250,9,9,18,"(11.360009,-72.129330)"
2018,Julio,Venezuela,862,1,3,4,"(11.117806,-74.232622)"
2019,Agosto,Bolivia,68,44,43,87,"(10.408582,-75.538003)"
2018,Septiembre,Países Bajos,528,2,5,7,"(11.247723,-74.213989)"
2022,Junio,Austria,40,11,11,22,"(10.445761,-75.516429)"
2013,Noviembre,Venezuela,862,69,132,201,"(7.088729,-70.740253)"
2012,Diciembre,Alemania,276,0,1,1,"(6.228046,-77.404104)"
2019,Abril,Kiribati,296,0,1,1,"(11.247723,-74.213989)"
2018,Diciembre,Nicaragua,558,101,106,207,"(4.697144,-74.140516)"
2018,Diciembre,Montenegro,499,0,4,4,"(4.697144,-74.140516)"
2020,Diciembre,Paraguay,600,1,0,1,"(7.128456,-73.183637)"
2023,Febrero,Suecia,752,25,50,75,"(6.171601,-75.427454)"
2019,Noviembre,Argentina,32,10,3,13,"(-4.223468,-69.945098)"
2022,Mayo,Belice,84,1,1,2,"(4.815061,-75.736532)"
2019,Abril,Montenegro,499,0,1,1,"(6.171601,-75.427454)"
2013,Agosto,Bahamas,44,3,1,4,"(4.697144,-74.140516)"
2014,Noviembre,Brasil,76,460,339,799,"(10.445761,-75.516429)"
2016,Noviembre,Estados Unidos de América,840,1653,4285,5938,"(6.171601,-75.427454)"
2017,Agosto,Kenia,404,0,1,1,"(0.25129,-76.875963)"
2017,Noviembre,Senegal,686,0,3,3,"(4.697144,-74.140516)"
2017,Agosto,China,156,10,22,32,"(10.445761,-75.516429)"
2013,Febrero,República Checa,203,1,1,2,"(11.360009,-72.129330)"
2022,Octubre,Sudáfrica,710,1,3,4,"(6.171601,-75.427454)"
2017,Agosto,República Checa,203,1,0,1,"(10.408582,-75.538003)"
2022,Agosto,Ecuador,218,0,1,1,"(-4.223468,-69.945098)"
2016,Junio,Perú,604,0,1,1,"(4.452882,-75.766298)"
2021,Diciembre,Perú,604,1,4,5,"(10.408582,-75.538003)"
2021,Diciembre,Polonia,616,18,33,51,"(10.445761,-75.516429)"
2022,Enero,Alemania,276,0,4,4,"(8.635765,-77.346578)"
2020,Septiembre,Estados Unidos de América,840,0,1,1,"(7.128456,-73.183637)"
2014,Marzo,Noruega,578,0,1,1,"(10.886611,-74.776708)"
2016,Enero,México,484,1,2,3,"(-4.197703,-69.941278)"
2017,Septiembre,Ecuador,218,63,60,123,"(10.445761,-75.516429)"
2022,Noviembre,Islas Fiji,242,1,1,2,"(4.697144,-74.140516)"
2012,Octubre,Brasil,76,190,228,418,"(10.445761,-75.516429)"
2014,Julio,Paraguay,600,9,13,22,"(3.541112,-76.384584)"
2023,Febrero,Noruega,578,34,33,67,"(10.445761,-75.516429)"
2019,Enero,Israel,376,108,404,512,"(4.697144,-74.140516)"
2022,Diciembre,Austria,40,1,4,5,"(4.815061,-75.736532)"
2014,Agosto,Suiza,756,1,3,4,"(7.818934,-72.453226)"
2014,Enero,Palestina,99999,0,5,5,"(4.697144,-74.140516)"
2022,Diciembre,República Dominicana,214,2,7,9,"(4.452882,-75.766298)"
2017,Agosto,Kuwait,414,0,1,1,"(4.697144,-74.140516)"
2022,Marzo,República de Moldavia,498,0,1,1,"(6.171601,-75.427454)"
2013,Abril,Jamaica,388,1,0,1,"(11.360009,-72.129330)"
2015,Enero,Cuba,192,0,1,1,"(-4.197703,-69.941278)"
2014,Marzo,China,156,2,1,3,"(8.635765,-77.346578)"
2023,Febrero,Bermudas/Territorio Británico de Ultramar,60,3,4,7,"(10.445761,-75.516429)"
2014,Junio,Bélgica,56,143,286,429,"(4.697144,-74.140516)"
2016,Diciembre,China,156,0,1,1,"(12.586067,-81.702563)"
2016,Octubre,Polonia,616,12,5,17,"(-4.197703,-69.941278)"
2014,Mayo,Venezuela,862,14,21,35,"(6.185799,-67.483929)"
2023,Abril,Trinidad y Tobago,780,0,1,1,"(4.815061,-75.736532)"
2014,Agosto,Haití,332,12,27,39,"(4.697144,-74.140516)"
2015,Abril,Liechtenstein,438,1,1,2,"(3.541112,-76.384584)"
2012,Noviembre,Nicaragua,558,0,3,3,"(10.886611,-74.776708)"
2016,Agosto,Samoa Estadounidense/Territorio no incorporado de Estados Unidos,16,0,1,1,"(4.697144,-74.140516)"
2019,Octubre,Bulgaria,100,2,3,5,"(3.541112,-76.384584)"
2015,Marzo,España,724,3,9,12,"(7.927209,-72.507910)"
2015,Agosto,Líbano,422,1,3,4,"(10.445761,-75.516429)"
2019,Abril,Chile,152,4,8,12,"(11.360009,-72.129330)"
2013,Marzo,Italia,380,1,0,1,"(7.128456,-73.183637)"
2014,Agosto,Guatemala,320,3,4,7,"(4.815061,-75.736532)"
2013,Diciembre,Bélgica,56,0,1,1,"(7.818934,-72.453226)"
2016,Octubre,Brasil,76,129,144,273,"(3.541112,-76.384584)"
2019,Agosto,Nueva Zelanda,554,70,96,166,"(4.697144,-74.140516)"
2022,Junio,Ecuador,218,1,2,3,"(7.927209,-72.507910)"
2016,Abril,Guatemala,320,1,2,3,"(7.818934,-72.453226)"
2019,Noviembre,Chipre,196,1,1,2,"(10.445761,-75.516429)"
2012,Octubre,República de Corea,410,2,3,5,"(0.814836,-77.662532)"
2017,Junio,Dinamarca,208,0,1,1,"(7.128456,-73.183637)"
2018,Julio,República de Irlanda,372,8,9,17,"(10.408582,-75.538003)"
2019,Junio,Panamá,591,1889,1524,3413,"(6.171601,-75.427454)"
2019,Diciembre,Grecia,300,1,0,1,"(10.886611,-74.776708)"
2016,Abril,Israel,376,0,1,1,"(11.360009,-72.129330)"
2014,Mayo,Perú,604,1,5,6,"(7.128456,-73.183637)"
2012,Mayo,Dinamarca,208,5,6,11,"(0.814836,-77.662532)"
2016,Mayo,Dominica,212,0,1,1,"(6.171601,-75.427454)"
2013,Septiembre,Letonia,428,2,1,3,"(10.445761,-75.516429)"
2023,Febrero,República Árabe Siria,760,0,39,39,"(10.408582,-75.538003)"
2014,Diciembre,Guatemala,320,338,474,812,"(4.697144,-74.140516)"
2015,Diciembre,Italia,380,62,144,206,"(10.445761,-75.516429)"
2012,Abril,España,724,1,5,6,"(-4.197703,-69.941278)"
2015,Mayo,España,724,0,1,1,"(1.813928,-78.763924)"
2017,Diciembre,Venezuela,862,3,5,8,"(4.815061,-75.736532)"
2021,Enero,República de Belarús,112,1,0,1,"(10.445761,-75.516429)"
2022,Noviembre,Malasia,458,7,6,13,"(3.541112,-76.384584)"
2018,Septiembre,Etiopia,231,2,1,3,"(6.171601,-75.427454)"
2015,Octubre,República Checa,203,1,0,1,"(10.445761,-75.516429)"
2012,Septiembre,Países Bajos,528,1,3,4,"(11.360009,-72.129330)"
2013,Enero,India,356,2,9,11,"(10.445761,-75.516429)"
2019,Febrero,China,156,0,3,3,"(9.402978,-75.681599)"
2022,Enero,Honduras,340,253,227,480,"(4.697144,-74.140516)"
2017,Noviembre,Estados Unidos de América,840,2433,6192,8625,"(6.171601,-75.427454)"
2022,Septiembre,México,484,4,4,8,"(7.916725,-72.462544)"
2016,Noviembre,Uruguay,858,5,1,6,"(10.408582,-75.538003)"
2019,Octubre,Trinidad y Tobago,780,5,11,16,"(6.171601,-75.427454)"
2017,Marzo,Túnez,788,0,1,1,"(10.408582,-75.538003)"
2019,Noviembre,Argentina,32,60,75,135,"(0.814836,-77.662532)"
2016,Septiembre,Noruega,578,79,133,212,"(4.697144,-74.140516)"
2015,Mayo,España,724,0,1,1,"(-4.223468,-69.945098)"
2021,Enero,Malta,470,0,1,1,"(10.445761,-75.516429)"
2022,Septiembre,Canadá,124,0,1,1,"(7.927209,-72.507910)"
2013,Febrero,Australia,36,12,31,43,"(10.408582,-75.538003)"
2015,Septiembre,Noruega,578,3,12,15,"(6.171601,-75.427454)"
2016,Abril,Irán,364,0,1,1,"(3.541112,-76.384584)"
2015,Julio,Grecia,300,0,1,1,"(10.408582,-75.538003)"
2021,Junio,Francia,250,1,1,2,"(0.814836,-77.662532)"
2020,Enero,Panamá,591,579,593,1172,"(10.445761,-75.516429)"
2018,Agosto,Filipinas,608,0,30,30,"(3.893038,-77.067921)"
2014,Febrero,Alemania,276,1499,2293,3792,"(4.697144,-74.140516)"
2014,Enero,Filipinas,608,0,1,1,"(11.360009,-72.129330)"
2013,Noviembre,Islandia,352,0,1,1,"(6.171601,-75.427454)"
2017,Marzo,Polonia,616,0,1,1,"(4.815061,-75.736532)"
2017,Febrero,China,156,409,802,1211,"(4.697144,-74.140516)"
2016,Febrero,Mongolia,496,2,0,2,"(4.697144,-74.140516)"
2017,Noviembre,Nueva Zelanda,554,1,2,3,"(11.247723,-74.213989)"
2013,Julio,Paraguay,600,17,22,39,"(10.445761,-75.516429)"
2023,Abril,República Checa,203,0,2,2,"(10.886611,-74.776708)"
2015,Diciembre,Nicaragua,558,2,0,2,"(12.586067,-81.702563)"
2022,Marzo,Bosnia y Herzegovina,70,1,0,1,"(10.971302,-74.765397)"
2019,Mayo,Panamá,591,0,1,1,"(1.813928,-78.763924)"
2013,Agosto,Belice,84,0,1,1,"(10.445761,-75.516429)"
2017,Marzo,Australia,36,0,1,1,"(11.247723,-74.213989)"
2019,Mayo,Países Bajos,528,6,11,17,"(8.635765,-77.346578)"
2021,Noviembre,Panamá,591,509,495,1004,"(3.541112,-76.384584)"
2023,Abril,Federación de Rusia,643,1,5,6,"(3.541112,-76.384584)"
2019,Marzo,Panamá,591,16,11,27,"(7.128456,-73.183637)"
2012,Junio,Nueva Zelanda,554,37,61,98,"(4.697144,-74.140516)"
2018,Abril,Nigeria,566,1,0,1,"(6.171601,-75.427454)"
2013,Febrero,Países Bajos,528,4,5,9,"(11.360009,-72.129330)"
2012,Mayo,Emiratos Árabes,784,2,9,11,"(4.697144,-74.140516)"
2016,Abril,España,724,0,7,7,"(11.360009,-72.129330)"
2019,Enero,España,724,4,2,6,"(11.117806,-74.232622)"
2018,Junio,Panamá,591,5,8,13,"(0.814836,-77.662532)"
2017,Noviembre,Surinam,740,1,1,2,"(7.818934,-72.453226)"
2020,Marzo,Paraguay,600,53,17,70,"(10.445761,-75.516429)"
2013,Mayo,Trinidad y Tobago,780,1,2,3,"(3.541112,-76.384584)"
2023,Abril,Uruguay,858,2,14,16,"(10.886611,-74.776708)"
2017,Abril,Ucrania,804,0,1,1,"(9.402978,-75.681599)"
2012,Marzo,Costa Rica,188,0,1,1,"(10.408582,-75.538003)"
2022,Enero,Filipinas,608,0,23,23,"(10.408582,-75.538003)"
2014,Marzo,Federación de Rusia,643,188,228,416,"(4.697144,-74.140516)"
2018,Septiembre,Federación de Rusia,643,1,0,1,"(7.818934,-72.453226)"
2017,Mayo,Malta,470,0,2,2,"(8.635765,-77.346578)"
2021,Octubre,Filipinas,608,0,24,24,"(10.971302,-74.765397)"
2015,Enero,República de Irlanda,372,1,1,2,"(-4.197703,-69.941278)"
2016,Septiembre,Singapur,702,10,18,28,"(4.697144,-74.140516)"
2020,Agosto,Ucrania,804,0,5,5,"(4.697144,-74.140516)"
2012,Julio,Sudáfrica,710,1,4,5,"(6.171601,-75.427454)"
2020,Septiembre,Estados Unidos de América,840,249,708,957,"(4.697144,-74.140516)"
2012,Enero,Pakistán,586,1,0,1,"(10.445761,-75.516429)"
2017,Mayo,Singapur,702,11,26,37,"(4.697144,-74.140516)"
2012,Noviembre,Dinamarca,208,5,3,8,"(0.814836,-77.662532)"
2013,Marzo,Uruguay,858,31,29,60,"(12.586067,-81.702563)"
2013,Junio,Japón,392,3,6,9,"(10.445761,-75.516429)"
2020,Marzo,México,484,1,2,3,"(7.128456,-73.183637)"
2019,Diciembre,Vietnam,704,10,10,20,"(4.697144,-74.140516)"
2013,Septiembre,Chile,152,2953,3797,6750,"(4.697144,-74.140516)"
2014,Mayo,Kenia,404,5,9,14,"(4.697144,-74.140516)"
2017,Agosto,China,156,4,7,11,"(7.818934,-72.453226)"
2021,Julio,Reino Unido de Gran Bretaña e Irlanda del Norte,826,28,100,128,"(6.171601,-75.427454)"
2016,Junio,Francia,250,2,3,5,"(13.3387613,-81.372937)"
2014,Junio,México,484,3,11,14,"(-4.197703,-69.941278)"
2021,Noviembre,República de Corea,410,0,1,1,"(10.408582,-75.538003)"
2014,Mayo,Estados Unidos de América,840,1,1,2,"(6.185799,-67.483929)"
2016,Octubre,Austria,40,8,7,15,"(3.541112,-76.384584)"
2019,Febrero,Filipinas,608,3,2,5,"(6.171601,-75.427454)"
2016,Septiembre,Reino Unido de Gran Bretaña e Irlanda del Norte,826,61,170,231,"(6.171601,-75.427454)"
2017,Mayo,Ecuador,218,13,17,30,"(10.886611,-74.776708)"
2020,Enero,Italia,380,2,1,3,"(11.528919,-72.919681)"
2012,Junio,España,724,1,2,3,"(7.927209,-72.507910)"
2022,Julio,Antigua y Barbuda,28,0,1,1,"(11.360009,-72.129330)"
2022,Diciembre,Países Bajos,528,1,0,1,"(7.088729,-70.740253)"
2023,Enero,República de Corea,410,0,1,1,"(10.408582,-75.538003)"
2014,Octubre,Mongolia,496,3,0,3,"(4.697144,-74.140516)"
2015,Abril,México,484,3616,6864,10480,"(4.697144,-74.140516)"
2021,Diciembre,Paraguay,600,3,5,8,"(10.886611,-74.776708)"
2021,Abril,Eslovenia,705,2,2,4,"(10.445761,-75.516429)"
2018,Diciembre,Venezuela,862,6,5,11,"(-4.223468,-69.945098)"
2022,Agosto,España,724,3,10,13,"(4.452882,-75.766298)"
2018,Abril,Sudáfrica,710,2,5,7,"(10.445761,-75.516429)"
2014,Agosto,Alemania,276,1954,2460,4414,"(4.697144,-74.140516)"
2022,Febrero,Ecuador,218,0,4,4,"(8.635765,-77.346578)"
2022,Enero,Estados Unidos de América,840,22,46,68,"(12.586067,-81.702563)"
2012,Octubre,Líbano,422,0,2,2,"(3.541112,-76.384584)"
2018,Junio,Argentina,32,70,121,191,"(0.814836,-77.662532)"
2013,Febrero,Honduras,340,21,26,47,"(6.171601,-75.427454)"
2014,Febrero,Mongolia,496,0,1,1,"(10.445761,-75.516429)"
2017,Febrero,República de Corea,410,0,1,1,"(-4.197703,-69.941278)"
2019,Mayo,España,724,5,5,10,"(0.25129,-76.875963)"
2017,Julio,Jamaica,388,3,15,18,"(10.445761,-75.516429)"
2016,Mayo,Francia,250,1,1,2,"(11.360009,-72.129330)"
2012,Marzo,Suecia,752,0,5,5,"(-4.197703,-69.941278)"
2013,Agosto,Canadá,124,4,4,8,"(12.586067,-81.702563)"
2016,Mayo,Vietnam,704,1,0,1,"(3.541112,-76.384584)"
2022,Marzo,Países Bajos,528,1,0,1,"(4.452882,-75.766298)"
2012,Diciembre,Pakistán,586,0,1,1,"(7.818934,-72.453226)"
2022,Marzo,Croacia,191,1,0,1,"(7.818934,-72.453226)"
2023,Junio,Chile,152,41,33,74,"(11.117806,-74.232622)"
2016,Marzo,Croacia,191,0,2,2,"(10.408582,-75.538003)"
2022,Febrero,Islas Caimán/Territorio Británico de Ultramar,136,0,1,1,"(10.445761,-75.516429)"
2013,Julio,Marruecos,504,0,1,1,"(0.814836,-77.662532)"
2018,Febrero,República Dominicana,214,0,3,3,"(11.117806,-74.232622)"
2015,Abril,Brunei Darussalam,96,1,0,1,"(0.814836,-77.662532)"
2016,Septiembre,Austria,40,8,14,22,"(6.171601,-75.427454)"
2014,Julio,Argentina,32,118,258,376,"(6.171601,-75.427454)"
2019,Noviembre,Montenegro,499,0,1,1,"(0.814836,-77.662532)"
2018,Abril,Suiza,756,2,4,6,"(-4.223468,-69.945098)"
2017,Enero,Polonia,616,11,24,35,"(3.541112,-76.384584)"
2018,Noviembre,República de Irlanda,372,3,10,13,"(0.814836,-77.662532)"
2023,Mayo,Reino Unido de Gran Bretaña e Irlanda del Norte,826,23,47,70,"(3.541112,-76.384584)"
2015,Noviembre,Grecia,300,1,1,2,"(-4.197703,-69.941278)"
2015,Agosto,República de Moldavia,498,3,1,4,"(4.697144,-74.140516)"
2012,Diciembre,Costa Rica,188,1,0,1,"(0.25129,-76.875963)"
2012,Febrero,Argentina,32,11,30,41,"(10.886611,-74.776708)"
2018,Mayo,Venezuela,862,1759,2426,4185,"(0.814836,-77.662532)"
2016,Noviembre,Brasil,76,620,442,1062,"(12.586067,-81.702563)"
2020,Noviembre,Suecia,752,1,1,2,"(3.541112,-76.384584)"
2020,Enero,Argelia,12,1,0,1,"(7.818934,-72.453226)"
2012,Mayo,Estados Unidos de América,840,43,70,113,"(4.815061,-75.736532)"
2021,Noviembre,Canadá,124,1,4,5,"(7.128456,-73.183637)"
2012,Mayo,Sudáfrica,710,0,1,1,"(3.541112,-76.384584)"
2022,Diciembre,Ucrania,804,0,1,1,"(6.18189,-67.47535)"
2023,Marzo,Taiwán,158,0,1,1,"(0.814836,-77.662532)"
2017,Mayo,Guatemala,320,19,54,73,"(3.541112,-76.384584)"
2016,Marzo,Chipre,196,0,1,1,"(3.541112,-76.384584)"
2018,Abril,Ecuador,218,8,32,40,"(10.408582,-75.538003)"
2019,Diciembre,Estados Unidos de América,840,2,8,10,"(12.5744111,-81.703935)"
2022,Octubre,Alemania,276,0,1,1,"(11.360009,-72.129330)"
2022,Febrero,Costa Rica,188,5,9,14,"(4.815061,-75.736532)"
2022,Junio,El Salvador,222,0,3,3,"(12.586067,-81.702563)"
2012,Febrero,Federación de Rusia,643,0,1,1,"(11.360009,-72.129330)"
2017,Abril,Reino Unido de Gran Bretaña e Irlanda del Norte,826,0,15,15,"(10.971302,-74.765397)"
2021,Mayo,Federación de Rusia,643,11,5,16,"(6.171601,-75.427454)"
2014,Marzo,Suecia,752,2,1,3,"(7.818934,-72.453226)"
2012,Junio,México,484,0,1,1,"(3.893038,-77.067921)"
2013,Octubre,Tanzania,834,1,4,5,"(10.445761,-75.516429)"
2022,Marzo,Camerún,120,1,1,2,"(4.697144,-74.140516)"
2018,Febrero,Suecia,752,6,7,13,"(10.886611,-74.776708)"
2012,Julio,Eslovenia,705,0,2,2,"(10.445761,-75.516429)"
2019,Abril,Suecia,752,1,4,5,"(-4.223468,-69.945098)"
2014,Junio,Argentina,32,8,16,24,"(7.818934,-72.453226)"
2012,Mayo,Canadá,124,2,5,7,"(-4.197703,-69.941278)"
2016,Abril,Panamá,591,0,1,1,"(7.818934,-72.453226)"
2022,Julio,Países Bajos,528,3066,3629,6696,"(4.697144,-74.140516)"
2016,Agosto,Italia,380,9,23,32,"(7.818934,-72.453226)"
2017,Abril,Emiratos Árabes,784,1,11,12,"(4.697144,-74.140516)"
2023,Enero,Luxemburgo,442,0,1,1,"(0.25129,-76.875963)"
2022,Septiembre,Italia,380,0,2,2,"(7.128456,-73.183637)"
2014,Septiembre,Grecia,300,1,1,2,"(11.247723,-74.213989)"
2014,Octubre,Ecuador,218,1,19,20,"(10.408582,-75.538003)"
2016,Abril,Canadá,124,110,167,277,"(10.445761,-75.516429)"
2013,Marzo,Croacia,191,0,1,1,"(11.360009,-72.129330)"
2016,Agosto,Brasil,76,30,39,69,"(10.886611,-74.776708)"
2014,Mayo,Ecuador,218,1,0,1,"(8.635765,-77.346578)"
2019,Enero,Liberia,430,1,0,1,"(4.697144,-74.140516)"
2017,Noviembre,México,484,0,1,1,"(4.452882,-75.766298)"
2016,Abril,Bélgica,56,0,2,2,"(7.128456,-73.183637)"
2014,Junio,España,724,0,1,1,"(11.247723,-74.213989)"
2018,Julio,Benín,204,0,3,3,"(4.697144,-74.140516)"
2013,Septiembre,Austria,40,2,3,5,"(3.541112,-76.384584)"
2023,Mayo,España,724,1,4,5,"(-4.197703,-69.941278)"
2013,Noviembre,China,156,0,1,1,"(7.818934,-72.453226)"
2013,Diciembre,Australia,36,2,8,10,"(8.635765,-77.346578)"
2021,Mayo,Croacia,191,0,1,1,"(3.541112,-76.384584)"
2019,Diciembre,Belice,84,0,3,3,"(6.171601,-75.427454)"
2016,Enero,República Checa,203,3,5,8,"(3.541112,-76.384584)"
2021,Octubre,Canadá,124,130,398,528,"(6.171601,-75.427454)"
2023,Marzo,Estados Unidos de América,840,15,24,39,"(-4.197703,-69.941278)"
2019,Septiembre,Uganda,800,0,1,1,"(10.445761,-75.516429)"
2012,Marzo,Japón,392,1,3,4,"(7.818934,-72.453226)"
2015,Noviembre,Filipinas,608,0,18,18,"(10.971302,-74.765397)"
2014,Junio,Ecuador,218,3,6,9,"(10.886611,-74.776708)"
2013,Diciembre,Tuvalu,798,0,4,4,"(10.408582,-75.538003)"
2023,Junio,Santa Lucia,662,2,3,5,"(10.445761,-75.516429)"
2019,Febrero,Bangladesh,50,2,0,2,"(10.445761,-75.516429)"
2019,Diciembre,Uruguay,858,5,22,27,"(3.541112,-76.384584)"
2017,Junio,Filipinas,608,1,29,30,"(3.541112,-76.384584)"
2019,Abril,Australia,36,48,57,105,"(10.445761,-75.516429)"
2017,Julio,Túnez,788,4,8,12,"(4.697144,-74.140516)"
2019,Diciembre,República Dominicana,214,1,5,6,"(-4.197703,-69.941278)"
2019,Septiembre,Suiza,756,1,4,5,"(-4.223468,-69.945098)"
2023,Abril,Finlandia,246,1,0,1,"(10.408582,-75.538003)"
2015,Abril,Bolivia,68,0,4,4,"(10.408582,-75.538003)"
2018,Septiembre,Filipinas,608,0,15,15,"(10.886611,-74.776708)"
2019,Julio,San Cristóbal y Nevis,659,1,4,5,"(6.171601,-75.427454)"
2012,Abril,Israel,376,2,85,87,"(6.171601,-75.427454)"
2021,Diciembre,Perú,604,1016,1143,2159,"(6.171601,-75.427454)"
2018,Diciembre,Países Bajos,528,8,9,17,"(8.635765,-77.346578)"
2019,Marzo,Canadá,124,1339,1427,2766,"(10.445761,-75.516429)"
2016,Febrero,Perú,604,2,1,3,"(7.128456,-73.183637)"
2019,Diciembre,Palau,585,0,1,1,"(4.697144,-74.140516)"
2020,Febrero,Islandia,352,7,11,18,"(4.697144,-74.140516)"
2018,Julio,Croacia,191,0,4,4,"(10.445761,-75.516429)"
2013,Marzo,Federación de Rusia,643,1,0,1,"(11.360009,-72.129330)"
2023,Enero,Santa Lucia,662,0,1,1,"(6.171601,-75.427454)"
2016,Abril,Federación de Rusia,643,0,2,2,"(11.360009,-72.129330)"
2013,Diciembre,Uruguay,858,111,234,345,"(4.697144,-74.140516)"
2019,Abril,Canadá,124,73,92,165,"(3.541112,-76.384584)"
2020,Febrero,Brasil,76,353,300,653,"(12.586067,-81.702563)"
2016,Febrero,Trinidad y Tobago,780,1,1,2,"(4.815061,-75.736532)"
2012,Abril,Honduras,340,0,1,1,"(-4.197703,-69.941278)"
2012,Mayo,Alemania,276,1,7,8,"(10.886611,-74.776708)"
2015,Marzo,Georgia,268,4,11,15,"(4.697144,-74.140516)"
2016,Febrero,Honduras,340,20,21,41,"(3.541112,-76.384584)"
2019,Noviembre,Myanmar,104,0,1,1,"(4.697144,-74.140516)"
2022,Enero,República Checa,203,0,1,1,"(0.814836,-77.662532)"
2017,Mayo,Letonia,428,0,4,4,"(10.408582,-75.538003)"
2022,Mayo,Alemania,276,109,256,365,"(6.171601,-75.427454)"
2021,Diciembre,Australia,36,7,12,19,"(10.886611,-74.776708)"
2022,Junio,Filipinas,608,0,16,16,"(9.402978,-75.681599)"
2020,Febrero,Chile,152,57,59,116,"(12.586067,-81.702563)"
2012,Febrero,Federación de Rusia,643,4,4,8,"(10.408582,-75.538003)"
2012,Noviembre,Japón,392,3,13,16,"(10.445761,-75.516429)"
2015,Mayo,Estados Unidos de América,840,146,172,318,"(4.815061,-75.736532)"
2014,Noviembre,Líbano,422,0,1,1,"(10.886611,-74.776708)"
2012,Diciembre,China,156,2,2,4,"(10.445761,-75.516429)"
2014,Mayo,Reino Unido de Gran Bretaña e Irlanda del Norte,826,28,78,106,"(10.445761,-75.516429)"
2020,Febrero,Filipinas,608,1,0,1,"(7.128456,-73.183637)"
2013,Noviembre,México,484,26,61,87,"(7.818934,-72.453226)"
2015,Enero,Ghana,288,3,4,7,"(4.697144,-74.140516)"
2017,Mayo,Cuba,192,166,285,451,"(4.697144,-74.140516)"
2022,Abril,Malasia,458,2,1,3,"(10.408582,-75.538003)"
2023,Junio,Italia,380,1,1,2,"(-4.197703,-69.941278)"
2015,Abril,Federación de Rusia,643,6,5,11,"(10.445761,-75.516429)"
2019,Mayo,Guinea,324,0,2,2,"(4.697144,-74.140516)"
2018,Febrero,Países Bajos,528,2,2,4,"(12.586067,-81.702563)"
2012,Marzo,Namibia,516,0,1,1,"(4.697144,-74.140516)"
2016,Abril,India,356,0,1,1,"(7.927209,-72.507910)"
2013,Abril,Lituania,440,0,3,3,"(10.408582,-75.538003)"
2012,Enero,Federación de Rusia,643,1,0,1,"(4.815061,-75.736532)"
2013,Junio,Países Bajos,528,6,19,25,"(3.541112,-76.384584)"
2019,Diciembre,Sudáfrica,710,0,1,1,"(3.541112,-76.384584)"
2021,Noviembre,Zimbabue,716,0,1,1,"(10.445761,-75.516429)"
2016,Octubre,Lituania,440,31,30,61,"(4.697144,-74.140516)"
2017,Noviembre,Argentina,32,13,39,52,"(10.886611,-74.776708)"
2016,Junio,Canadá,124,0,3,3,"(13.3387613,-81.372937)"
2014,Junio,Canadá,124,7,4,11,"(4.815061,-75.736532)"
2014,Diciembre,Reino Unido de Gran Bretaña e Irlanda del Norte,826,0,6,6,"(3.893038,-77.067921)"
2017,Febrero,Brasil,76,0,1,1,"(12.5744111,-81.703935)"
2018,Noviembre,Costa Rica,188,33,27,60,"(10.886611,-74.776708)"
2013,Noviembre,Angola,24,3,1,4,"(4.697144,-74.140516)"
2023,Mayo,Myanmar,104,0,1,1,"(10.408582,-75.538003)"
2018,Mayo,Irán,364,7,18,25,"(4.697144,-74.140516)"
2012,Diciembre,Países Bajos,528,33,47,80,"(4.452882,-75.766298)"
2022,Abril,Alemania,276,7,4,11,"(8.635765,-77.346578)"
2023,Enero,Chile,152,996,1052,2049,"(3.541112,-76.384584)"
2012,Noviembre,Reino Unido de Gran Bretaña e Irlanda del Norte,826,7,22,29,"(6.171601,-75.427454)"
2018,Febrero,Reino Unido de Gran Bretaña e Irlanda del Norte,826,1,2,3,"(12.586067,-81.702563)"
2022,Mayo,Hong Kong,344,0,1,1,"(8.36068,-72.409396)"
2022,Septiembre,Mozambique,508,1,0,1,"(10.445761,-75.516429)"
2021,Junio,Chile,152,6,7,13,"(7.818934,-72.453226)"
2017,Febrero,Hong Kong,344,2,0,2,"(0.814836,-77.662532)"
2016,Octubre,Federación de Rusia,643,9,16,25,"(10.445761,-75.516429)"
2021,Julio,República de Armenia,51,0,1,1,"(4.697144,-74.140516)"
2017,Noviembre,Bélgica,56,0,1,1,"(8.36068,-72.409396)"
2022,Agosto,Malasia,458,6,10,16,"(4.697144,-74.140516)"
2018,Octubre,Iraq,368,0,1,1,"(4.697144,-74.140516)"
2013,Junio,Portugal,620,0,3,3,"(0.814836,-77.662532)"
2013,Octubre,Panamá,591,16,32,48,"(12.586067,-81.702563)"
2021,Julio,Países Bajos,528,0,4,4,"(10.971302,-74.765397)"
2022,Septiembre,Bélgica,56,4,3,7,"(3.541112,-76.384584)"
2019,Febrero,Costa Rica,188,9,15,24,"(10.886611,-74.776708)"
2013,Agosto,Chile,152,50,32,82,"(10.408582,-75.538003)"
2018,Noviembre,Lituania,440,2,3,5,"(3.541112,-76.384584)"
2018,Octubre,Suiza,756,46,43,89,"(10.445761,-75.516429)"
2013,Julio,Portugal,620,0,2,2,"(7.927209,-72.507910)"
2014,Septiembre,Bahamas,44,0,1,1,"(6.171601,-75.427454)"
2018,Agosto,Dinamarca,208,1,0,1,"(10.408582,-75.538003)"
2015,Septiembre,Israel,376,0,1,1,"(11.247723,-74.213989)"
2016,Diciembre,Cuba,192,1,0,1,"(12.586067,-81.702563)"
2014,Agosto,Francia,250,11,21,32,"(-4.197703,-69.941278)"
2019,Enero,Venezuela,862,171,219,390,"(10.886611,-74.776708)"
2018,Noviembre,Santa Sede/Ciudad del Vaticano,336,0,1,1,"(4.697144,-74.140516)"
2023,Marzo,Serbia,688,0,1,1,"(10.408582,-75.538003)"
2021,Mayo,Reino Unido de Gran Bretaña e Irlanda del Norte,826,0,2,2,"(4.452882,-75.766298)"
2016,Agosto,Brasil,76,3,12,15,"(3.866713,-67.927521)"
2020,Marzo,Bélgica,56,3,2,5,"(10.408582,-75.538003)"
2022,Mayo,República Dominicana,214,6,11,17,"(0.814836,-77.662532)"
2019,Julio,Santa Sede/Ciudad del Vaticano,336,0,1,1,"(4.697144,-74.140516)"
2020,Marzo,Honduras,340,21,19,40,"(10.445761,-75.516429)"
2018,Septiembre,Líbano,422,0,1,1,"(11.360009,-72.129330)"
2017,Noviembre,República de Belarús,112,8,13,21,"(4.697144,-74.140516)"
2023,Febrero,Alemania,276,12,13,25,"(-4.197703,-69.941278)"
2013,Diciembre,San Cristóbal y Nevis,659,1,1,2,"(4.697144,-74.140516)"
2022,Julio,India,356,0,6,6,"(10.886611,-74.776708)"
2023,Enero,Francia,250,1,2,3,"(6.18189,-67.47535)"
2017,Julio,Macedonia,807,0,1,1,"(3.541112,-76.384584)"
2013,Septiembre,Japón,392,9,32,41,"(6.171601,-75.427454)"
2023,Febrero,Cuba,192,129,189,318,"(4.697144,-74.140516)"
2016,Marzo,Grecia,300,0,1,1,"(0.25129,-76.875963)"
2013,Junio,Suiza,756,2,5,7,"(-4.197703,-69.941278)"
2014,Octubre,India,356,1,7,8,"(10.886611,-74.776708)"
2021,Febrero,Costa Rica,188,14,15,29,"(3.541112,-76.384584)"
2022,Septiembre,Estados Unidos de América,840,0,1,1,"(6.18189,-67.47535)"
2013,Julio,Líbano,422,0,1,1,"(6.171601,-75.427454)"
2013,Septiembre,Mozambique,508,1,0,1,"(3.541112,-76.384584)"
2016,Octubre,Honduras,340,0,2,2,"(13.3387613,-81.372937)"
2019,Marzo,Bolivia,68,530,643,1175,"(4.697144,-74.140516)"
2013,Diciembre,Panamá,591,8,11,19,"(8.635765,-77.346578)"
2017,Abril,Desconocido,99999,15,8,23,"(10.445761,-75.516429)"
2023,Febrero,Estados Unidos de América,840,2,2,4,"(8.066966,-76.735404)"
2019,Octubre,Santa Lucia,662,0,1,1,"(6.171601,-75.427454)"
2017,Septiembre,Guatemala,320,0,1,1,"(10.408582,-75.538003)"
2015,Marzo,Vietnam,704,4,1,5,"(4.697144,-74.140516)"
2014,Junio,Estados Unidos de América,840,10,8,18,"(11.360009,-72.129330)"
2016,Agosto,Desconocido,99999,0,1,1,"(10.886611,-74.776708)"
2017,Agosto,Nepal,524,0,1,1,"(0.814836,-77.662532)"
2023,Febrero,Estados Unidos de América,840,10,17,27,"(7.818934,-72.453226)"
2015,Noviembre,Israel,376,7,14,21,"(0.814836,-77.662532)"
2018,Junio,Suiza,756,8,3,11,"(8.635765,-77.346578)"
2020,Enero,Suecia,752,0,1,1,"(0.25129,-76.875963)"
2023,Mayo,India,356,0,42,42,"(10.971302,-74.765397)"
2020,Febrero,Lituania,440,9,15,24,"(6.171601,-75.427454)"
2023,Febrero,Suiza,756,1,3,4,"(-4.223468,-69.945098)"
2017,Febrero,Honduras,340,1,0,1,"(0.814836,-77.662532)"
2016,Diciembre,Estados Unidos de América,840,41,74,115,"(10.408582,-75.538003)"
2021,Noviembre,Croacia,191,0,1,1,"(11.247723,-74.213989)"
2016,Diciembre,Líbano,422,1,0,1,"(6.171601,-75.427454)"
2022,Septiembre,Ecuador,218,0,49,49,"(10.408582,-75.538003)"
2013,Diciembre,China,156,1,1,2,"(4.452882,-75.766298)"
2019,Abril,San  Vicente y las Granadinas,670,3,1,4,"(4.697144,-74.140516)"
2013,Junio,México,484,6,27,33,"(7.818934,-72.453226)"
2017,Enero,Costa Rica,188,216,141,357,"(12.586067,-81.702563)"
2015,Marzo,Federación de Rusia,643,1,5,6,"(7.818934,-72.453226)"
2013,Enero,Perú,604,0,2,2,"(7.128456,-73.183637)"
2022,Diciembre,Italia,380,0,2,2,"(8.635765,-77.346578)"
2022,Agosto,Países Bajos,528,64,74,138,"(3.541112,-76.384584)"
2013,Julio,Uruguay,858,163,358,521,"(4.697144,-74.140516)"
2021,Octubre,Bulgaria,100,2,0,2,"(10.886611,-74.776708)"
2016,Mayo,Azerbaiyán,31,3,4,7,"(4.697144,-74.140516)"
2014,Junio,México,484,50,129,179,"(3.541112,-76.384584)"
2017,Abril,Lituania,440,1,1,2,"(0.814836,-77.662532)"
2021,Noviembre,Francia,250,1199,2116,3315,"(4.697144,-74.140516)"
2017,Julio,Bután,64,0,3,3,"(4.697144,-74.140516)"
2015,Agosto,República de Irlanda,372,14,30,44,"(6.171601,-75.427454)"
2022,Enero,Pakistán,586,0,6,6,"(4.697144,-74.140516)"
2016,Mayo,Haití,332,2,14,16,"(4.697144,-74.140516)"
2019,Marzo,Islandia,352,15,22,37,"(4.697144,-74.140516)"
2022,Octubre,Francia,250,102,114,216,"(10.445761,-75.516429)"
2018,Septiembre,España,724,21,24,45,"(10.408582,-75.538003)"
2017,Mayo,Estados Unidos de América,840,494,903,1397,"(10.886611,-74.776708)"
2022,Septiembre,Ecuador,218,5,10,15,"(11.360009,-72.129330)"
2020,Septiembre,Países Bajos,528,3,4,7,"(6.171601,-75.427454)"
2016,Agosto,Jordania,400,0,1,1,"(10.445761,-75.516429)"
2013,Septiembre,Uruguay,858,1,4,5,"(11.360009,-72.129330)"
2022,Mayo,Brunei Darussalam,96,1,0,1,"(4.697144,-74.140516)"
2018,Julio,Honduras,340,4,53,57,"(10.886611,-74.776708)"
2016,Septiembre,Costa Rica,188,109,158,267,"(6.171601,-75.427454)"
2018,Agosto,Islandia,352,5,8,13,"(10.445761,-75.516429)"
2014,Julio,Ucrania,804,0,5,5,"(10.408582,-75.538003)"
2018,Septiembre,Venezuela,862,58,98,156,"(0.25129,-76.875963)"
2018,Diciembre,Estados Unidos de América,840,2,1,3,"(6.228046,-77.404104)"
2022,Marzo,Túnez,788,7,8,15,"(4.697144,-74.140516)"
2015,Mayo,Panamá,591,0,7,7,"(12.5744111,-81.703935)"
2017,Diciembre,República de Corea,410,1,1,2,"(10.408582,-75.538003)"
2014,Enero,Perú,604,362,493,855,"(6.171601,-75.427454)"
2021,Julio,Turquía,792,1,8,9,"(10.445761,-75.516429)"
2017,Junio,Sierra Leona,694,0,1,1,"(10.445761,-75.516429)"
2021,Julio,Croacia,191,2,4,6,"(6.171601,-75.427454)"
2018,Julio,Canadá,124,8,2,10,"(-4.197703,-69.941278)"
2017,Junio,Eslovaquia,703,0,1,1,"(8.635765,-77.346578)"
2013,Septiembre,Venezuela,862,1235,1549,2784,"(7.818934,-72.453226)"
2013,Junio,Alemania,276,0,1,1,"(7.088729,-70.740253)"
2023,Abril,San Cristóbal y Nevis,659,4,7,11,"(4.697144,-74.140516)"
2012,Julio,Grecia,300,0,1,1,"(10.971302,-74.765397)"
2019,Mayo,Francia,250,6,11,17,"(0.25129,-76.875963)"
2017,Marzo,Liechtenstein,438,0,4,4,"(6.171601,-75.427454)"
2014,Octubre,Uruguay,858,127,343,470,"(4.697144,-74.140516)"
2019,Julio,Dinamarca,208,3,1,4,"(-4.197703,-69.941278)"
2017,Mayo,Grecia,300,0,1,1,"(11.247723,-74.213989)"
2018,Abril,Francia,250,13,7,20,"(-4.197703,-69.941278)"
2019,Abril,Perú,604,9,14,23,"(11.360009,-72.129330)"
2014,Diciembre,Rumania,642,4,4,8,"(6.171601,-75.427454)"
2017,Noviembre,España,724,31,58,89,"(7.818934,-72.453226)"
2022,Septiembre,Federación de Rusia,643,1,1,2,"(10.886611,-74.776708)"
2015,Junio,Finlandia,246,1,0,1,"(10.886611,-74.776708)"
2012,Junio,Italia,380,2,3,5,"(7.927209,-72.507910)"
2014,Marzo,Surinam,740,8,36,44,"(6.171601,-75.427454)"
2013,Junio,Guatemala,320,0,4,4,"(8.635765,-77.346578)"
2021,Noviembre,Kirguistán,417,1,0,1,"(6.171601,-75.427454)"
2022,Enero,Uruguay,858,2,3,5,"(4.452882,-75.766298)"
2015,Junio,Canadá,124,8,12,20,"(10.408582,-75.538003)"
2018,Diciembre,Cuba,192,2,0,2,"(-4.197703,-69.941278)"
2017,Septiembre,Estonia,233,2,1,3,"(6.171601,-75.427454)"
2017,Noviembre,República de Irlanda,372,4,12,16,"(3.541112,-76.384584)"
2023,Abril,Federación de Rusia,643,1,1,2,"(12.586067,-81.702563)"
2022,Abril,República Dominicana,214,2792,2268,5060,"(4.697144,-74.140516)"
2023,Marzo,Noruega,578,0,3,3,"(11.117806,-74.232622)"
2018,Julio,Suecia,752,1,7,8,"(-4.223468,-69.945098)"
2022,Diciembre,Alemania,276,5,7,12,"(7.128456,-73.183637)"
2015,Febrero,Federación de Rusia,643,0,1,1,"(0.25129,-76.875963)"
2017,Julio,Tailandia,764,0,1,1,"(10.445761,-75.516429)"
2020,Octubre,Italia,380,1,2,3,"(3.541112,-76.384584)"
2015,Julio,Países Bajos,528,0,1,1,"(10.886611,-74.776708)"
2017,Junio,Austria,40,126,212,338,"(4.697144,-74.140516)"
2020,Febrero,República Checa,203,0,1,1,"(0.25129,-76.875963)"
2019,Abril,Jamaica,388,2,9,11,"(3.541112,-76.384584)"
2022,Septiembre,Francia,250,4,1,5,"(11.117806,-74.232622)"
2020,Febrero,Singapur,702,15,24,40,"(4.697144,-74.140516)"
2018,Febrero,Vietnam,704,0,1,1,"(6.171601,-75.427454)"
2018,Marzo,Serbia,688,0,1,1,"(0.814836,-77.662532)"
2019,Marzo,Arabia Saudita,682,0,2,2,"(10.886611,-74.776708)"
2021,Diciembre,Bélgica,56,5,0,5,"(10.408582,-75.538003)"
2016,Enero,Finlandia,246,7,3,10,"(0.814836,-77.662532)"
2021,Enero,Paraguay,600,43,37,80,"(10.445761,-75.516429)"
2023,Abril,Turkmenistán,795,0,4,4,"(4.697144,-74.140516)"
2014,Diciembre,Finlandia,246,2,4,6,"(6.171601,-75.427454)"
2021,Octubre,Malasia,458,2,5,7,"(4.697144,-74.140516)"
2023,Marzo,Honduras,340,592,516,1108,"(4.697144,-74.140516)"
2019,Octubre,Serbia,688,19,33,52,"(4.697144,-74.140516)"
2021,Enero,Panamá,591,326,457,783,"(4.697144,-74.140516)"
2022,Septiembre,Nueva Zelanda,554,2,7,9,"(10.445761,-75.516429)"
2022,Septiembre,Barbados,52,0,2,2,"(3.541112,-76.384584)"
2019,Agosto,Países Bajos,528,59,71,130,"(3.541112,-76.384584)"
2012,Abril,Israel,376,106,512,618,"(4.697144,-74.140516)"
2022,Diciembre,Chile,152,5,12,17,"(11.360009,-72.129330)"
2012,Diciembre,Marruecos,504,1,2,3,"(4.697144,-74.140516)"
2013,Mayo,Haití,332,0,3,3,"(6.171601,-75.427454)"
2014,Julio,Macedonia,807,1,5,6,"(4.697144,-74.140516)"
2013,Noviembre,Líbano,422,1,2,3,"(10.886611,-74.776708)"
2019,Abril,Portugal,620,0,1,1,"(7.088729,-70.740253)"
2018,Septiembre,Mauricio,480,0,1,1,"(10.408582,-75.538003)"
2017,Agosto,Italia,380,0,1,1,"(6.185799,-67.483929)"
2018,Marzo,Bolivia,68,1,1,2,"(11.360009,-72.129330)"
2022,Marzo,Malta,470,3,1,4,"(6.171601,-75.427454)"
2013,Agosto,España,724,2,0,2,"(4.452882,-75.766298)"
2014,Julio,China,156,2,9,11,"(7.818934,-72.453226)"
2012,Septiembre,República Árabe Siria,760,2,2,4,"(4.697144,-74.140516)"
2019,Diciembre,Argentina,32,106,121,227,"(3.541112,-76.384584)"
2016,Octubre,Kazajistán,398,0,1,1,"(0.814836,-77.662532)"
2017,Mayo,Zimbabue,716,1,5,6,"(3.541112,-76.384584)"
2019,Febrero,México,484,4,11,15,"(7.927209,-72.507910)"
2013,Noviembre,Estados Unidos de América,840,241,443,684,"(10.886611,-74.776708)"
2017,Febrero,Paraguay,600,1,3,4,"(0.814836,-77.662532)"
2012,Septiembre,Noruega,578,0,2,2,"(10.886611,-74.776708)"
2023,Febrero,Santa Lucia,662,0,1,1,"(10.445761,-75.516429)"
2014,Febrero,Indonesia,360,16,25,41,"(4.697144,-74.140516)"
2019,Julio,Uzbekistán,860,1,0,1,"(3.541112,-76.384584)"
2023,Febrero,Hungría,348,1,0,1,"(7.128456,-73.183637)"
2012,Diciembre,Reino Unido de Gran Bretaña e Irlanda del Norte,826,0,1,1,"(7.128456,-73.183637)"
2014,Febrero,Kazajistán,398,0,1,1,"(4.697144,-74.140516)"
2014,Julio,Bermudas/Territorio Británico de Ultramar,60,0,4,4,"(6.171601,-75.427454)"
2023,Febrero,Sri Lanka,144,0,1,1,"(3.893038,-77.067921)"
2014,Enero,Brasil,76,84,117,201,"(-4.197703,-69.941278)"
2022,Diciembre,Antigua y Barbuda,28,0,1,1,"(11.360009,-72.129330)"
2017,Julio,República Dominicana,214,0,1,1,"(12.586067,-81.702563)"
2015,Mayo,India,356,61,417,478,"(4.697144,-74.140516)"
2023,Abril,Ecuador,218,4,6,10,"(7.927209,-72.507910)"
2017,Junio,Bolivia,68,0,2,2,"(8.635765,-77.346578)"
2019,Octubre,San Cristóbal y Nevis,659,0,1,1,"(6.171601,-75.427454)"
2014,Octubre,Bolivia,68,476,600,1076,"(4.697144,-74.140516)"
2012,Febrero,España,724,1,1,2,"(7.927209,-72.507910)"
2015,Mayo,Nueva Zelanda,554,5,4,9,"(10.445761,-75.516429)"
2015,Mayo,Etiopia,231,1,0,1,"(10.445761,-75.516429)"
2019,Septiembre,Madagascar,450,1,0,1,"(4.697144,-74.140516)"
2023,Enero,Suecia,752,0,1,1,"(11.360009,-72.129330)"
2012,Agosto,Paraguay,600,0,1,1,"(10.886611,-74.776708)"
2017,Julio,Canadá,124,1,1,2,"(11.360009,-72.129330)"
2015,Junio,Ecuador,218,16,51,67,"(6.171601,-75.427454)"
2016,Marzo,República Democrática del Congo,180,1,4,5,"(4.697144,-74.140516)"
2020,Marzo,Suiza,756,43,66,109,"(6.171601,-75.427454)"
2014,Julio,Países Bajos,528,12,9,21,"(7.128456,-73.183637)"
2018,Abril,Chile,152,656,541,1197,"(10.445761,-75.516429)"
2019,Mayo,Belice,84,1,0,1,"(-4.223468,-69.945098)"
2021,Febrero,Canadá,124,40,100,140,"(6.171601,-75.427454)"
2018,Abril,Bolivia,68,0,1,1,"(7.128456,-73.183637)"
2016,Agosto,Perú,604,21,37,58,"(-4.197703,-69.941278)"
2015,Mayo,Venezuela,862,0,7,7,"(10.433609,-73.247863)"
2020,Enero,Malawi,454,1,1,2,"(4.697144,-74.140516)"
2022,Septiembre,Ecuador,218,4,5,9,"(4.452882,-75.766298)"
2013,Agosto,República Checa,203,21,37,58,"(4.697144,-74.140516)"
2012,Septiembre,Turquía,792,0,2,2,"(0.814836,-77.662532)"
2017,Agosto,Portugal,620,4,3,7,"(0.814836,-77.662532)"
2020,Marzo,Cuba,192,0,1,1,"(7.916725,-72.462544)"
2016,Noviembre,Chile,152,46,311,357,"(10.886611,-74.776708)"
2013,Julio,Chipre,196,1,0,1,"(3.541112,-76.384584)"
2012,Septiembre,Estados Unidos de América,840,6,6,12,"(8.635765,-77.346578)"
2020,Octubre,Marruecos,504,1,0,1,"(3.541112,-76.384584)"
2019,Mayo,Antigua y Barbuda,28,0,1,1,"(10.445761,-75.516429)"
2015,Abril,Brasil,76,0,1,1,"(7.128456,-73.183637)"
2017,Febrero,Bulgaria,100,6,6,12,"(10.445761,-75.516429)"
2018,Julio,China,156,479,837,1316,"(4.697144,-74.140516)"
2012,Diciembre,Estonia,233,0,2,2,"(10.445761,-75.516429)"
2013,Enero,Nueva Zelanda,554,3,0,3,"(11.360009,-72.129330)"
2016,Febrero,Alemania,276,0,1,1,"(0.25129,-76.875963)"
2021,Septiembre,Perú,604,1,0,1,"(0.814836,-77.662532)"
2015,Marzo,República Dominicana,214,31,34,65,"(3.541112,-76.384584)"
2019,Febrero,El Salvador,222,24,31,55,"(6.171601,-75.427454)"
2018,Septiembre,Francia,250,51,78,129,"(0.814836,-77.662532)"
2016,Junio,Brasil,76,12,27,39,"(0.814836,-77.662532)"
2014,Septiembre,Canadá,124,4,10,14,"(10.408582,-75.538003)"
2020,Octubre,Estados Unidos de América,840,567,1655,2223,"(10.445761,-75.516429)"
2018,Febrero,Malí,466,0,1,1,"(10.445761,-75.516429)"
2023,Enero,Grecia,300,0,1,1,"(7.916725,-72.462544)"
2012,Marzo,Croacia,191,0,1,1,"(10.886611,-74.776708)"
2018,Febrero,Federación de Rusia,643,0,1,1,"(10.971302,-74.765397)"
2021,Febrero,Taiwán,158,0,1,1,"(10.886611,-74.776708)"
2014,Enero,Canadá,124,5,7,12,"(13.3387613,-81.372937)"
2013,Diciembre,Federación de Rusia,643,131,162,293,"(4.697144,-74.140516)"
2021,Marzo,República de Corea,410,3,2,5,"(6.171601,-75.427454)"
2022,Febrero,Perú,604,10,19,29,"(4.815061,-75.736532)"
2016,Noviembre,Granada,308,0,1,1,"(10.445761,-75.516429)"
2023,Marzo,Ghana,288,0,1,1,"(10.886611,-74.776708)"
2020,Agosto,Venezuela,862,1,0,1,"(6.185799,-67.483929)"
2017,Abril,Guatemala,320,30,70,100,"(3.541112,-76.384584)"
2014,Noviembre,Guatemala,320,5,4,9,"(12.586067,-81.702563)"
2015,Julio,Portugal,620,0,1,1,"(-4.197703,-69.941278)"
2016,Noviembre,Australia,36,1,2,3,"(7.128456,-73.183637)"
2013,Abril,Dinamarca,208,0,1,1,"(0.25129,-76.875963)"
2022,Agosto,Hong Kong,344,0,1,1,"(3.541112,-76.384584)"
2016,Diciembre,Bosnia y Herzegovina,70,7,4,11,"(4.697144,-74.140516)"
2015,Diciembre,Bolivia,68,724,620,1344,"(4.697144,-74.140516)"
2022,Octubre,Uruguay,858,0,1,1,"(0.25129,-76.875963)"
2022,Agosto,Malta,470,0,2,2,"(10.445761,-75.516429)"
2015,Enero,Suecia,752,8,10,18,"(0.814836,-77.662532)"
2023,Enero,Perú,604,9,15,24,"(4.815061,-75.736532)"
2023,Abril,Uruguay,858,3,6,9,"(4.452882,-75.766298)"
2017,Junio,Canadá,124,22,26,48,"(0.814836,-77.662532)"
2023,Marzo,República de Moldavia,498,2,1,3,"(6.171601,-75.427454)"
2016,Diciembre,Bolivia,68,3,0,3,"(0.25129,-76.875963)"
2012,Diciembre,Venezuela,862,66,95,161,"(0.814836,-77.662532)"
2013,Octubre,Venezuela,862,33,86,119,"(10.886611,-74.776708)"
2013,Septiembre,Níger,562,0,5,5,"(4.697144,-74.140516)"
2017,Noviembre,Países Bajos,528,2,2,4,"(-4.223468,-69.945098)"
2012,Octubre,Panamá,591,0,9,9,"(10.408582,-75.538003)"
2017,Octubre,República de Corea,410,5,0,5,"(12.586067,-81.702563)"
2022,Marzo,Guinea Bissau,624,1,0,1,"(4.697144,-74.140516)"
2020,Octubre,Nigeria,566,0,1,1,"(6.171601,-75.427454)"
2013,Marzo,Chile,152,80,149,229,"(6.171601,-75.427454)"
2018,Mayo,Sudáfrica,710,2,1,3,"(0.814836,-77.662532)"
2017,Septiembre,Italia,380,10,21,31,"(10.886611,-74.776708)"
2017,Enero,Argentina,32,5,15,20,"(0.25129,-76.875963)"
2021,Julio,El Salvador,222,1,0,1,"(7.818934,-72.453226)"
2017,Septiembre,Estados Unidos de América,840,1941,4932,6873,"(6.171601,-75.427454)"
2016,Abril,Turquía,792,0,1,1,"(10.886611,-74.776708)"
2018,Marzo,Alemania,276,1,3,4,"(11.247723,-74.213989)"
2013,Diciembre,Federación de Rusia,643,0,1,1,"(10.971302,-74.765397)"
2022,Abril,Sri Lanka,144,1,0,1,"(6.171601,-75.427454)"
2016,Enero,Finlandia,246,2,1,3,"(10.408582,-75.538003)"
2022,Febrero,Alemania,276,122,157,279,"(10.445761,-75.516429)"
2016,Septiembre,Brasil,76,115,135,250,"(3.541112,-76.384584)"
2023,Marzo,Uruguay,858,1,7,8,"(4.815061,-75.736532)"
2013,Junio,Estados Unidos de América,840,16,20,36,"(12.586067,-81.702563)"
2017,Enero,Alemania,276,138,235,373,"(6.171601,-75.427454)"
2017,Julio,Alemania,276,2130,2604,4734,"(4.697144,-74.140516)"
2019,Febrero,Austria,40,8,14,22,"(0.814836,-77.662532)"
2012,Agosto,Costa Rica,188,1,0,1,"(6.185799,-67.483929)"
2017,Febrero,Albania,8,0,1,1,"(10.445761,-75.516429)"
2016,Junio,Panamá,591,2,0,2,"(7.102626,-77.762647)"
2018,Mayo,República de Armenia,51,1,0,1,"(3.541112,-76.384584)"
2012,Noviembre,Ghana,288,0,6,6,"(4.697144,-74.140516)"
2017,Febrero,San Marino,674,0,1,1,"(4.697144,-74.140516)"
2012,Mayo,Tíbet/Región Autónoma de China,99999,0,1,1,"(4.697144,-74.140516)"
2014,Diciembre,Bulgaria,100,1,0,1,"(12.586067,-81.702563)"
2016,Julio,Italia,380,10,29,39,"(10.886611,-74.776708)"
2018,Octubre,Estados Unidos de América,840,5,17,22,"(8.635765,-77.346578)"
2023,Mayo,Malta,470,0,1,1,"(6.171601,-75.427454)"
2013,Enero,Venezuela,862,4,3,7,"(7.128456,-73.183637)"
2019,Octubre,China,156,0,3,3,"(11.247723,-74.213989)"
2023,Marzo,Bélgica,56,2,1,3,"(8.635765,-77.346578)"
2018,Julio,Países Bajos,528,0,4,4,"(11.247723,-74.213989)"
2012,Marzo,Kenia,404,0,1,1,"(7.818934,-72.453226)"
2017,Noviembre,Croacia,191,0,1,1,"(0.814836,-77.662532)"
2019,Enero,Dinamarca,208,0,2,2,"(8.635765,-77.346578)"
2016,Octubre,República de Armenia,51,3,4,7,"(4.697144,-74.140516)"
2021,Marzo,República Dominicana,214,195,201,396,"(6.171601,-75.427454)"
2020,Noviembre,Estados Unidos de América,840,0,1,1,"(7.916725,-72.462544)"
2012,Febrero,Finlandia,246,4,4,8,"(0.814836,-77.662532)"
2017,Mayo,India,356,96,449,545,"(4.697144,-74.140516)"
2016,Diciembre,Bosnia y Herzegovina,70,0,1,1,"(6.171601,-75.427454)"
2012,Abril,República de Corea,410,0,3,3,"(12.586067,-81.702563)"
2018,Abril,Venezuela,862,64,98,162,"(3.541112,-76.384584)"
2017,Noviembre,Italia,380,0,1,1,"(7.088729,-70.740253)"
2023,Mayo,Surinam,740,2,0,2,"(3.541112,-76.384584)"
2021,Agosto,República de Belarús,112,2,3,5,"(4.697144,-74.140516)"
2021,Septiembre,Polonia,616,0,1,1,"(4.452882,-75.766298)"
2014,Febrero,Alemania,276,11,9,20,"(8.635765,-77.346578)"
2013,Septiembre,Polonia,616,0,1,1,"(7.128456,-73.183637)"
2023,Abril,Dinamarca,208,3,0,3,"(8.635765,-77.346578)"
2018,Agosto,Bélgica,56,0,2,2,"(7.128456,-73.183637)"
2018,Abril,China,156,1,3,4,"(8.36068,-72.409396)"
2014,Mayo,Desconocido,99999,1,0,1,"(0.814836,-77.662532)"
2017,Septiembre,Argelia,12,1,7,8,"(4.697144,-74.140516)"
2013,Septiembre,Venezuela,862,2,4,6,"(11.528919,-72.919681)"
2022,Febrero,Ecuador,218,1,1,2,"(7.088729,-70.740253)"
2015,Junio,Singapur,702,3,2,5,"(10.445761,-75.516429)"
2019,Agosto,Honduras,340,29,11,40,"(3.541112,-76.384584)"
2022,Octubre,Eslovaquia,703,0,1,1,"(7.818934,-72.453226)"
2022,Marzo,Canadá,124,2,1,3,"(0.25129,-76.875963)"
2022,Diciembre,Angola,24,0,2,2,"(4.697144,-74.140516)"
2012,Abril,Noruega,578,1,1,2,"(13.3387613,-81.372937)"
2020,Noviembre,Francia,250,25,71,96,"(6.171601,-75.427454)"
2022,Octubre,México,484,34,32,66,"(4.815061,-75.736532)"
2013,Noviembre,Belice,84,0,1,1,"(12.586067,-81.702563)"
2013,Agosto,Vietnam,704,1,8,9,"(4.697144,-74.140516)"
2020,Septiembre,Bélgica,56,0,12,12,"(3.893038,-77.067921)"
2015,Mayo,Federación de Rusia,643,0,1,1,"(0.25129,-76.875963)"
2015,Marzo,Panamá,591,10,8,18,"(7.128456,-73.183637)"
2019,Julio,Noruega,578,186,224,410,"(4.697144,-74.140516)"
2018,Octubre,República Democrática del Congo,180,0,1,1,"(7.818934,-72.453226)"
2023,Junio,Arabia Saudita,682,5,23,28,"(4.697144,-74.140516)"
2019,Septiembre,Alemania,276,0,1,1,"(8.36068,-72.409396)"
2017,Febrero,Estados Unidos de América,840,0,1,1,"(1.813928,-78.763924)"
2020,Febrero,Bélgica,56,0,3,3,"(0.25129,-76.875963)"
2015,Marzo,India,356,0,2,2,"(4.815061,-75.736532)"
2016,Noviembre,Reino Unido de Gran Bretaña e Irlanda del Norte,826,895,2021,2916,"(4.697144,-74.140516)"
2017,Noviembre,Antigua y Barbuda,28,1,0,1,"(10.886611,-74.776708)"
2019,Diciembre,República de Moldavia,498,2,0,2,"(6.171601,-75.427454)"
2016,Febrero,República Checa,203,2,2,4,"(8.635765,-77.346578)"
2016,Junio,Croacia,191,9,31,40,"(4.697144,-74.140516)"
2015,Marzo,República de Irlanda,372,0,1,1,"(10.886611,-74.776708)"
2014,Abril,Trinidad y Tobago,780,24,50,74,"(4.697144,-74.140516)"
2018,Febrero,Honduras,340,3,6,9,"(10.886611,-74.776708)"
2019,Enero,Uruguay,858,26,30,56,"(3.541112,-76.384584)"
2012,Abril,Estados Unidos de América,840,0,17,17,"(10.971302,-74.765397)"
2017,Septiembre,Bosnia y Herzegovina,70,0,4,4,"(4.697144,-74.140516)"
2015,Mayo,República Checa,203,1,5,6,"(6.171601,-75.427454)"
2019,Noviembre,Israel,376,0,2,2,"(4.815061,-75.736532)"
2021,Diciembre,Italia,380,4,3,7,"(4.815061,-75.736532)"
2023,Junio,Qatar,634,2,0,2,"(10.445761,-75.516429)"
2018,Febrero,Honduras,340,1,1,2,"(4.815061,-75.736532)"
2022,Marzo,Botsuana,72,1,0,1,"(4.697144,-74.140516)"
2016,Octubre,Chile,152,0,1,1,"(12.5744111,-81.703935)"
2015,Septiembre,Panamá,591,46,80,126,"(10.886611,-74.776708)"
2016,Octubre,Grecia,300,0,1,1,"(10.971302,-74.765397)"
2017,Julio,Filipinas,608,1,1,2,"(7.818934,-72.453226)"
2017,Agosto,Italia,380,31,76,107,"(3.541112,-76.384584)"
2022,Septiembre,Hong Kong,344,1,0,1,"(10.408582,-75.538003)"
2017,Abril,Panamá,591,9,8,17,"(7.128456,-73.183637)"
2014,Noviembre,Turquía,792,3,4,7,"(3.541112,-76.384584)"
2013,Septiembre,Uruguay,858,1,1,2,"(4.815061,-75.736532)"
2017,Marzo,Perú,604,3654,4448,8102,"(4.697144,-74.140516)"
2012,Marzo,España,724,5,11,16,"(10.886611,-74.776708)"
2016,Abril,Bulgaria,100,1,0,1,"(7.927209,-72.507910)"
2014,Mayo,Kenia,404,2,0,2,"(3.541112,-76.384584)"
2017,Marzo,Rumania,642,0,1,1,"(0.814836,-77.662532)"
2022,Septiembre,Ecuador,218,126,122,248,"(3.541112,-76.384584)"
2022,Febrero,El Salvador,222,0,1,1,"(10.408582,-75.538003)"
2019,Enero,Bélgica,56,1,1,2,"(7.818934,-72.453226)"
2022,Octubre,Argentina,32,1,0,1,"(8.36068,-72.409396)"
2013,Febrero,República de Corea,410,1,1,2,"(10.408582,-75.538003)"
2012,Marzo,Suecia,752,0,2,2,"(11.247723,-74.213989)"
2020,Febrero,Suiza,756,631,942,1573,"(4.697144,-74.140516)"
2017,Octubre,Brasil,76,1724,1267,2991,"(10.445761,-75.516429)"
2012,Diciembre,Uruguay,858,1,8,9,"(0.814836,-77.662532)"
2016,Agosto,Bolivia,68,441,551,992,"(4.697144,-74.140516)"
2022,Marzo,República Dominicana,214,1,7,8,"(4.452882,-75.766298)"
2017,Julio,El Salvador,222,5,10,15,"(10.886611,-74.776708)"
2016,Agosto,Turquía,792,0,2,2,"(7.818934,-72.453226)"
2018,Enero,Cuba,192,0,9,9,"(10.408582,-75.538003)"
2023,Mayo,Reino Unido de Gran Bretaña e Irlanda del Norte,826,0,1,1,"(10.971302,-74.765397)"
2019,Febrero,Estados Unidos de América,840,10,11,21,"(8.635765,-77.346578)"
2013,Septiembre,Bolivia,68,1,1,2,"(-4.197703,-69.941278)"
2013,Julio,Nueva Zelanda,554,1,0,1,"(4.452882,-75.766298)"
2016,Julio,Argelia,12,1,4,5,"(4.697144,-74.140516)"
2017,Abril,República de Corea,410,5,3,8,"(12.586067,-81.702563)"
2014,Mayo,Reino Unido de Gran Bretaña e Irlanda del Norte,826,0,1,1,"(0.25129,-76.875963)"
2018,Septiembre,Rwanda,646,2,0,2,"(10.445761,-75.516429)"
2014,Marzo,República Dominicana,214,0,1,1,"(11.247723,-74.213989)"
2015,Abril,Chile,152,0,1,1,"(4.452882,-75.766298)"
2020,Enero,Tailandia,764,0,3,3,"(11.247723,-74.213989)"
2015,Septiembre,República Dominicana,214,3,0,3,"(4.815061,-75.736532)"
2022,Diciembre,Puerto Rico/Territorio de Estados Unidos,630,0,2,2,"(4.697144,-74.140516)"
2018,Marzo,Islandia,352,1,2,3,"(6.171601,-75.427454)"
2018,Septiembre,Perú,604,0,1,1,"(6.185799,-67.483929)"
2021,Mayo,Panamá,591,1,0,1,"(12.5744111,-81.703935)"
2019,Enero,Samoa Occidental,882,1,0,1,"(4.697144,-74.140516)"
2012,Febrero,Santa Lucia,662,0,1,1,"(10.886611,-74.776708)"
2012,Agosto,Nepal,524,0,2,2,"(4.697144,-74.140516)"
2021,Agosto,Bahamas,44,13,4,17,"(3.541112,-76.384584)"
2019,Octubre,Grecia,300,0,1,1,"(7.128456,-73.183637)"
2019,Diciembre,Senegal,686,1,2,3,"(4.697144,-74.140516)"
2022,Febrero,Perú,604,0,1,1,"(7.102626,-77.762647)"
2019,Noviembre,Kirguistán,417,1,0,1,"(4.697144,-74.140516)"
2012,Marzo,Croacia,191,5,35,40,"(4.697144,-74.140516)"
2022,Abril,Costa Rica,188,9,13,22,"(4.815061,-75.736532)"
2019,Septiembre,Sudáfrica,710,4,2,6,"(0.814836,-77.662532)"
2012,Noviembre,Países Bajos,528,1,9,10,"(7.818934,-72.453226)"
2018,Octubre,Nigeria,566,0,1,1,"(6.171601,-75.427454)"
2017,Noviembre,Venezuela,862,1,7,8,"(6.17134,-75.427194)"
2018,Diciembre,Ecuador,218,1,0,1,"(11.117806,-74.232622)"
2023,Mayo,Guatemala,320,1,12,13,"(4.815061,-75.736532)"
2022,Julio,República de Irlanda,372,1,1,2,"(7.128456,-73.183637)"
2022,Junio,Francia,250,2,0,2,"(7.916725,-72.462544)"
2015,Diciembre,Panamá,591,0,4,4,"(7.818934,-72.453226)"
2014,Abril,Australia,36,13,23,36,"(3.541112,-76.384584)"
2017,Octubre,India,356,1,4,5,"(3.893038,-77.067921)"
2015,Diciembre,Alemania,276,0,1,1,"(7.088729,-70.740253)"
2020,Febrero,Taiwán,158,2,2,4,"(0.814836,-77.662532)"
2018,Septiembre,México,484,17,22,39,"(10.408582,-75.538003)"
2016,Agosto,Federación de Rusia,643,1,0,1,"(8.635765,-77.346578)"
2022,Septiembre,República de Irlanda,372,4,7,11,"(3.541112,-76.384584)"
2013,Abril,España,724,5,9,14,"(-4.197703,-69.941278)"
2012,Diciembre,Bulgaria,100,1,0,1,"(0.814836,-77.662532)"
2019,Noviembre,Estonia,233,1,4,5,"(6.171601,-75.427454)"
2017,Enero,Estados Unidos de América,840,54,96,150,"(4.452882,-75.766298)"
2020,Diciembre,Venezuela,862,3,3,6,"(10.971302,-74.765397)"
2017,Octubre,Chile,152,51,83,134,"(3.541112,-76.384584)"
2015,Septiembre,Macedonia,807,0,1,1,"(4.697144,-74.140516)"
2014,Octubre,Rwanda,646,2,1,3,"(4.697144,-74.140516)"
2018,Marzo,Bulgaria,100,32,47,79,"(4.697144,-74.140516)"
2018,Abril,Federación de Rusia,643,22,20,42,"(10.445761,-75.516429)"
2021,Febrero,Ecuador,218,1,1,2,"(7.818934,-72.453226)"
2023,Enero,España,724,509,856,1365,"(6.171601,-75.427454)"
2014,Febrero,México,484,0,1,1,"(7.102626,-77.762647)"
2016,Julio,República de Irlanda,372,17,14,31,"(10.445761,-75.516429)"
2016,Febrero,Guyana,328,1,0,1,"(7.128456,-73.183637)"
2013,Noviembre,España,724,172,454,626,"(6.171601,-75.427454)"
2022,Julio,Venezuela,862,975,961,1938,"(6.171601,-75.427454)"
2018,Agosto,Suiza,756,1,0,1,"(0.25129,-76.875963)"
2013,Junio,Japón,392,1,1,2,"(11.360009,-72.129330)"
2015,Marzo,Ecuador,218,155,244,399,"(7.818934,-72.453226)"
2012,Mayo,Países Bajos,528,1,0,1,"(-4.197703,-69.941278)"
2022,Enero,San  Vicente y las Granadinas,670,3,3,6,"(10.886611,-74.776708)"
2012,Noviembre,Bahamas,44,0,3,3,"(6.171601,-75.427454)"
2019,Julio,Guyana,328,6,5,11,"(10.445761,-75.516429)"
2015,Octubre,Israel,376,3,2,5,"(-4.197703,-69.941278)"
2017,Enero,Canadá,124,1178,1884,3062,"(4.697144,-74.140516)"
2017,Julio,España,724,65,71,136,"(0.814836,-77.662532)"
2021,Enero,Cuba,192,14,15,29,"(6.171601,-75.427454)"
2014,Agosto,Panamá,591,0,1,1,"(11.117806,-74.232622)"
2015,Diciembre,Argentina,32,3422,4905,8327,"(4.697144,-74.140516)"
2013,Mayo,Guatemala,320,7,15,22,"(7.818934,-72.453226)"
2022,Octubre,República de Corea,410,1,0,1,"(0.814836,-77.662532)"
2012,Febrero,Surinam,740,4,1,5,"(10.445761,-75.516429)"
2016,Mayo,Estados Unidos de América,840,132,202,334,"(4.452882,-75.766298)"
2014,Noviembre,Filipinas,608,1,0,1,"(8.635765,-77.346578)"
2015,Febrero,Suecia,752,11,17,28,"(10.445761,-75.516429)"
2023,Abril,Ucrania,804,0,4,4,"(10.886611,-74.776708)"
2019,Diciembre,Líbano,422,0,2,2,"(10.445761,-75.516429)"
2015,Septiembre,Panamá,591,48,49,97,"(12.586067,-81.702563)"
2017,Septiembre,Desconocido,99999,1,1,2,"(1.813928,-78.763924)"
2012,Septiembre,Suecia,752,2,9,11,"(10.445761,-75.516429)"
2016,Agosto,Guatemala,320,9,16,25,"(10.886611,-74.776708)"
2018,Marzo,Nepal,524,1,5,6,"(4.697144,-74.140516)"
2016,Octubre,Honduras,340,1,4,5,"(4.815061,-75.736532)"
2023,Mayo,México,484,16,33,49,"(4.815061,-75.736532)"
2018,Septiembre,Israel,376,0,1,1,"(-4.223468,-69.945098)"
2013,Abril,Canadá,124,1,7,8,"(4.815061,-75.736532)"
2014,Enero,Argentina,32,5241,5387,10628,"(4.697144,-74.140516)"
2022,Junio,Paraguay,600,9,4,13,"(12.586067,-81.702563)"
2017,Septiembre,Estados Unidos de América,840,0,4,4,"(-4.223468,-69.945098)"
2018,Marzo,Bermudas/Territorio Británico de Ultramar,60,1,2,3,"(6.171601,-75.427454)"
2013,Marzo,Zimbabue,716,1,4,5,"(4.697144,-74.140516)"
2016,Abril,Montenegro,499,1,0,1,"(10.408582,-75.538003)"
2017,Enero,Túnez,788,1,5,6,"(4.697144,-74.140516)"
2021,Noviembre,Liechtenstein,438,0,1,1,"(4.697144,-74.140516)"
2016,Diciembre,Austria,40,15,21,36,"(6.171601,-75.427454)"
2022,Agosto,Francia,250,10,6,16,"(7.916725,-72.462544)"
2013,Mayo,Austria,40,0,1,1,"(3.541112,-76.384584)"
2012,Septiembre,Paraguay,600,3,1,4,"(7.818934,-72.453226)"
2012,Junio,Reino Unido de Gran Bretaña e Irlanda del Norte,826,1,4,5,"(-4.197703,-69.941278)"
2018,Septiembre,Austria,40,0,1,1,"(7.818934,-72.453226)"
2014,Febrero,Chile,152,132,185,317,"(6.171601,-75.427454)"
2014,Enero,Japón,392,6,26,32,"(0.814836,-77.662532)"
2015,Abril,España,724,5,8,13,"(-4.197703,-69.941278)"
2014,Noviembre,Costa Rica,188,47,69,116,"(10.445761,-75.516429)"
2021,Diciembre,Canadá,124,0,1,1,"(8.635765,-77.346578)"
2022,Febrero,Países Bajos,528,6,4,10,"(0.814836,-77.662532)"
2016,Noviembre,Federación de Rusia,643,168,238,406,"(4.697144,-74.140516)"
2019,Diciembre,Canadá,124,0,1,1,"(-4.223468,-69.945098)"
2018,Febrero,India,356,0,1,1,"(12.586067,-81.702563)"
2012,Noviembre,Uganda,800,3,1,4,"(4.697144,-74.140516)"
2021,Enero,Uzbekistán,860,3,3,6,"(4.697144,-74.140516)"
2019,Febrero,Zimbabue,716,1,2,3,"(4.697144,-74.140516)"
2019,Septiembre,Suazilandia,748,1,0,1,"(4.697144,-74.140516)"
2022,Noviembre,Chile,152,0,1,1,"(10.408582,-75.538003)"
2019,Noviembre,Serbia,688,0,1,1,"(0.25129,-76.875963)"
2018,Agosto,Italia,380,1,2,3,"(-4.223468,-69.945098)"
2019,Mayo,México,484,3,4,7,"(7.818934,-72.453226)"
2012,Abril,Federación de Rusia,643,2,0,2,"(10.445761,-75.516429)"
2023,Mayo,Turquía,792,0,2,2,"(4.815061,-75.736532)"
2022,Octubre,Cuba,192,2,0,2,"(7.927209,-72.507910)"
2015,Noviembre,Surinam,740,23,24,47,"(6.171601,-75.427454)"
2014,Septiembre,Federación de Rusia,643,2,11,13,"(10.408582,-75.538003)"
2019,Febrero,Bélgica,56,361,538,899,"(4.697144,-74.140516)"
2016,Julio,Federación de Rusia,643,7,5,12,"(3.541112,-76.384584)"
2012,Septiembre,Bolivia,68,1,0,1,"(-4.197703,-69.941278)"
2016,Octubre,Croacia,191,0,3,3,"(3.541112,-76.384584)"
2012,Diciembre,Brasil,76,9,17,26,"(0.814836,-77.662532)"
2014,Junio,Eslovaquia,703,1,1,2,"(10.408582,-75.538003)"
2021,Junio,Polonia,616,1,7,8,"(10.408582,-75.538003)"
2012,Julio,Federación de Rusia,643,0,1,1,"(9.402978,-75.681599)"
2016,Enero,República de Irlanda,372,2,2,4,"(8.635765,-77.346578)"
2018,Junio,Guatemala,320,1,2,3,"(12.5744111,-81.703935)"
2019,Enero,Desconocido,99999,1,2,3,"(10.445761,-75.516429)"
2016,Febrero,Bélgica,56,0,2,2,"(7.818934,-72.453226)"
2015,Enero,Reino Unido de Gran Bretaña e Irlanda del Norte,826,11,12,23,"(-4.197703,-69.941278)"
2014,Febrero,Estados Unidos de América,840,115,132,247,"(10.408582,-75.538003)"
2016,Octubre,República Dominicana,214,541,697,1238,"(4.697144,-74.140516)"
2015,Septiembre,Polonia,616,2,12,14,"(3.541112,-76.384584)"
2023,Abril,Japón,392,16,22,38,"(6.171601,-75.427454)"
2012,Julio,Lituania,440,0,1,1,"(10.408582,-75.538003)"
2019,Diciembre,Francia,250,2,1,3,"(4.452882,-75.766298)"
2015,Abril,Suiza,756,13,40,53,"(6.171601,-75.427454)"
2020,Febrero,Lituania,440,50,48,98,"(4.697144,-74.140516)"
2022,Octubre,Bahamas,44,13,16,29,"(10.445761,-75.516429)"
2015,Octubre,Trinidad y Tobago,780,0,1,1,"(10.886611,-74.776708)"
2022,Noviembre,Federación de Rusia,643,0,2,2,"(10.971302,-74.765397)"
2018,Diciembre,Lituania,440,6,8,14,"(10.445761,-75.516429)"
2017,Diciembre,República de Belarús,112,1,0,1,"(4.452882,-75.766298)"
2020,Octubre,Suecia,752,0,4,4,"(6.171601,-75.427454)"
2017,Agosto,Letonia,428,0,1,1,"(10.971302,-74.765397)"
2015,Mayo,República Dominicana,214,3,3,6,"(10.433609,-73.247863)"
2013,Agosto,Federación de Rusia,643,10,7,17,"(7.818934,-72.453226)"
2020,Febrero,Uruguay,858,3,4,7,"(4.815061,-75.736532)"
2017,Julio,Suiza,756,43,60,103,"(10.445761,-75.516429)"
2019,Marzo,Países Bajos,528,23,25,48,"(0.814836,-77.662532)"
2012,Julio,India,356,0,1,1,"(11.247723,-74.213989)"
2022,Marzo,Países Bajos,528,5,3,8,"(-4.197703,-69.941278)"
2015,Marzo,Ucrania,804,42,46,88,"(4.697144,-74.140516)"
2021,Diciembre,Argentina,32,9,19,28,"(10.886611,-74.776708)"
2018,Noviembre,Israel,376,1,0,1,"(1.813928,-78.763924)"
2019,Febrero,Chile,152,0,1,1,"(4.452882,-75.766298)"
2023,Febrero,India,356,0,1,1,"(4.452882,-75.766298)"
2012,Abril,Macedonia,807,1,1,2,"(4.697144,-74.140516)"
2019,Marzo,Afganistán,4,0,1,1,"(10.886611,-74.776708)"
2023,Enero,Indonesia,360,0,5,5,"(10.971302,-74.765397)"
2012,Diciembre,Bélgica,56,139,328,467,"(4.697144,-74.140516)"
2019,Julio,Japón,392,0,3,3,"(11.360009,-72.129330)"
2014,Agosto,Polonia,616,2,7,9,"(0.814836,-77.662532)"
2013,Noviembre,Grecia,300,0,1,1,"(10.886611,-74.776708)"
2012,Julio,Burkina Faso,854,1,0,1,"(0.814836,-77.662532)"
2022,Abril,Alemania,276,1,1,2,"(11.247723,-74.213989)"
2015,Julio,Cuba,192,20,35,55,"(3.541112,-76.384584)"
2020,Enero,Canadá,124,19,31,50,"(10.886611,-74.776708)"
2016,Mayo,Chile,152,1,0,1,"(0.25129,-76.875963)"
2019,Agosto,Bélgica,56,1,1,2,"(-4.197703,-69.941278)"
2022,Julio,Brasil,76,3,6,9,"(7.927209,-72.507910)"
2013,Junio,Italia,380,1,7,8,"(8.635765,-77.346578)"
2021,Diciembre,Nicaragua,558,4,0,4,"(7.128456,-73.183637)"
2014,Enero,Uruguay,858,152,256,408,"(4.697144,-74.140516)"
2017,Octubre,Nigeria,566,0,2,2,"(-4.197703,-69.941278)"
2023,Mayo,Australia,36,7,12,19,"(0.814836,-77.662532)"
2023,Mayo,España,724,19,22,41,"(7.818934,-72.453226)"
2018,Enero,Brasil,76,700,575,1275,"(10.445761,-75.516429)"
2021,Abril,Bahamas,44,0,3,3,"(10.445761,-75.516429)"
2017,Febrero,Estados Unidos de América,840,3415,4597,8012,"(10.445761,-75.516429)"
2016,Mayo,Malasia,458,0,2,2,"(0.814836,-77.662532)"
2017,Octubre,Argelia,12,2,5,7,"(4.697144,-74.140516)"
2018,Julio,Países Bajos,528,6,6,12,"(-4.197703,-69.941278)"
2012,Septiembre,Bolivia,68,20,24,44,"(0.814836,-77.662532)"
2015,Abril,Venezuela,862,64,86,150,"(3.541112,-76.384584)"
2018,Junio,España,724,8,10,18,"(4.815061,-75.736532)"
2012,Marzo,República de Corea,410,6,11,17,"(0.814836,-77.662532)"
2016,Julio,Paraguay,600,0,6,6,"(10.886611,-74.776708)"
2014,Abril,Federación de Rusia,643,0,1,1,"(7.927209,-72.507910)"
2018,Diciembre,Nicaragua,558,1,0,1,"(0.814836,-77.662532)"
2015,Abril,Uruguay,858,132,321,453,"(4.697144,-74.140516)"
2017,Julio,Noruega,578,2,1,3,"(10.408582,-75.538003)"
2017,Noviembre,Francia,250,1,1,2,"(13.3387613,-81.372937)"
2013,Julio,Honduras,340,59,68,127,"(6.171601,-75.427454)"
2016,Diciembre,Venezuela,862,1,1,2,"(7.927209,-72.507910)"
2023,Febrero,Sri Lanka,144,0,16,16,"(10.408582,-75.538003)"
2013,Septiembre,Rumania,642,1,1,2,"(10.445761,-75.516429)"
2021,Agosto,Israel,376,12,40,52,"(10.445761,-75.516429)"
2015,Mayo,Alemania,276,58,102,160,"(6.171601,-75.427454)"
2014,Junio,Georgia,268,1,0,1,"(4.697144,-74.140516)"
2014,Octubre,Líbano,422,1,1,2,"(10.886611,-74.776708)"
2015,Enero,Panamá,591,0,5,5,"(0.814836,-77.662532)"
2019,Noviembre,Estados Unidos de América,840,6,9,15,"(11.247723,-74.213989)"
2019,Diciembre,Kenia,404,2,1,3,"(6.171601,-75.427454)"
2016,Mayo,Jamaica,388,0,3,3,"(3.541112,-76.384584)"
2022,Octubre,República de Moldavia,498,0,1,1,"(10.445761,-75.516429)"
2012,Julio,Panamá,591,3,2,5,"(6.228046,-77.404104)"
2021,Diciembre,Uruguay,858,1,4,5,"(4.815061,-75.736532)"
2020,Febrero,Honduras,340,75,71,146,"(6.171601,-75.427454)"
2012,Julio,Noruega,578,0,2,2,"(7.818934,-72.453226)"
2013,Octubre,Paraguay,600,12,13,25,"(10.445761,-75.516429)"
2023,Febrero,Reino Unido de Gran Bretaña e Irlanda del Norte,826,2,1,3,"(6.18189,-67.47535)"
2018,Abril,Países Bajos,528,3,1,4,"(7.818934,-72.453226)"
2012,Julio,Reino Unido de Gran Bretaña e Irlanda del Norte,826,2,7,9,"(11.360009,-72.129330)"
2018,Abril,Haití,332,2,9,11,"(6.171601,-75.427454)"
2018,Junio,Francia,250,3,5,8,"(11.247723,-74.213989)"
2021,Diciembre,Suecia,752,0,2,2,"(7.818934,-72.453226)"
2022,Julio,España,724,4211,5802,10014,"(4.697144,-74.140516)"
2017,Agosto,Guyana,328,0,4,4,"(10.886611,-74.776708)"
2015,Mayo,Hungría,348,2,0,2,"(6.171601,-75.427454)"
2016,Agosto,Chile,152,1,0,1,"(4.452882,-75.766298)"
2023,Febrero,Sudán,736,0,1,1,"(10.408582,-75.538003)"
2019,Marzo,Brasil,76,87,119,206,"(3.541112,-76.384584)"
2015,Julio,Canadá,124,0,6,6,"(11.360009,-72.129330)"
2019,Diciembre,China,156,2,5,7,"(7.818934,-72.453226)"
2014,Diciembre,Canadá,124,2,1,3,"(13.3387613,-81.372937)"
2012,Octubre,Japón,392,1,10,11,"(10.886611,-74.776708)"
2017,Junio,Camboya,116,0,1,1,"(4.697144,-74.140516)"
2014,Octubre,República Dominicana,214,0,2,2,"(7.128456,-73.183637)"
2016,Agosto,Mauricio,480,0,1,1,"(3.541112,-76.384584)"
2014,Febrero,Sri Lanka,144,0,1,1,"(4.697144,-74.140516)"
2020,Febrero,Austria,40,3,5,8,"(-4.223468,-69.945098)"
2018,Julio,Ecuador,218,707,511,1218,"(10.445761,-75.516429)"
2016,Octubre,Francia,250,50,79,129,"(0.814836,-77.662532)"
2015,Septiembre,México,484,1,1,2,"(4.452882,-75.766298)"
2012,Octubre,Antigua y Barbuda,28,1,1,2,"(4.697144,-74.140516)"
2016,Julio,Sudáfrica,710,3,6,9,"(6.171601,-75.427454)"
2012,Septiembre,Suiza,756,3,8,11,"(7.818934,-72.453226)"
2022,Julio,Turquía,792,0,1,1,"(4.815061,-75.736532)"
2014,Julio,República de Corea,410,0,1,1,"(10.886611,-74.776708)"
2014,Abril,Grecia,300,0,2,2,"(10.971302,-74.765397)"
2019,Junio,Alemania,276,20,29,49,"(10.886611,-74.776708)"
2023,Mayo,Noruega,578,2,1,3,"(10.408582,-75.538003)"
2015,Febrero,Polonia,616,0,1,1,"(11.247723,-74.213989)"
2022,Octubre,Bolivia,68,593,672,1266,"(4.697144,-74.140516)"
2018,Mayo,Suecia,752,118,194,312,"(4.697144,-74.140516)"
2022,Mayo,Etiopia,231,0,1,1,"(10.445761,-75.516429)"
2014,Mayo,Venezuela,862,180,188,368,"(7.927209,-72.507910)"
2014,Diciembre,Bahamas,44,0,2,2,"(10.445761,-75.516429)"
2021,Noviembre,Federación de Rusia,643,19,29,48,"(6.171601,-75.427454)"
2015,Septiembre,Países Bajos,528,10,12,22,"(0.814836,-77.662532)"
2019,Junio,Iraq,368,1,1,2,"(4.697144,-74.140516)"
2023,Febrero,Ecuador,218,1,2,3,"(6.18189,-67.47535)"
2022,Mayo,Qatar,634,0,3,3,"(10.445761,-75.516429)"
2014,Octubre,Australia,36,2,5,7,"(8.635765,-77.346578)"
2019,Mayo,Ucrania,804,0,14,14,"(10.445761,-75.516429)"
2016,Febrero,Venezuela,862,4184,5209,9393,"(4.697144,-74.140516)"
2015,Octubre,Japón,392,1,0,1,"(-4.197703,-69.941278)"
2015,Noviembre,Estonia,233,1,0,1,"(10.445761,-75.516429)"
2017,Diciembre,Grecia,300,0,1,1,"(10.886611,-74.776708)"
2013,Abril,Rumania,642,22,66,88,"(4.697144,-74.140516)"
2013,Junio,Venezuela,862,4,41,45,"(10.408582,-75.538003)"
2018,Julio,Ecuador,218,1,4,5,"(7.088729,-70.740253)"
2022,Febrero,Albania,8,0,6,6,"(6.171601,-75.427454)"
2018,Septiembre,Nigeria,566,0,1,1,"(10.445761,-75.516429)"
2022,Noviembre,Uruguay,858,13,12,25,"(12.586067,-81.702563)"
2019,Junio,Argentina,32,1523,1190,2713,"(10.445761,-75.516429)"
2023,Febrero,Comoras,174,1,1,2,"(4.697144,-74.140516)"
2023,Abril,Portugal,620,2,2,4,"(0.814836,-77.662532)"
2021,Mayo,Noruega,578,0,1,1,"(10.886611,-74.776708)"
2013,Diciembre,Bélgica,56,0,2,2,"(7.927209,-72.507910)"
2013,Julio,Federación de Rusia,643,5,13,18,"(3.541112,-76.384584)"
2012,Diciembre,China,156,7,4,11,"(10.408582,-75.538003)"
2016,Enero,Bulgaria,100,3,0,3,"(3.541112,-76.384584)"
2023,Febrero,Bulgaria,100,0,1,1,"(10.886611,-74.776708)"
2023,Mayo,Reino Unido de Gran Bretaña e Irlanda del Norte,826,7,4,11,"(11.117806,-74.232622)"
2012,Septiembre,Francia,250,5,5,10,"(11.247723,-74.213989)"
2022,Octubre,Suiza,756,0,1,1,"(7.916725,-72.462544)"
2018,Diciembre,Argentina,32,3,8,11,"(-4.197703,-69.941278)"
2016,Enero,Israel,376,2,24,26,"(3.541112,-76.384584)"
2021,Diciembre,Malasia,458,1,2,3,"(3.541112,-76.384584)"
2019,Diciembre,Italia,380,152,293,445,"(10.445761,-75.516429)"
2016,Junio,Rumania,642,4,5,9,"(10.445761,-75.516429)"
2018,Enero,Italia,380,1,10,11,"(11.360009,-72.129330)"
2014,Diciembre,Israel,376,0,1,1,"(8.635765,-77.346578)"
2012,Julio,Noruega,578,93,127,220,"(4.697144,-74.140516)"
2018,Enero,Venezuela,862,2200,2314,4514,"(0.814836,-77.662532)"
2019,Julio,China,156,1,1,2,"(8.36068,-72.409396)"
2022,Junio,Francia,250,0,1,1,"(11.360009,-72.129330)"
2019,Febrero,Malasia,458,0,1,1,"(10.408582,-75.538003)"
2014,Mayo,República de Corea,410,0,4,4,"(7.818934,-72.453226)"
2023,Febrero,Paraguay,600,5,3,8,"(11.117806,-74.232622)"
2014,Enero,Canadá,124,4,3,7,"(-4.197703,-69.941278)"
2016,Enero,Uruguay,858,8,13,21,"(10.886611,-74.776708)"
2016,Mayo,Lituania,440,0,1,1,"(3.893038,-77.067921)"
2022,Julio,Surinam,740,7,5,12,"(6.171601,-75.427454)"
2012,Octubre,Costa de Marfil,384,2,3,5,"(3.541112,-76.384584)"
2022,Julio,Venezuela,862,0,4,4,"(6.17134,-75.427194)"
2021,Mayo,Perú,604,1,6,7,"(-4.223468,-69.945098)"
2013,Julio,República de Belarús,112,9,1,10,"(4.697144,-74.140516)"
2023,Enero,Japón,392,6,6,12,"(3.541112,-76.384584)"
2019,Diciembre,Estonia,233,0,1,1,"(3.541112,-76.384584)"
2023,Enero,Eslovenia,705,2,7,9,"(3.541112,-76.384584)"
2012,Abril,Senegal,686,0,1,1,"(4.697144,-74.140516)"
2018,Octubre,España,724,1,1,2,"(11.247723,-74.213989)"
2014,Enero,República Dominicana,214,3,3,6,"(7.927209,-72.507910)"
2015,Diciembre,Hungría,348,3,1,4,"(3.541112,-76.384584)"
2022,Noviembre,Brasil,76,0,2,2,"(7.916725,-72.462544)"
2017,Abril,Desconocido,99999,1,4,5,"(3.541112,-76.384584)"
2018,Agosto,Israel,376,4,4,8,"(12.586067,-81.702563)"
2018,Julio,Grecia,300,0,1,1,"(9.402978,-75.681599)"
2014,Junio,Bélgica,56,4,8,12,"(10.445761,-75.516429)"
2013,Enero,Argentina,32,190,260,450,"(0.814836,-77.662532)"
2019,Junio,Filipinas,608,3,2,5,"(0.814836,-77.662532)"
2016,Marzo,Barbados,52,3,5,8,"(6.171601,-75.427454)"
2019,Julio,Estados Unidos de América,840,21,18,39,"(7.818934,-72.453226)"
2015,Febrero,Sudán,736,0,1,1,"(4.697144,-74.140516)"
2019,Marzo,Georgia,268,0,2,2,"(9.402978,-75.681599)"
2022,Marzo,Costa Rica,188,0,1,1,"(0.814836,-77.662532)"
2021,Febrero,República Dominicana,214,5,1,6,"(4.815061,-75.736532)"
2014,Febrero,Países Bajos,528,5,9,14,"(11.360009,-72.129330)"
2014,Noviembre,Panamá,591,8,14,22,"(7.128456,-73.183637)"
2022,Julio,Canadá,124,6,9,15,"(0.814836,-77.662532)"
2013,Septiembre,Jordania,400,0,5,5,"(4.697144,-74.140516)"
2012,Noviembre,España,724,1,15,16,"(4.815061,-75.736532)"
2012,Julio,Nueva Zelanda,554,1,3,4,"(3.541112,-76.384584)"
2013,Octubre,Serbia,688,0,1,1,"(10.408582,-75.538003)"
2022,Septiembre,Perú,604,4768,5220,9988,"(4.697144,-74.140516)"
2021,Julio,Sri Lanka,144,0,2,2,"(4.697144,-74.140516)"
2016,Febrero,República Checa,203,1,0,1,"(10.886611,-74.776708)"
2018,Abril,Portugal,620,0,1,1,"(-4.197703,-69.941278)"
2017,Enero,España,724,2725,5605,8330,"(4.697144,-74.140516)"
2015,Abril,Países Bajos,528,0,1,1,"(13.3387613,-81.372937)"
2021,Marzo,Ecuador,218,0,1,1,"(11.247723,-74.213989)"
2018,Abril,Italia,380,724,1686,2410,"(4.697144,-74.140516)"
2019,Junio,Uruguay,858,1,10,11,"(10.886611,-74.776708)"
2023,Mayo,Jamaica,388,8,11,19,"(3.541112,-76.384584)"
2020,Agosto,Argentina,32,12,17,29,"(4.697144,-74.140516)"
2017,Enero,Islandia,352,1,0,1,"(0.814836,-77.662532)"
2019,Junio,China,156,0,2,2,"(10.971302,-74.765397)"
2022,Octubre,Desconocido,99999,2,6,8,"(10.445761,-75.516429)"
2013,Noviembre,Bosnia y Herzegovina,70,2,0,2,"(4.697144,-74.140516)"
2015,Marzo,Bulgaria,100,1,0,1,"(10.886611,-74.776708)"
2020,Octubre,India,356,0,10,10,"(10.445761,-75.516429)"
2014,Agosto,Argentina,32,124,87,211,"(10.408582,-75.538003)"
2023,Abril,Hong Kong,344,0,1,1,"(10.445761,-75.516429)"
2019,Febrero,Mauricio,480,0,1,1,"(10.445761,-75.516429)"
2012,Octubre,Serbia,688,3,6,9,"(4.697144,-74.140516)"
2019,Septiembre,Honduras,340,0,44,44,"(12.5744111,-81.703935)"
2019,Junio,Islas Caimán/Territorio Británico de Ultramar,136,1,0,1,"(12.586067,-81.702563)"
2019,Junio,Polonia,616,1,0,1,"(-4.223468,-69.945098)"
2013,Junio,Bolivia,68,1,2,3,"(4.815061,-75.736532)"
2012,Diciembre,Costa Rica,188,7,9,16,"(4.815061,-75.736532)"
2012,Abril,Mónaco,492,1,1,2,"(4.697144,-74.140516)"
2021,Septiembre,Dominica,212,2,4,6,"(4.697144,-74.140516)"
2019,Octubre,Chile,152,1,0,1,"(8.36068,-72.409396)"
2023,Enero,San Marino,674,0,1,1,"(10.445761,-75.516429)"
2022,Septiembre,Nueva Zelanda,554,1,0,1,"(0.25129,-76.875963)"
2018,Noviembre,Honduras,340,334,351,685,"(4.697144,-74.140516)"
2016,Marzo,Lituania,440,1,3,4,"(0.25129,-76.875963)"
2012,Marzo,Panamá,591,467,851,1318,"(4.697144,-74.140516)"
2023,Junio,Panamá,591,2,1,3,"(0.814836,-77.662532)"
2018,Noviembre,Ecuador,218,86,112,198,"(6.171601,-75.427454)"
2012,Agosto,Grecia,300,0,2,2,"(10.445761,-75.516429)"
2012,Julio,Cuba,192,4,20,24,"(10.886611,-74.776708)"
2022,Septiembre,Costa Rica,188,4,3,7,"(12.586067,-81.702563)"
2019,Octubre,Liberia,430,1,3,4,"(4.697144,-74.140516)"
2012,Diciembre,Uruguay,858,0,3,3,"(8.635765,-77.346578)"
2022,Abril,Canadá,124,1,2,3,"(7.916725,-72.462544)"
2018,Febrero,Mónaco,492,0,1,1,"(3.541112,-76.384584)"
2013,Noviembre,Albania,8,0,2,2,"(4.697144,-74.140516)"
2015,Noviembre,Panamá,591,195,215,410,"(10.445761,-75.516429)"
2013,Noviembre,Argentina,32,1,3,4,"(11.247723,-74.213989)"
2012,Diciembre,Malasia,458,9,23,32,"(4.697144,-74.140516)"
2021,Septiembre,Filipinas,608,2,7,9,"(6.171601,-75.427454)"
2018,Diciembre,Antigua y Barbuda,28,0,1,1,"(7.818934,-72.453226)"
2012,Julio,Nueva Zelanda,554,2,5,7,"(6.171601,-75.427454)"
2017,Marzo,Francia,250,2,4,6,"(13.3387613,-81.372937)"
2019,Julio,Dinamarca,208,7,14,21,"(3.541112,-76.384584)"
2019,Marzo,Turquía,792,0,2,2,"(10.408582,-75.538003)"
2013,Marzo,Finlandia,246,0,8,8,"(10.445761,-75.516429)"
2023,Junio,Brasil,76,711,582,1293,"(10.445761,-75.516429)"
2015,Julio,Uruguay,858,1,4,5,"(-4.197703,-69.941278)"
2015,Julio,Estados Unidos de América,840,90,123,213,"(0.814836,-77.662532)"
2018,Abril,Austria,40,2,6,8,"(3.541112,-76.384584)"
2015,Octubre,Perú,604,28,42,70,"(-4.197703,-69.941278)"
2018,Enero,Japón,392,2,17,19,"(0.814836,-77.662532)"
2023,Febrero,Angola,24,0,7,7,"(4.697144,-74.140516)"
2019,Diciembre,Australia,36,86,178,264,"(6.171601,-75.427454)"
2014,Julio,Grecia,300,0,1,1,"(0.25129,-76.875963)"
2020,Junio,República Árabe Siria,760,0,1,1,"(4.697144,-74.140516)"
2016,Mayo,Myanmar,104,0,1,1,"(3.893038,-77.067921)"
2012,Febrero,Reino Unido de Gran Bretaña e Irlanda del Norte,826,3,8,11,"(7.818934,-72.453226)"
2016,Noviembre,Guyana,328,1,0,1,"(7.818934,-72.453226)"
2012,Junio,Alemania,276,7,7,14,"(-4.197703,-69.941278)"
2018,Junio,Antigua y Barbuda,28,1,1,2,"(10.445761,-75.516429)"
2019,Junio,Ucrania,804,0,1,1,"(9.402978,-75.681599)"
2019,Septiembre,México,484,0,1,1,"(10.971302,-74.765397)"
2019,Abril,Bélgica,56,0,4,4,"(3.893038,-77.067921)"
2016,Noviembre,San Marino,674,0,1,1,"(6.171601,-75.427454)"
2019,Octubre,Venezuela,862,11612,9895,21507,"(7.818934,-72.453226)"
2021,Marzo,Suiza,756,63,199,262,"(4.697144,-74.140516)"
2014,Diciembre,Suiza,756,1,4,5,"(11.360009,-72.129330)"
2015,Enero,Kirguistán,417,2,2,4,"(4.697144,-74.140516)"
2019,Junio,Francia,250,7,4,11,"(0.25129,-76.875963)"
2023,Abril,Italia,380,0,1,1,"(-4.223468,-69.945098)"
2013,Noviembre,Panamá,591,1,9,10,"(7.818934,-72.453226)"
2020,Enero,Reino Unido de Gran Bretaña e Irlanda del Norte,826,2,4,6,"(7.818934,-72.453226)"
2016,Febrero,República Dominicana,214,1,0,1,"(7.128456,-73.183637)"
2019,Agosto,Hungría,348,35,51,86,"(4.697144,-74.140516)"
2018,Noviembre,Grecia,300,3,19,22,"(10.445761,-75.516429)"
2014,Diciembre,Italia,380,36,122,158,"(10.445761,-75.516429)"
2015,Mayo,Chile,152,26,47,73,"(0.814836,-77.662532)"
2017,Diciembre,Ecuador,218,2,14,16,"(10.886611,-74.776708)"
2012,Octubre,Panamá,591,5,6,11,"(7.927209,-72.507910)"
2019,Abril,Polonia,616,0,4,4,"(8.066966,-76.735404)"
2021,Septiembre,Aruba,533,1,0,1,"(4.697144,-74.140516)"
2012,Mayo,España,724,1,2,3,"(13.3387613,-81.372937)"
2012,Mayo,Ucrania,804,1,0,1,"(6.171601,-75.427454)"
2014,Febrero,Sudáfrica,710,1,2,3,"(10.445761,-75.516429)"
2017,Agosto,Noruega,578,80,114,194,"(4.697144,-74.140516)"
2015,Mayo,Alemania,276,14,22,36,"(10.408582,-75.538003)"
2012,Marzo,Suiza,756,2,4,6,"(10.886611,-74.776708)"
2012,Agosto,República de Irlanda,372,5,9,14,"(10.445761,-75.516429)"
2013,Agosto,Cuba,192,8,12,20,"(10.445761,-75.516429)"
2017,Febrero,Venezuela,862,90,121,211,"(10.445761,-75.516429)"
2013,Enero,Bélgica,56,4,12,16,"(10.445761,-75.516429)"
2015,Diciembre,Federación de Rusia,643,3,3,6,"(11.360009,-72.129330)"
2015,Agosto,Dominica,212,0,4,4,"(10.445761,-75.516429)"
2014,Septiembre,Alemania,276,64,54,118,"(0.814836,-77.662532)"
2019,Septiembre,Japón,392,1,1,2,"(12.586067,-81.702563)"
2022,Marzo,Venezuela,862,0,6,6,"(11.247723,-74.213989)"
2016,Junio,Eslovenia,705,2,1,3,"(6.171601,-75.427454)"
2013,Agosto,Santa Lucia,662,1,1,2,"(10.445761,-75.516429)"
2018,Abril,Estonia,233,4,2,6,"(10.445761,-75.516429)"
2021,Marzo,Taiwán,158,1,2,3,"(6.171601,-75.427454)"
2022,Diciembre,Paraguay,600,2,0,2,"(11.117806,-74.232622)"
2015,Junio,Haití,332,8,26,34,"(4.697144,-74.140516)"
2015,Julio,Polonia,616,5,14,19,"(6.171601,-75.427454)"
2016,Septiembre,Taiwán,158,0,1,1,"(12.586067,-81.702563)"
2019,Diciembre,Japón,392,0,1,1,"(6.185799,-67.483929)"
2023,Enero,Suecia,752,1,1,2,"(8.364293,-72.405710)"
2015,Diciembre,Perú,604,5,7,12,"(7.128456,-73.183637)"
2022,Noviembre,San  Vicente y las Granadinas,670,2,4,6,"(4.697144,-74.140516)"
2012,Octubre,Santa Lucia,662,2,3,5,"(4.697144,-74.140516)"
2023,Febrero,Omán,512,3,3,6,"(4.697144,-74.140516)"
2022,Marzo,Austria,40,0,1,1,"(4.815061,-75.736532)"
2013,Agosto,República Democrática Popular  Lao,418,2,2,4,"(4.697144,-74.140516)"
2012,Septiembre,Luxemburgo,442,0,2,2,"(0.814836,-77.662532)"
2018,Noviembre,Alemania,276,1,0,1,"(12.5744111,-81.703935)"
2022,Noviembre,Francia,250,209,377,586,"(6.171601,-75.427454)"
2019,Enero,Reino Unido de Gran Bretaña e Irlanda del Norte,826,51,59,110,"(10.408582,-75.538003)"
2022,Junio,República Dominicana,214,1,1,2,"(7.088729,-70.740253)"
2015,Marzo,Federación de Rusia,643,11,11,22,"(0.814836,-77.662532)"
2012,Abril,Polonia,616,0,4,4,"(11.247723,-74.213989)"
2017,Mayo,Venezuela,862,10,12,22,"(3.866713,-67.927521)"
2021,Octubre,Bélgica,56,85,237,322,"(4.697144,-74.140516)"
2023,Mayo,República de Armenia,51,1,0,1,"(6.171601,-75.427454)"
2013,Octubre,Panamá,591,0,9,9,"(8.066966,-76.735404)"
2021,Noviembre,Grecia,300,0,1,1,"(4.815061,-75.736532)"
2014,Diciembre,Senegal,686,0,1,1,"(10.445761,-75.516429)"
2015,Octubre,Países Bajos,528,4,3,7,"(8.635765,-77.346578)"
2018,Abril,República Checa,203,17,2,19,"(8.635765,-77.346578)"
2022,Febrero,Canadá,124,1,9,10,"(10.408582,-75.538003)"
2016,Octubre,Guatemala,320,70,209,279,"(6.171601,-75.427454)"
2017,Marzo,Filipinas,608,1,58,59,"(10.408582,-75.538003)"
2017,Mayo,Venezuela,862,118,189,307,"(10.445761,-75.516429)"
2014,Junio,Panamá,591,0,1,1,"(0.814836,-77.662532)"
2022,Noviembre,Bolivia,68,0,2,2,"(6.18189,-67.47535)"
2020,Diciembre,Canadá,124,0,1,1,"(6.17134,-75.427194)"
2021,Noviembre,Alemania,276,1,6,7,"(4.815061,-75.736532)"
2012,Septiembre,Bulgaria,100,3,1,4,"(6.171601,-75.427454)"
2013,Febrero,Bélgica,56,1,0,1,"(11.360009,-72.129330)"
2019,Julio,Estados Unidos de América,840,69,73,142,"(7.128456,-73.183637)"
2022,Julio,Croacia,191,1,2,3,"(3.541112,-76.384584)"
2019,Febrero,Noruega,578,4,2,6,"(10.886611,-74.776708)"
2018,Julio,Estados Unidos de América,840,68,88,156,"(12.586067,-81.702563)"
2018,Abril,México,484,4212,7667,11879,"(4.697144,-74.140516)"
2017,Mayo,Turquía,792,1,16,17,"(6.171601,-75.427454)"
2012,Junio,Trinidad y Tobago,780,0,1,1,"(4.815061,-75.736532)"
2012,Diciembre,Sudáfrica,710,3,1,4,"(0.814836,-77.662532)"
2014,Agosto,Ecuador,218,3,10,13,"(-4.197703,-69.941278)"
2012,Abril,Suiza,756,2,1,3,"(7.818934,-72.453226)"
2012,Febrero,Cuba,192,65,156,221,"(4.697144,-74.140516)"
2015,Septiembre,Chile,152,56,25,81,"(12.586067,-81.702563)"
2014,Mayo,Austria,40,2,4,6,"(3.541112,-76.384584)"
2013,Febrero,República de Corea,410,1,3,4,"(10.445761,-75.516429)"
2012,Diciembre,Jamaica,388,1,2,3,"(3.541112,-76.384584)"
2021,Julio,Chile,152,6,7,13,"(7.818934,-72.453226)"
2022,Marzo,Suecia,752,3,6,9,"(3.541112,-76.384584)"
2013,Noviembre,Japón,392,0,1,1,"(12.586067,-81.702563)"
2017,Octubre,India,356,5,56,61,"(6.171601,-75.427454)"
2021,Septiembre,España,724,7,26,33,"(10.886611,-74.776708)"
2018,Mayo,Barbados,52,1,1,2,"(6.171601,-75.427454)"
2020,Febrero,Federación de Rusia,643,2,1,3,"(4.815061,-75.736532)"
2017,Febrero,Túnez,788,10,8,18,"(4.697144,-74.140516)"
2023,Enero,Nigeria,566,2,6,8,"(4.697144,-74.140516)"
2017,Agosto,Surinam,740,0,1,1,"(11.360009,-72.129330)"
2018,Abril,Arabia Saudita,682,1,4,5,"(4.697144,-74.140516)"
2017,Agosto,Panamá,591,364,376,740,"(10.445761,-75.516429)"
2022,Abril,Austria,40,1,0,1,"(4.452882,-75.766298)"
2014,Mayo,Polonia,616,5,4,9,"(0.814836,-77.662532)"
2016,Febrero,Canadá,124,22,49,71,"(10.886611,-74.776708)"
2020,Marzo,Nepal,524,0,4,4,"(4.697144,-74.140516)"
2015,Agosto,Honduras,340,9,15,24,"(10.445761,-75.516429)"
2016,Mayo,Ecuador,218,36,65,101,"(7.818934,-72.453226)"
2015,Diciembre,Francia,250,4,4,8,"(13.3387613,-81.372937)"
2022,Noviembre,Uruguay,858,135,90,225,"(10.445761,-75.516429)"
2016,Septiembre,Taiwán,158,0,5,5,"(0.814836,-77.662532)"
2014,Septiembre,Bélgica,56,1,1,2,"(11.247723,-74.213989)"
2021,Marzo,Italia,380,15,44,59,"(10.445761,-75.516429)"
2016,Mayo,Dinamarca,208,9,18,27,"(6.171601,-75.427454)"
2020,Marzo,Sri Lanka,144,3,2,5,"(4.697144,-74.140516)"
2014,Diciembre,Bután,64,0,1,1,"(4.697144,-74.140516)"
2016,Agosto,Bahamas,44,7,9,16,"(6.171601,-75.427454)"
2021,Mayo,España,724,1,3,4,"(7.128456,-73.183637)"
2020,Enero,Federación de Rusia,643,1,0,1,"(8.36068,-72.409396)"
2015,Enero,Perú,604,283,681,964,"(0.814836,-77.662532)"
2019,Julio,San Marino,674,0,1,1,"(10.445761,-75.516429)"
2023,Abril,Emiratos Árabes,784,0,1,1,"(3.541112,-76.384584)"
2022,Julio,Honduras,340,41,39,80,"(3.541112,-76.384584)"
2016,Noviembre,Bélgica,56,19,42,61,"(6.171601,-75.427454)"
2019,Febrero,El Salvador,222,0,1,1,"(11.360009,-72.129330)"
2022,Diciembre,Haití,332,4,3,7,"(6.171601,-75.427454)"
2020,Diciembre,Italia,380,5,1,6,"(7.818934,-72.453226)"
2013,Enero,España,724,1,1,2,"(4.452882,-75.766298)"
2018,Octubre,Canadá,124,2,6,8,"(7.128456,-73.183637)"
2018,Noviembre,Guatemala,320,0,1,1,"(11.360009,-72.129330)"
2017,Septiembre,Canadá,124,2,3,5,"(11.247723,-74.213989)"
2016,Noviembre,Nepal,524,0,2,2,"(3.541112,-76.384584)"
2016,Noviembre,Sudáfrica,710,5,9,14,"(6.171601,-75.427454)"
2012,Marzo,Líbano,422,5,5,10,"(11.360009,-72.129330)"
2019,Junio,Argentina,32,8,10,18,"(11.360009,-72.129330)"
2022,Septiembre,El Salvador,222,190,134,324,"(10.445761,-75.516429)"
2021,Octubre,Alemania,276,3,2,5,"(11.247723,-74.213989)"
2022,Diciembre,Polonia,616,5,8,13,"(10.886611,-74.776708)"
2018,Abril,Brasil,76,414,328,742,"(12.586067,-81.702563)"
2022,Marzo,Camerún,120,0,3,3,"(10.445761,-75.516429)"
2016,Diciembre,Estonia,233,1,3,4,"(6.171601,-75.427454)"
2021,Agosto,Cuba,192,0,8,8,"(4.815061,-75.736532)"
2019,Octubre,Zimbabue,716,4,3,7,"(4.697144,-74.140516)"
2013,Julio,Honduras,340,8,30,38,"(10.445761,-75.516429)"
2014,Septiembre,Estados Unidos de América,840,4509,9955,14464,"(4.697144,-74.140516)"
2014,Noviembre,Chile,152,20,50,70,"(0.814836,-77.662532)"
2018,Octubre,Panamá,591,2,15,17,"(10.408582,-75.538003)"
2017,Julio,Filipinas,608,0,1,1,"(9.402978,-75.681599)"
2015,Septiembre,Canadá,124,0,4,4,"(7.818934,-72.453226)"
2013,Abril,Isla de Man,833,36,30,66,"(0.814836,-77.662532)"
2019,Diciembre,Brasil,76,4218,4874,9092,"(4.697144,-74.140516)"
2018,Febrero,Nicaragua,558,0,1,1,"(10.408582,-75.538003)"
2014,Julio,República de Irlanda,372,3,10,13,"(-4.197703,-69.941278)"
2014,Enero,El Salvador,222,1,0,1,"(1.813928,-78.763924)"
2013,Septiembre,Nicaragua,558,1,1,2,"(7.128456,-73.183637)"
2021,Enero,Jamaica,388,0,5,5,"(10.445761,-75.516429)"
2014,Diciembre,Australia,36,1,10,11,"(7.818934,-72.453226)"
2018,Marzo,Costa Rica,188,175,138,313,"(10.445761,-75.516429)"
2023,Enero,Trinidad y Tobago,780,0,1,1,"(11.360009,-72.129330)"
2016,Enero,Andorra,20,0,2,2,"(4.452882,-75.766298)"
2023,Febrero,España,724,8,10,18,"(11.117806,-74.232622)"
2013,Julio,México,484,13,31,44,"(0.814836,-77.662532)"
2015,Agosto,Malawi,454,1,3,4,"(4.697144,-74.140516)"
2022,Noviembre,Canadá,124,3,5,8,"(-4.223468,-69.945098)"
2023,Enero,China,156,0,1,1,"(12.586067,-81.702563)"
2019,Junio,Guatemala,320,1,1,2,"(7.128456,-73.183637)"
2020,Enero,Países Bajos,528,19,22,41,"(10.408582,-75.538003)"
2013,Abril,Argentina,32,97,243,340,"(6.171601,-75.427454)"
2018,Septiembre,Angola,24,0,1,1,"(6.171601,-75.427454)"
2019,Agosto,Madagascar,450,1,0,1,"(6.171601,-75.427454)"
2015,Octubre,Nicaragua,558,64,71,135,"(4.697144,-74.140516)"
2021,Octubre,Australia,36,1,3,4,"(10.886611,-74.776708)"
2020,Mayo,Venezuela,862,6,29,35,"(4.697144,-74.140516)"
2023,Marzo,Lituania,440,3,0,3,"(10.408582,-75.538003)"
2015,Marzo,Antigua y Barbuda,28,0,1,1,"(10.445761,-75.516429)"
2014,Agosto,Lituania,440,1,0,1,"(6.171601,-75.427454)"
2019,Junio,Haití,332,1,9,10,"(6.171601,-75.427454)"
2022,Enero,Serbia,688,7,5,12,"(6.171601,-75.427454)"
2014,Diciembre,Polonia,616,0,1,1,"(11.247723,-74.213989)"
2015,Diciembre,Desconocido,99999,0,1,1,"(3.541112,-76.384584)"
2019,Septiembre,Alemania,276,8,8,16,"(8.635765,-77.346578)"
2019,Diciembre,Croacia,191,0,1,1,"(-4.223468,-69.945098)"
2013,Marzo,Israel,376,1,5,6,"(10.408582,-75.538003)"
2020,Enero,Brasil,76,0,1,1,"(6.185799,-67.483929)"
2019,Octubre,Letonia,428,1,1,2,"(0.814836,-77.662532)"
2018,Febrero,Francia,250,5,1,6,"(7.128456,-73.183637)"
2015,Febrero,Paraguay,600,0,1,1,"(11.360009,-72.129330)"
2017,Diciembre,Malta,470,1,1,2,"(6.171601,-75.427454)"
2016,Mayo,Uruguay,858,4,8,12,"(0.814836,-77.662532)"
2012,Julio,Bulgaria,100,7,3,10,"(4.697144,-74.140516)"
2014,Marzo,Grecia,300,0,1,1,"(11.247723,-74.213989)"
2021,Enero,Santa Lucia,662,1,0,1,"(4.697144,-74.140516)"
2015,Junio,Panamá,591,0,1,1,"(11.247723,-74.213989)"
2022,Mayo,Argentina,32,2455,3674,6129,"(4.697144,-74.140516)"
2021,Noviembre,Dinamarca,208,2,4,6,"(3.541112,-76.384584)"
2016,Junio,Filipinas,608,0,1,1,"(9.402978,-75.681599)"
2017,Noviembre,Jamaica,388,1,2,3,"(12.586067,-81.702563)"
2018,Noviembre,Etiopia,231,1,45,46,"(4.697144,-74.140516)"
2017,Octubre,Ecuador,218,0,4,4,"(7.128456,-73.183637)"
2017,Mayo,Alemania,276,37,54,91,"(3.541112,-76.384584)"
2016,Agosto,Santa Lucia,662,1,1,2,"(10.886611,-74.776708)"
2012,Octubre,Israel,376,1,3,4,"(-4.197703,-69.941278)"
2014,Febrero,Bélgica,56,1,4,5,"(7.818934,-72.453226)"
2019,Enero,Alemania,276,3,1,4,"(11.117806,-74.232622)"
2014,Diciembre,Filipinas,608,0,1,1,"(8.066966,-76.735404)"
2023,Abril,Países Bajos,528,37,18,55,"(10.408582,-75.538003)"
2015,Octubre,Francia,250,0,1,1,"(7.927209,-72.507910)"
2018,Agosto,Venezuela,862,1,34,35,"(12.165168,-71.983761)"
2017,Noviembre,Rumania,642,3,8,11,"(10.408582,-75.538003)"
2019,Febrero,Venezuela,862,22,19,41,"(10.408582,-75.538003)"
2015,Abril,Perú,604,0,1,1,"(3.893038,-77.067921)"
2012,Noviembre,República de Irlanda,372,3,12,15,"(6.171601,-75.427454)"
2019,Mayo,República de Corea,410,182,489,671,"(4.697144,-74.140516)"
2017,Marzo,República de Irlanda,372,4,6,10,"(3.541112,-76.384584)"
2022,Agosto,Nueva Zelanda,554,0,4,4,"(10.886611,-74.776708)"
2017,Julio,Zimbabue,716,1,1,2,"(10.445761,-75.516429)"
2019,Junio,Indonesia,360,0,2,2,"(3.541112,-76.384584)"
2019,Mayo,Ecuador,218,1399,2116,3515,"(0.814836,-77.662532)"
2013,Febrero,Isla de Man,833,14,40,54,"(6.171601,-75.427454)"
2019,Noviembre,Perú,604,2,3,5,"(-4.197703,-69.941278)"
2018,Junio,Turquía,792,1,4,5,"(10.408582,-75.538003)"
2018,Septiembre,Paraguay,600,12,7,19,"(10.886611,-74.776708)"
2012,Diciembre,Alemania,276,52,72,124,"(0.814836,-77.662532)"
2017,Diciembre,República de Irlanda,372,1,1,2,"(-4.197703,-69.941278)"
2013,Noviembre,República Dominicana,214,0,1,1,"(12.586067,-81.702563)"
2022,Diciembre,Liberia,430,0,2,2,"(10.445761,-75.516429)"
2013,Octubre,Brasil,76,2868,4306,7174,"(4.697144,-74.140516)"
2012,Agosto,India,356,5,22,27,"(6.171601,-75.427454)"
2019,Mayo,Letonia,428,1,1,2,"(3.541112,-76.384584)"
2013,Julio,Australia,36,6,7,13,"(10.886611,-74.776708)"
2019,Abril,México,484,14,15,29,"(4.815061,-75.736532)"
2022,Diciembre,Venezuela,862,0,40,40,"(10.408582,-75.538003)"
2012,Mayo,República de Irlanda,372,1,1,2,"(-4.197703,-69.941278)"
2013,Agosto,Desconocido,99999,0,1,1,"(4.697144,-74.140516)"
2019,Mayo,Costa Rica,188,1,0,1,"(11.360009,-72.129330)"
2018,Febrero,Belice,84,0,2,2,"(6.171601,-75.427454)"
2018,Marzo,Kazajistán,398,2,0,2,"(10.445761,-75.516429)"
2016,Febrero,Andorra,20,1,0,1,"(3.541112,-76.384584)"
2016,Enero,Suecia,752,1,2,3,"(12.586067,-81.702563)"
2023,Abril,Estados Unidos de América,840,2,4,6,"(11.247723,-74.213989)"
2019,Junio,Perú,604,2,2,4,"(4.452882,-75.766298)"
2019,Mayo,Portugal,620,1,1,2,"(8.36068,-72.409396)"
2017,Agosto,Guyana,328,1,1,2,"(7.818934,-72.453226)"
2012,Noviembre,República de Irlanda,372,8,15,23,"(10.445761,-75.516429)"
2019,Octubre,Macedonia,807,6,4,10,"(4.697144,-74.140516)"
2022,Octubre,Venezuela,862,13,30,43,"(-4.197703,-69.941278)"
2022,Junio,Malta,470,2,4,6,"(6.171601,-75.427454)"
2017,Mayo,Irán,364,0,1,1,"(6.171601,-75.427454)"
2013,Agosto,Hungría,348,0,1,1,"(0.814836,-77.662532)"
2022,Julio,Países Bajos,528,12,10,22,"(8.635765,-77.346578)"
2019,Agosto,Antigua y Barbuda,28,1,0,1,"(10.445761,-75.516429)"
2018,Julio,Cuba,192,1,3,4,"(0.814836,-77.662532)"
2016,Noviembre,Italia,380,51,105,156,"(10.445761,-75.516429)"
2018,Septiembre,Federación de Rusia,643,1,1,2,"(4.815061,-75.736532)"
2012,Octubre,Nueva Zelanda,554,1,1,2,"(6.171601,-75.427454)"
2022,Diciembre,Turquía,792,0,1,1,"(11.247723,-74.213989)"
2016,Marzo,Pakistán,586,12,15,27,"(4.697144,-74.140516)"
2022,Octubre,Perú,604,7,8,15,"(7.927209,-72.507910)"
2018,Marzo,Georgia,268,1,2,3,"(10.445761,-75.516429)"
2012,Marzo,Perú,604,127,89,216,"(10.445761,-75.516429)"
2012,Abril,Lituania,440,4,9,13,"(4.697144,-74.140516)"
2015,Septiembre,Japón,392,0,7,7,"(4.815061,-75.736532)"
2013,Diciembre,República Checa,203,4,6,10,"(0.814836,-77.662532)"
2017,Junio,Filipinas,608,0,2,2,"(7.818934,-72.453226)"
2012,Febrero,Guatemala,320,22,44,66,"(6.171601,-75.427454)"
2012,Marzo,Brasil,76,39,28,67,"(12.586067,-81.702563)"
2019,Octubre,El Salvador,222,0,1,1,"(10.408582,-75.538003)"
2020,Noviembre,Kazajistán,398,2,1,3,"(4.697144,-74.140516)"
2012,Julio,Turquía,792,0,5,5,"(7.818934,-72.453226)"
2014,Octubre,Países Bajos,528,270,319,589,"(6.171601,-75.427454)"
2019,Septiembre,Nueva Zelanda,554,13,21,34,"(10.445761,-75.516429)"
2019,Agosto,Francia,250,1,3,4,"(7.818934,-72.453226)"
2018,Abril,Chile,152,33,54,87,"(3.541112,-76.384584)"
2018,Abril,Nueva Zelanda,554,16,18,34,"(10.445761,-75.516429)"
2012,Abril,Estados Unidos de América,840,0,1,1,"(11.528919,-72.919681)"
2016,Septiembre,Portugal,620,1,6,7,"(10.886611,-74.776708)"
2021,Junio,Suiza,756,80,160,240,"(4.697144,-74.140516)"
2014,Septiembre,Guinea Ecuatorial,226,1,0,1,"(3.541112,-76.384584)"
2018,Mayo,Bolivia,68,16,16,32,"(0.814836,-77.662532)"
2019,Diciembre,India,356,4,7,11,"(3.541112,-76.384584)"
2016,Enero,Haití,332,0,1,1,"(10.886611,-74.776708)"
2022,Febrero,Guyana,328,0,5,5,"(4.697144,-74.140516)"
2013,Marzo,Italia,380,1,0,1,"(13.3387613,-81.372937)"
2018,Julio,Reino Unido de Gran Bretaña e Irlanda del Norte,826,55,70,126,"(10.886611,-74.776708)"
2022,Agosto,Jamaica,388,0,1,1,"(-4.197703,-69.941278)"
2021,Diciembre,República Dominicana,214,1388,1409,2798,"(4.697144,-74.140516)"
2012,Febrero,Bulgaria,100,4,7,11,"(4.697144,-74.140516)"
2023,Marzo,Brasil,76,162,155,317,"(12.586067,-81.702563)"
2021,Abril,Estados Unidos de América,840,128,161,289,"(4.452882,-75.766298)"
2012,Enero,Uzbekistán,860,0,1,1,"(3.541112,-76.384584)"
2017,Enero,Ucrania,804,34,28,62,"(4.697144,-74.140516)"
2016,Junio,Venezuela,862,0,2,2,"(12.5744111,-81.703935)"
2013,Marzo,Noruega,578,0,1,1,"(7.927209,-72.507910)"
2012,Marzo,Chile,152,8,28,36,"(10.886611,-74.776708)"
2019,Abril,Eslovaquia,703,2,2,4,"(10.445761,-75.516429)"
2022,Octubre,Desconocido,99999,2,0,2,"(7.818934,-72.453226)"
2012,Octubre,Ecuador,218,79,126,205,"(7.818934,-72.453226)"
2013,Enero,Puerto Rico/Territorio de Estados Unidos,630,0,3,3,"(4.697144,-74.140516)"
2022,Septiembre,Singapur,702,0,1,1,"(10.408582,-75.538003)"
2017,Junio,Arabia Saudita,682,1,0,1,"(3.541112,-76.384584)"
2023,Mayo,Croacia,191,0,1,1,"(3.893038,-77.067921)"
2018,Julio,México,484,2,1,3,"(7.088729,-70.740253)"
2013,Noviembre,España,724,3,23,26,"(4.815061,-75.736532)"
2012,Junio,Dinamarca,208,1,0,1,"(7.818934,-72.453226)"
2012,Octubre,Países Bajos,528,5,4,9,"(10.886611,-74.776708)"
2012,Noviembre,Finlandia,246,2,0,2,"(12.586067,-81.702563)"
2018,Junio,Francia,250,6,2,8,"(-4.197703,-69.941278)"
2019,Febrero,Bélgica,56,0,1,1,"(7.128456,-73.183637)"
2022,Marzo,Macedonia,807,0,1,1,"(0.814836,-77.662532)"
2022,Diciembre,Brasil,76,10,6,16,"(11.117806,-74.232622)"
2014,Noviembre,Tailandia,764,1,0,1,"(6.171601,-75.427454)"
2017,Diciembre,Noruega,578,0,1,1,"(-4.223468,-69.945098)"
2022,Enero,República de Belarús,112,0,1,1,"(10.408582,-75.538003)"
2018,Junio,Dinamarca,208,13,16,29,"(10.445761,-75.516429)"
2018,Marzo,Sudáfrica,710,3,5,8,"(10.408582,-75.538003)"
2020,Diciembre,Croacia,191,1,0,1,"(10.445761,-75.516429)"
2023,Junio,República de Irlanda,372,9,8,17,"(8.635765,-77.346578)"
2013,Diciembre,Israel,376,0,1,1,"(4.452882,-75.766298)"
2015,Junio,Perú,604,151,219,370,"(3.541112,-76.384584)"
2019,Diciembre,Turquía,792,0,4,4,"(9.402978,-75.681599)"
2016,Marzo,Croacia,191,0,2,2,"(9.402978,-75.681599)"
2022,Abril,Filipinas,608,6,57,63,"(10.445761,-75.516429)"
2017,Septiembre,Venezuela,862,5,2,7,"(-4.197703,-69.941278)"
2020,Agosto,República Dominicana,214,0,1,1,"(11.117806,-74.232622)"
2014,Julio,Panamá,591,0,4,4,"(12.5744111,-81.703935)"
2020,Enero,República Dominicana,214,4,12,16,"(10.886611,-74.776708)"
2023,Abril,Federación de Rusia,643,0,12,12,"(3.893038,-77.067921)"
2016,Octubre,Letonia,428,0,3,3,"(9.402978,-75.681599)"
2019,Enero,México,484,8,17,25,"(10.408582,-75.538003)"
2013,Julio,Turquía,792,0,1,1,"(7.818934,-72.453226)"
2017,Abril,Nueva Zelanda,554,0,1,1,"(11.247723,-74.213989)"
2012,Mayo,Federación de Rusia,643,0,1,1,"(10.408582,-75.538003)"
2016,Mayo,San  Vicente y las Granadinas,670,0,2,2,"(4.697144,-74.140516)"
2017,Abril,España,724,207,369,576,"(3.541112,-76.384584)"
2016,Febrero,Panamá,591,0,4,4,"(12.5744111,-81.703935)"
2016,Agosto,Venezuela,862,106,263,369,"(10.886611,-74.776708)"
2022,Julio,Perú,604,46,75,121,"(7.818934,-72.453226)"
2023,Febrero,Austria,40,5,5,10,"(3.541112,-76.384584)"
2012,Marzo,Panamá,591,8,12,20,"(7.128456,-73.183637)"
2023,Mayo,Cuba,192,4,1,5,"(7.128456,-73.183637)"
2012,Enero,México,484,84,272,356,"(6.171601,-75.427454)"
2022,Marzo,Ecuador,218,5,2,7,"(7.916725,-72.462544)"
2013,Agosto,Suiza,756,280,415,695,"(4.697144,-74.140516)"
2022,Julio,España,724,605,848,1454,"(6.171601,-75.427454)"
2015,Julio,Australia,36,33,55,88,"(0.814836,-77.662532)"
2012,Junio,Italia,380,0,1,1,"(8.635765,-77.346578)"
2012,Febrero,Marruecos,504,0,2,2,"(4.697144,-74.140516)"
2016,Enero,Polonia,616,0,2,2,"(10.971302,-74.765397)"
2023,Enero,Serbia,688,12,8,20,"(10.445761,-75.516429)"
2021,Diciembre,Paraguay,600,1,1,2,"(4.452882,-75.766298)"
2018,Septiembre,República Dominicana,214,5,15,20,"(0.814836,-77.662532)"
2016,Marzo,Polonia,616,3,10,13,"(10.408582,-75.538003)"
2022,Febrero,Cuba,192,11,17,28,"(10.445761,-75.516429)"
2012,Mayo,Eslovaquia,703,0,1,1,"(4.815061,-75.736532)"
2021,Octubre,México,484,0,10,10,"(6.228046,-77.404104)"
2016,Diciembre,Ecuador,218,6,11,17,"(12.586067,-81.702563)"
2017,Febrero,Filipinas,608,0,67,67,"(10.408582,-75.538003)"
2022,Abril,Perú,604,2,8,10,"(4.815061,-75.736532)"
2017,Septiembre,Filipinas,608,3,84,87,"(10.445761,-75.516429)"
2016,Noviembre,España,724,8,14,22,"(4.815061,-75.736532)"
2012,Diciembre,Chile,152,47,91,138,"(0.814836,-77.662532)"
2019,Septiembre,Honduras,340,139,95,234,"(10.445761,-75.516429)"
2019,Diciembre,Noruega,578,0,3,3,"(-4.197703,-69.941278)"
2013,Septiembre,Bolivia,68,3,3,6,"(10.408582,-75.538003)"
2012,Febrero,Perú,604,5,7,12,"(11.360009,-72.129330)"
2018,Junio,Reino Unido de Gran Bretaña e Irlanda del Norte,826,3,11,14,"(-4.223468,-69.945098)"
2017,Febrero,Turquía,792,1,2,3,"(3.541112,-76.384584)"
2018,Octubre,Italia,380,1,1,2,"(6.185799,-67.483929)"
2016,Abril,Chile,152,28,20,48,"(12.586067,-81.702563)"
2012,Diciembre,Chile,152,1,2,3,"(7.128456,-73.183637)"
2019,Septiembre,Bélgica,56,6,10,16,"(0.814836,-77.662532)"
2013,Noviembre,Honduras,340,7,5,12,"(10.886611,-74.776708)"
2021,Noviembre,Alemania,276,29,31,60,"(3.541112,-76.384584)"
2016,Enero,Japón,392,6,10,16,"(0.814836,-77.662532)"
2023,Marzo,Venezuela,862,155,144,299,"(0.25129,-76.875963)"
2016,Diciembre,Bahamas,44,2,0,2,"(10.886611,-74.776708)"
2016,Junio,Suecia,752,6,2,8,"(-4.197703,-69.941278)"
2013,Septiembre,Austria,40,3,15,18,"(6.171601,-75.427454)"
2016,Noviembre,Georgia,268,0,1,1,"(10.886611,-74.776708)"
2014,Febrero,Nueva Zelanda,554,1,4,5,"(8.635765,-77.346578)"
2022,Octubre,Sudáfrica,710,1,1,2,"(11.247723,-74.213989)"
2020,Marzo,Estados Unidos de América,840,5,5,10,"(8.635765,-77.346578)"
2014,Mayo,Guatemala,320,0,1,1,"(0.814836,-77.662532)"
2022,Agosto,Paraguay,600,0,2,2,"(0.814836,-77.662532)"
2017,Septiembre,Jamaica,388,1,0,1,"(10.408582,-75.538003)"
2019,Febrero,España,724,4,6,10,"(0.25129,-76.875963)"
2015,Febrero,República de Irlanda,372,3,3,6,"(10.408582,-75.538003)"
2016,Junio,Bahamas,44,0,1,1,"(10.886611,-74.776708)"
2019,Junio,Bulgaria,100,27,15,42,"(4.697144,-74.140516)"
2016,Noviembre,Nueva Zelanda,554,6,5,11,"(10.445761,-75.516429)"
2018,Enero,España,724,0,1,1,"(12.5744111,-81.703935)"
2012,Mayo,Malta,470,1,1,2,"(10.445761,-75.516429)"
2013,Noviembre,Venezuela,862,1678,2290,3968,"(7.818934,-72.453226)"
2018,Julio,Francia,250,4,10,14,"(7.128456,-73.183637)"
2018,Diciembre,Alemania,276,3,2,5,"(8.36068,-72.409396)"
2014,Diciembre,Argentina,32,0,1,1,"(4.452882,-75.766298)"
2015,Abril,Costa Rica,188,30,73,103,"(3.541112,-76.384584)"
2014,Agosto,Suecia,752,2,7,9,"(3.541112,-76.384584)"
2016,Junio,Federación de Rusia,643,1,1,2,"(-4.197703,-69.941278)"
2012,Agosto,Trinidad y Tobago,780,3,1,4,"(7.128456,-73.183637)"
2019,Abril,Bolivia,68,23,15,38,"(10.408582,-75.538003)"
2022,Octubre,Países Bajos,528,1417,1939,3356,"(4.697144,-74.140516)"
2018,Marzo,Zambia,894,3,0,3,"(4.697144,-74.140516)"
2018,Septiembre,Ecuador,218,70,100,170,"(6.171601,-75.427454)"
2018,Septiembre,China,156,1,0,1,"(12.586067,-81.702563)"
2022,Junio,Filipinas,608,0,6,6,"(11.247723,-74.213989)"
2018,Noviembre,Ucrania,804,0,4,4,"(3.541112,-76.384584)"
2021,Marzo,Taiwán,158,2,2,4,"(4.697144,-74.140516)"
2012,Octubre,Chile,152,4,12,16,"(11.360009,-72.129330)"
2015,Junio,Nueva Zelanda,554,6,2,8,"(10.408582,-75.538003)"
2019,Enero,Polonia,616,258,382,640,"(4.697144,-74.140516)"
2019,Enero,Australia,36,2,2,4,"(-4.197703,-69.941278)"
2019,Mayo,Granada,308,0,1,1,"(4.697144,-74.140516)"
2021,Diciembre,534,99999,1,0,1,"(4.697144,-74.140516)"
2017,Febrero,Islas Turcas y Caicos/Territorio Británico de Ultramar,796,1,0,1,"(10.886611,-74.776708)"
2017,Abril,Brasil,76,0,2,2,"(8.635765,-77.346578)"
2013,Julio,España,724,1,0,1,"(1.813928,-78.763924)"
2012,Noviembre,Georgia,268,0,3,3,"(4.697144,-74.140516)"
2014,Noviembre,Andorra,20,1,9,10,"(4.697144,-74.140516)"
2016,Marzo,Hong Kong,344,1,0,1,"(6.171601,-75.427454)"
2015,Enero,España,724,149,422,571,"(6.171601,-75.427454)"
2017,Septiembre,Croacia,191,0,2,2,"(10.886611,-74.776708)"
2018,Diciembre,Panamá,591,46,58,104,"(4.815061,-75.736532)"
2019,Abril,India,356,0,16,16,"(10.408582,-75.538003)"
2020,Febrero,Zimbabue,716,1,0,1,"(10.445761,-75.516429)"
2015,Diciembre,Costa Rica,188,2,3,5,"(0.814836,-77.662532)"
2021,Mayo,China,156,0,1,1,"(11.360009,-72.129330)"
2017,Mayo,Estados Unidos de América,840,76,98,174,"(0.814836,-77.662532)"
2017,Junio,República de Armenia,51,0,1,1,"(10.445761,-75.516429)"
2017,Marzo,Nueva Zelanda,554,0,1,1,"(10.886611,-74.776708)"
2020,Agosto,Perú,604,0,5,5,"(-4.197703,-69.941278)"
2021,Noviembre,Jamaica,388,0,1,1,"(13.3387613,-81.372937)"
2017,Junio,Chile,152,116,93,209,"(10.408582,-75.538003)"
2018,Mayo,Bélgica,56,150,305,455,"(4.697144,-74.140516)"
2017,Julio,Australia,36,0,1,1,"(11.247723,-74.213989)"
2016,Abril,Estados Unidos de América,840,903,1231,2134,"(3.541112,-76.384584)"
2012,Febrero,Brasil,76,0,1,1,"(1.813928,-78.763924)"
2017,Julio,Italia,380,940,1724,2664,"(4.697144,-74.140516)"
2022,Enero,Lituania,440,1,3,4,"(10.445761,-75.516429)"
2018,Marzo,Ucrania,804,0,7,7,"(10.886611,-74.776708)"
2016,Junio,República Checa,203,1,0,1,"(10.408582,-75.538003)"
2018,Mayo,Panamá,591,0,2,2,"(1.813928,-78.763924)"
2016,Agosto,Perú,604,13,17,30,"(10.886611,-74.776708)"
2021,Febrero,Portugal,620,29,72,101,"(4.697144,-74.140516)"
2021,Febrero,Mozambique,508,2,1,3,"(4.697144,-74.140516)"
2022,Diciembre,Costa Rica,188,13,21,34,"(10.886611,-74.776708)"
2014,Junio,Paraguay,600,23,19,42,"(10.445761,-75.516429)"
2019,Marzo,República de Corea,410,1,4,5,"(10.886611,-74.776708)"
2018,Abril,Bolivia,68,5,7,12,"(10.886611,-74.776708)"
2013,Octubre,Bahréin,48,0,3,3,"(4.697144,-74.140516)"
2016,Diciembre,Nueva Zelanda,554,7,15,22,"(10.445761,-75.516429)"
2014,Diciembre,Países Bajos,528,20,50,70,"(10.408582,-75.538003)"
2019,Marzo,Brasil,76,1,3,4,"(12.5744111,-81.703935)"
2015,Noviembre,Paraguay,600,47,32,79,"(10.445761,-75.516429)"
2022,Mayo,Brasil,76,7,18,25,"(0.814836,-77.662532)"
2017,Marzo,Irán,364,0,6,6,"(6.171601,-75.427454)"
2019,Julio,Suecia,752,0,2,2,"(7.818934,-72.453226)"
2018,Febrero,República Dominicana,214,4,6,10,"(4.815061,-75.736532)"
2016,Junio,Estados Unidos de América,840,839,1332,2171,"(10.886611,-74.776708)"
2020,Noviembre,Argentina,32,1,11,12,"(-4.197703,-69.941278)"
2022,Septiembre,Ecuador,218,2,1,3,"(6.18189,-67.47535)"
2023,Mayo,Polonia,616,0,2,2,"(4.452882,-75.766298)"
2014,Mayo,Estados Unidos de América,840,2,8,10,"(13.3387613,-81.372937)"
2016,Septiembre,Trinidad y Tobago,780,1,0,1,"(12.586067,-81.702563)"
2015,Marzo,Taiwán,158,2,2,4,"(0.814836,-77.662532)"
2023,Febrero,Croacia,191,1,2,3,"(10.886611,-74.776708)"
2013,Diciembre,República de Moldavia,498,1,0,1,"(3.541112,-76.384584)"
2013,Junio,Pakistán,586,0,1,1,"(0.814836,-77.662532)"
2013,Marzo,Panamá,591,2,5,7,"(7.927209,-72.507910)"
2013,Octubre,Suiza,756,16,18,34,"(0.814836,-77.662532)"
2014,Marzo,México,484,9,21,30,"(7.818934,-72.453226)"
2019,Abril,España,724,42,50,92,"(0.814836,-77.662532)"
2017,Marzo,Honduras,340,0,1,1,"(10.971302,-74.765397)"
2017,Noviembre,Cuba,192,0,2,2,"(0.25129,-76.875963)"
2022,Enero,Finlandia,246,6,25,31,"(6.171601,-75.427454)"
2013,Diciembre,Honduras,340,1,1,2,"(11.360009,-72.129330)"
2016,Agosto,Honduras,340,68,75,143,"(6.171601,-75.427454)"
2014,Agosto,Lituania,440,8,11,19,"(4.697144,-74.140516)"
2015,Agosto,Líbano,422,0,2,2,"(6.171601,-75.427454)"
2013,Febrero,Senegal,686,0,1,1,"(4.697144,-74.140516)"
2016,Octubre,Bolivia,68,7,5,12,"(7.818934,-72.453226)"
2016,Julio,México,484,454,572,1026,"(10.445761,-75.516429)"
2016,Mayo,Turquía,792,1,1,2,"(3.541112,-76.384584)"
2013,Abril,Estados Unidos de América,840,17,43,60,"(7.818934,-72.453226)"
2020,Marzo,República Checa,203,4,8,12,"(6.171601,-75.427454)"
2017,Enero,Polonia,616,4,5,9,"(8.635765,-77.346578)"
2012,Diciembre,Eslovaquia,703,0,1,1,"(7.818934,-72.453226)"
2015,Junio,Alemania,276,10,15,25,"(8.635765,-77.346578)"
2018,Marzo,San Cristóbal y Nevis,659,2,3,5,"(4.697144,-74.140516)"
2022,Febrero,Suecia,752,19,36,55,"(6.171601,-75.427454)"
2012,Febrero,Mozambique,508,0,1,1,"(4.697144,-74.140516)"
2019,Noviembre,Mónaco,492,0,1,1,"(3.541112,-76.384584)"
2017,Julio,Grecia,300,1,1,2,"(3.541112,-76.384584)"
2014,Noviembre,Federación de Rusia,643,0,1,1,"(11.360009,-72.129330)"
2012,Mayo,República de Corea,410,142,372,514,"(4.697144,-74.140516)"
2018,Mayo,Países Bajos,528,1,1,2,"(-4.197703,-69.941278)"
2019,Diciembre,Argentina,32,6,9,15,"(0.25129,-76.875963)"
2023,Febrero,Egipto,818,0,4,4,"(10.408582,-75.538003)"
2018,Septiembre,Ecuador,218,1,1,2,"(7.128456,-73.183637)"
2015,Febrero,Venezuela,862,368,371,739,"(7.927209,-72.507910)"
2021,Marzo,Turquía,792,0,9,9,"(6.171601,-75.427454)"
2013,Noviembre,Perú,604,2224,3250,5474,"(4.697144,-74.140516)"
2023,Mayo,República de Corea,410,14,20,34,"(6.171601,-75.427454)"
2015,Abril,Chile,152,2,0,2,"(0.25129,-76.875963)"
2015,Octubre,Guatemala,320,38,54,92,"(12.586067,-81.702563)"
2014,Abril,Guatemala,320,0,1,1,"(3.893038,-77.067921)"
2017,Agosto,Arabia Saudita,682,0,1,1,"(6.171601,-75.427454)"
2021,Abril,India,356,17,63,81,"(4.697144,-74.140516)"
2017,Junio,Ecuador,218,2584,3476,6060,"(4.697144,-74.140516)"
2018,Marzo,Camboya,116,2,0,2,"(4.697144,-74.140516)"
2014,Julio,Brasil,76,0,1,1,"(7.102626,-77.762647)"
2012,Marzo,El Salvador,222,373,518,891,"(4.697144,-74.140516)"
2022,Febrero,Federación de Rusia,643,3,4,7,"(0.814836,-77.662532)"
2023,Abril,Bulgaria,100,0,3,3,"(10.886611,-74.776708)"
2018,Agosto,Cuba,192,2,1,3,"(12.586067,-81.702563)"
2015,Febrero,Taiwán,158,8,4,12,"(6.171601,-75.427454)"
2012,Septiembre,Islandia,352,2,5,7,"(4.697144,-74.140516)"
2014,Marzo,Singapur,702,3,25,28,"(4.697144,-74.140516)"
2019,Enero,Venezuela,862,32,48,80,"(10.408582,-75.538003)"
2016,Noviembre,Israel,376,68,398,466,"(4.697144,-74.140516)"
2022,Agosto,Singapur,702,0,1,1,"(3.541112,-76.384584)"
2017,Abril,Venezuela,862,3,7,10,"(7.927209,-72.507910)"
2018,Marzo,Guatemala,320,0,3,3,"(10.408582,-75.538003)"
2012,Febrero,Japón,392,24,11,35,"(10.408582,-75.538003)"
2014,Septiembre,Kenia,404,0,1,1,"(7.128456,-73.183637)"
2012,Enero,Reino Unido de Gran Bretaña e Irlanda del Norte,826,0,1,1,"(3.541112,-76.384584)"
2013,Febrero,Reino Unido de Gran Bretaña e Irlanda del Norte,826,4,2,6,"(11.247723,-74.213989)"
2017,Agosto,Bangladesh,50,1,2,3,"(4.697144,-74.140516)"
2014,Febrero,Paraguay,600,8,10,18,"(6.171601,-75.427454)"
2016,Noviembre,Venezuela,862,2,6,8,"(0.25129,-76.875963)"
2015,Julio,China,156,1,5,6,"(7.818934,-72.453226)"
2014,Mayo,Panamá,591,0,1,1,"(12.5744111,-81.703935)"
2018,Noviembre,Eslovaquia,703,3,3,6,"(3.541112,-76.384584)"
2022,Enero,Grecia,300,0,5,5,"(3.541112,-76.384584)"
2022,Julio,Egipto,818,0,1,1,"(3.541112,-76.384584)"
2019,Marzo,Polonia,616,4,3,7,"(3.541112,-76.384584)"
2013,Enero,Turquía,792,0,1,1,"(10.408582,-75.538003)"
2018,Octubre,Federación de Rusia,643,1,4,5,"(10.886611,-74.776708)"
2013,Septiembre,El Salvador,222,16,20,36,"(10.445761,-75.516429)"
2017,Diciembre,Chile,152,35,84,119,"(6.171601,-75.427454)"
2017,Febrero,Estados Unidos de América,840,3,7,10,"(11.247723,-74.213989)"
2022,Diciembre,Canadá,124,0,2,2,"(8.635765,-77.346578)"
2012,Octubre,Francia,250,2,3,5,"(13.3387613,-81.372937)"
2019,Mayo,Honduras,340,1,5,6,"(0.814836,-77.662532)"
2020,Marzo,Países Bajos,528,0,1,1,"(12.586067,-81.702563)"
2013,Febrero,Islas Caimán/Territorio Británico de Ultramar,136,0,1,1,"(6.171601,-75.427454)"
2019,Diciembre,Estados Unidos de América,840,4736,9463,14199,"(6.171601,-75.427454)"
2019,Septiembre,Turquía,792,2,1,3,"(3.541112,-76.384584)"
2019,Noviembre,Estados Unidos de América,840,3,5,8,"(10.971302,-74.765397)"
2022,Marzo,Brasil,76,447,378,825,"(10.445761,-75.516429)"
2012,Diciembre,Panamá,591,0,5,5,"(12.5744111,-81.703935)"
2012,Junio,México,484,13,34,47,"(10.886611,-74.776708)"
2012,Junio,Ecuador,218,1,3,4,"(-4.197703,-69.941278)"
2013,Abril,Ucrania,804,1,0,1,"(3.541112,-76.384584)"
2023,Enero,República de Irlanda,372,154,265,419,"(4.697144,-74.140516)"
2021,Febrero,Ecuador,218,28,36,64,"(10.445761,-75.516429)"
2018,Junio,Austria,40,0,1,1,"(12.586067,-81.702563)"
2017,Octubre,Guatemala,320,0,1,1,"(1.813928,-78.763924)"
2021,Septiembre,Uruguay,858,70,133,203,"(4.697144,-74.140516)"
2022,Enero,Líbano,422,1,0,1,"(10.886611,-74.776708)"
2016,Octubre,Japón,392,12,34,46,"(6.171601,-75.427454)"
2018,Marzo,Chipre,196,1,0,1,"(10.445761,-75.516429)"
2017,Septiembre,España,724,1,4,5,"(12.586067,-81.702563)"
2018,Enero,Argentina,32,425,320,745,"(12.586067,-81.702563)"
2015,Octubre,Chile,152,1,4,5,"(7.128456,-73.183637)"
2012,Mayo,Argelia,12,1,4,5,"(4.697144,-74.140516)"
2016,Mayo,República de Belarús,112,0,1,1,"(10.445761,-75.516429)"
2016,Junio,Bahamas,44,0,2,2,"(10.445761,-75.516429)"
2014,Diciembre,Noruega,578,0,3,3,"(12.5744111,-81.703935)"
2017,Agosto,Haití,332,0,1,1,"(10.886611,-74.776708)"
2022,Octubre,Santa Lucia,662,1,5,6,"(10.445761,-75.516429)"
2015,Noviembre,Hungría,348,1,1,2,"(6.171601,-75.427454)"
2022,Noviembre,Filipinas,608,46,91,137,"(4.697144,-74.140516)"
2012,Junio,Sudáfrica,710,0,5,5,"(10.971302,-74.765397)"
2014,Septiembre,Letonia,428,0,1,1,"(3.893038,-77.067921)"
2015,Marzo,Hungría,348,1,2,3,"(6.171601,-75.427454)"
2013,Enero,Israel,376,0,1,1,"(7.818934,-72.453226)"
2019,Noviembre,Chile,152,1,7,8,"(11.360009,-72.129330)"
2016,Octubre,Bolivia,68,2,0,2,"(0.812436,-77.847006)"
2017,Diciembre,Desconocido,99999,0,1,1,"(7.818934,-72.453226)"
2022,Febrero,Estados Unidos de América,840,0,3,3,"(3.893038,-77.067921)"
2014,Noviembre,Reino Unido de Gran Bretaña e Irlanda del Norte,826,22,27,49,"(10.408582,-75.538003)"
2017,Diciembre,Francia,250,5,18,23,"(-4.223468,-69.945098)"
2013,Enero,Indonesia,360,1,1,2,"(6.171601,-75.427454)"
2019,Septiembre,Polonia,616,16,26,42,"(10.445761,-75.516429)"
2018,Mayo,Myanmar,104,3,11,14,"(4.697144,-74.140516)"
2018,Septiembre,Suecia,752,0,1,1,"(12.586067,-81.702563)"
2018,Abril,Honduras,340,0,2,2,"(11.360009,-72.129330)"
2016,Mayo,Países Bajos,528,35,34,69,"(0.814836,-77.662532)"
2017,Noviembre,Panamá,591,295,263,558,"(3.541112,-76.384584)"
2012,Septiembre,Japón,392,0,1,1,"(4.452882,-75.766298)"
2014,Octubre,Guatemala,320,1,3,4,"(7.818934,-72.453226)"
2018,Agosto,República Checa,203,0,1,1,"(11.360009,-72.129330)"
2022,Junio,Santa Lucia,662,11,2,13,"(4.697144,-74.140516)"
2016,Agosto,Chile,152,33,89,122,"(6.171601,-75.427454)"
2022,Abril,México,484,4,7,11,"(4.452882,-75.766298)"
2019,Mayo,Australia,36,0,6,6,"(-4.223468,-69.945098)"
2018,Noviembre,Japón,392,11,25,36,"(10.445761,-75.516429)"
2016,Mayo,Argentina,32,9,16,25,"(-4.197703,-69.941278)"
2017,Septiembre,Brasil,76,3,6,9,"(4.815061,-75.736532)"
2020,Diciembre,Emiratos Árabes,784,0,1,1,"(10.886611,-74.776708)"
2019,Diciembre,Ecuador,218,0,5,5,"(3.866713,-67.927521)"
2014,Septiembre,Brasil,76,0,1,1,"(7.128456,-73.183637)"
2012,Abril,Nueva Zelanda,554,13,8,21,"(0.814836,-77.662532)"
2013,Agosto,Panamá,591,0,1,1,"(12.5744111,-81.703935)"
2018,Octubre,México,484,72,117,189,"(10.886611,-74.776708)"
2014,Enero,República Dominicana,214,26,58,84,"(6.171601,-75.427454)"
2022,Noviembre,Montenegro,499,0,2,2,"(3.893038,-77.067921)"
2023,Enero,Serbia,688,1,0,1,"(10.886611,-74.776708)"
2019,Julio,Emiratos Árabes,784,0,8,8,"(6.171601,-75.427454)"
2022,Abril,Alemania,276,19,27,46,"(10.886611,-74.776708)"
2015,Septiembre,Noruega,578,49,121,170,"(4.697144,-74.140516)"
2022,Febrero,Venezuela,862,225,218,443,"(7.088729,-70.740253)"
2014,Abril,Argentina,32,65,105,170,"(3.541112,-76.384584)"
2019,Marzo,Turquía,792,1,1,2,"(0.25129,-76.875963)"
2012,Noviembre,Argentina,32,7,6,13,"(8.635765,-77.346578)"
2015,Septiembre,Bolivia,68,2,0,2,"(0.812436,-77.847006)"
2013,Junio,Isla Johnston,99999,0,1,1,"(3.541112,-76.384584)"
2018,Noviembre,Indonesia,360,0,1,1,"(3.893038,-77.067921)"
2013,Marzo,Bulgaria,100,1,2,3,"(11.360009,-72.129330)"
2017,Octubre,Uruguay,858,1,0,1,"(8.36068,-72.409396)"
2017,Enero,Venezuela,862,2,6,8,"(0.25129,-76.875963)"
2020,Enero,Líbano,422,1,2,3,"(6.171601,-75.427454)"
2012,Octubre,Israel,376,4,21,25,"(10.445761,-75.516429)"
2020,Febrero,Francia,250,0,1,1,"(7.916725,-72.462544)"
2017,Noviembre,Estonia,233,2,0,2,"(10.445761,-75.516429)"
2014,Noviembre,Federación de Rusia,643,135,263,398,"(4.697144,-74.140516)"
2022,Agosto,Hungría,348,55,58,113,"(4.697144,-74.140516)"
2015,Junio,Zambia,894,1,0,1,"(3.541112,-76.384584)"
2018,Septiembre,Polonia,616,1,3,4,"(10.408582,-75.538003)"
2015,Mayo,Canadá,124,1,4,5,"(7.927209,-72.507910)"
2014,Junio,Chile,152,0,2,2,"(7.927209,-72.507910)"
2015,Enero,México,484,0,1,1,"(4.452882,-75.766298)"
2022,Diciembre,República Dominicana,214,153,315,468,"(10.886611,-74.776708)"
2014,Marzo,Costa Rica,188,98,193,291,"(6.171601,-75.427454)"
2014,Junio,Alemania,276,2,2,4,"(7.818934,-72.453226)"
2014,Septiembre,Suiza,756,4,2,6,"(-4.197703,-69.941278)"
2013,Septiembre,India,356,0,7,7,"(10.886611,-74.776708)"
2022,Junio,Suecia,752,0,1,1,"(0.814836,-77.662532)"
2021,Julio,República Dominicana,214,15,32,47,"(10.886611,-74.776708)"
2022,Junio,Venezuela,862,193,221,414,"(10.886611,-74.776708)"
2018,Enero,Ecuador,218,0,1,1,"(10.971302,-74.765397)"
2022,Enero,China,156,2,2,4,"(10.886611,-74.776708)"
2016,Septiembre,Italia,380,3,6,9,"(8.635765,-77.346578)"
2023,Febrero,Sudáfrica,710,3,5,8,"(12.5744111,-81.703935)"
2017,Abril,República Árabe Siria,760,0,3,3,"(10.445761,-75.516429)"
2022,Octubre,Serbia,688,12,59,71,"(4.697144,-74.140516)"
2013,Marzo,Honduras,340,0,1,1,"(10.971302,-74.765397)"
2014,Julio,Chile,152,0,2,2,"(-4.197703,-69.941278)"
2017,Diciembre,Venezuela,862,3255,4479,7734,"(0.814836,-77.662532)"
2013,Octubre,Estados Unidos de América,840,9,8,17,"(11.360009,-72.129330)"
2023,Febrero,Costa Rica,188,0,1,1,"(-4.197703,-69.941278)"
2015,Julio,Haití,332,0,4,4,"(10.445761,-75.516429)"
2014,Septiembre,Rumania,642,41,69,110,"(4.697144,-74.140516)"
2014,Junio,El Salvador,222,1,1,2,"(4.815061,-75.736532)"
2018,Enero,Federación de Rusia,643,1,0,1,"(4.452882,-75.766298)"
2013,Marzo,Letonia,428,0,1,1,"(10.408582,-75.538003)"
2012,Septiembre,República Dominicana,214,1,0,1,"(11.360009,-72.129330)"
2023,Marzo,México,484,3,3,6,"(0.25129,-76.875963)"
2013,Enero,Mongolia,496,2,0,2,"(4.697144,-74.140516)"
2014,Mayo,Países Bajos,528,217,321,538,"(6.171601,-75.427454)"
2020,Diciembre,Haití,332,2,1,3,"(3.541112,-76.384584)"
2022,Julio,San  Vicente y las Granadinas,670,0,2,2,"(10.445761,-75.516429)"
2019,Junio,México,484,1,2,3,"(0.25129,-76.875963)"
2015,Noviembre,Australia,36,34,43,77,"(0.814836,-77.662532)"
2015,Junio,Austria,40,1,0,1,"(10.408582,-75.538003)"
2016,Septiembre,España,724,13,38,51,"(7.818934,-72.453226)"
2015,Febrero,República de Irlanda,372,2,10,12,"(3.541112,-76.384584)"
2022,Octubre,Bosnia y Herzegovina,70,5,10,15,"(4.697144,-74.140516)"
2015,Septiembre,Trinidad y Tobago,780,11,30,41,"(4.697144,-74.140516)"
2016,Agosto,Camerún,120,0,1,1,"(0.814836,-77.662532)"
2021,Diciembre,Ecuador,218,0,3,3,"(7.088729,-70.740253)"
2016,Junio,Panamá,591,0,1,1,"(11.247723,-74.213989)"
2016,Abril,Nicaragua,558,20,29,49,"(10.445761,-75.516429)"
2015,Noviembre,Ghana,288,0,1,1,"(6.171601,-75.427454)"
2013,Agosto,Venezuela,862,6,5,11,"(12.586067,-81.702563)"
2016,Abril,Chipre,196,0,1,1,"(10.445761,-75.516429)"
2019,Julio,Sudáfrica,710,1,2,3,"(10.445761,-75.516429)"
2020,Enero,Guyana,328,9,12,21,"(4.697144,-74.140516)"
2014,Marzo,Austria,40,2,2,4,"(10.886611,-74.776708)"
2016,Septiembre,Estados Unidos de América,840,5896,11468,17364,"(4.697144,-74.140516)"
2019,Febrero,Panamá,591,876,789,1665,"(10.445761,-75.516429)"
2013,Junio,Uruguay,858,3,3,6,"(10.886611,-74.776708)"
2023,Marzo,Pakistán,586,0,1,1,"(10.886611,-74.776708)"
2022,Julio,Jamaica,388,0,2,2,"(12.5744111,-81.703935)"
2019,Octubre,Hungría,348,0,1,1,"(0.25129,-76.875963)"
2019,Febrero,República Árabe Siria,760,0,3,3,"(4.697144,-74.140516)"
2013,Abril,Federación de Rusia,643,0,1,1,"(11.247723,-74.213989)"
2017,Diciembre,Estados Unidos de América,840,14,9,23,"(-4.223468,-69.945098)"
2022,Abril,Uruguay,858,45,55,100,"(6.171601,-75.427454)"
2018,Julio,Taiwán,158,1,0,1,"(7.128456,-73.183637)"
2016,Diciembre,Chile,152,8,26,34,"(7.818934,-72.453226)"
2018,Julio,Guatemala,320,0,1,1,"(0.812436,-77.847006)"
2013,Febrero,Cuba,192,0,1,1,"(7.128456,-73.183637)"
2023,Mayo,Argentina,32,33,86,119,"(0.814836,-77.662532)"
2013,Septiembre,Sri Lanka,144,1,1,2,"(4.697144,-74.140516)"
2022,Febrero,El Salvador,222,1,2,3,"(0.814836,-77.662532)"
2019,Marzo,Turquía,792,1,2,3,"(0.814836,-77.662532)"
2012,Octubre,México,484,4,17,21,"(4.815061,-75.736532)"
2016,Noviembre,Alemania,276,1483,2464,3947,"(4.697144,-74.140516)"
2023,Marzo,Canadá,124,0,2,2,"(-4.223468,-69.945098)"
2016,Julio,Finlandia,246,6,2,8,"(0.814836,-77.662532)"
2015,Agosto,Paraguay,600,1,0,1,"(4.815061,-75.736532)"
2019,Diciembre,Haití,332,15,30,45,"(4.697144,-74.140516)"
2015,Abril,China,156,1,0,1,"(12.586067,-81.702563)"
2019,Abril,Noruega,578,2,0,2,"(-4.197703,-69.941278)"
2015,Febrero,Croacia,191,10,34,44,"(4.697144,-74.140516)"
2019,Julio,Trinidad y Tobago,780,0,1,1,"(11.360009,-72.129330)"
2022,Mayo,Panamá,591,1504,1630,3134,"(4.697144,-74.140516)"
2017,Abril,México,484,0,2,2,"(7.088729,-70.740253)"
2022,Marzo,Kuwait,414,2,2,4,"(6.171601,-75.427454)"
2020,Diciembre,Reino Unido de Gran Bretaña e Irlanda del Norte,826,2,16,18,"(10.886611,-74.776708)"
2018,Septiembre,India,356,0,20,20,"(10.408582,-75.538003)"
2017,Marzo,Luxemburgo,442,0,2,2,"(11.247723,-74.213989)"
2021,Mayo,Reino Unido de Gran Bretaña e Irlanda del Norte,826,6,15,21,"(10.445761,-75.516429)"
2019,Octubre,Filipinas,608,0,9,9,"(10.886611,-74.776708)"
2016,Junio,Chile,152,2,7,9,"(-4.197703,-69.941278)"
2014,Febrero,Eslovaquia,703,0,1,1,"(7.818934,-72.453226)"
2020,Diciembre,China,156,1,2,3,"(10.445761,-75.516429)"
2017,Enero,El Salvador,222,3,4,7,"(10.886611,-74.776708)"
2018,Agosto,Estados Unidos de América,840,1,7,8,"(11.360009,-72.129330)"
2012,Febrero,Líbano,422,5,4,9,"(11.360009,-72.129330)"
2022,Diciembre,Letonia,428,0,1,1,"(10.408582,-75.538003)"
2013,Mayo,Costa Rica,188,1,0,1,"(6.185799,-67.483929)"
2015,Diciembre,Georgia,268,0,2,2,"(4.815061,-75.736532)"
2016,Enero,Guatemala,320,1,0,1,"(11.360009,-72.129330)"
2014,Diciembre,Bélgica,56,12,32,44,"(6.171601,-75.427454)"
2012,Octubre,Malta,470,1,0,1,"(7.818934,-72.453226)"
2017,Enero,Rumania,642,5,9,14,"(10.445761,-75.516429)"
2021,Junio,República de Corea,410,0,2,2,"(10.886611,-74.776708)"
2018,Agosto,Francia,250,1,1,2,"(11.247723,-74.213989)"
2022,Enero,Panamá,591,29,27,56,"(4.452882,-75.766298)"
2023,Marzo,República de Irlanda,372,15,58,73,"(6.171601,-75.427454)"
2014,Octubre,Honduras,340,1,35,36,"(10.886611,-74.776708)"
2013,Agosto,Letonia,428,5,3,8,"(4.697144,-74.140516)"
2018,Febrero,Países Bajos,528,1,6,7,"(7.818934,-72.453226)"
2017,Enero,Sudáfrica,710,2,3,5,"(10.886611,-74.776708)"
2019,Septiembre,Uruguay,858,2,0,2,"(11.360009,-72.129330)"
2019,Octubre,Croacia,191,1,1,2,"(11.247723,-74.213989)"
2022,Mayo,Argentina,32,2,2,4,"(12.5744111,-81.703935)"
2013,Julio,Luxemburgo,442,1,0,1,"(0.814836,-77.662532)"
2019,Enero,Panamá,591,48,75,123,"(4.815061,-75.736532)"
2019,Enero,Filipinas,608,64,75,139,"(4.697144,-74.140516)"
2016,Enero,Sudáfrica,710,0,1,1,"(8.635765,-77.346578)"
2016,Diciembre,Israel,376,3,16,19,"(0.814836,-77.662532)"
2023,Junio,El Salvador,222,1,3,4,"(11.117806,-74.232622)"
2021,Diciembre,Ucrania,804,1,8,9,"(10.886611,-74.776708)"
2019,Julio,Nicaragua,558,1,1,2,"(7.128456,-73.183637)"
2020,Enero,Perú,604,8,18,26,"(0.25129,-76.875963)"
2016,Junio,Austria,40,8,14,22,"(6.171601,-75.427454)"
2014,Febrero,El Salvador,222,0,1,1,"(7.818934,-72.453226)"
2021,Noviembre,Argelia,12,1,0,1,"(10.445761,-75.516429)"
2017,Noviembre,Estados Unidos de América,840,26,76,102,"(7.128456,-73.183637)"
2021,Septiembre,Afganistán,4,0,1,1,"(4.697144,-74.140516)"
2018,Septiembre,Indonesia,360,0,1,1,"(6.171601,-75.427454)"
2012,Julio,Mozambique,508,1,0,1,"(4.697144,-74.140516)"
2012,Diciembre,Canadá,124,474,550,1024,"(10.445761,-75.516429)"
2021,Mayo,Francia,250,0,1,1,"(12.586067,-81.702563)"
2019,Marzo,Rumania,642,0,1,1,"(11.360009,-72.129330)"
2016,Septiembre,República Dominicana,214,1,3,4,"(11.360009,-72.129330)"
2019,Febrero,Uzbekistán,860,0,1,1,"(4.697144,-74.140516)"
2019,Febrero,Rwanda,646,0,2,2,"(4.697144,-74.140516)"
2021,Julio,China,156,0,20,20,"(10.408582,-75.538003)"
2020,Agosto,Israel,376,0,1,1,"(10.886611,-74.776708)"
2015,Agosto,Italia,380,58,162,220,"(3.541112,-76.384584)"
2019,Julio,Panamá,591,1,0,1,"(7.927209,-72.507910)"
2014,Agosto,Indonesia,360,0,1,1,"(10.408582,-75.538003)"
2015,Agosto,Bélgica,56,7,23,30,"(6.171601,-75.427454)"
2017,Diciembre,Refugiado,99999,0,3,3,"(10.445761,-75.516429)"
2019,Junio,Turquía,792,0,1,1,"(8.635765,-77.346578)"
2019,Diciembre,Malta,470,0,3,3,"(6.171601,-75.427454)"
2021,Noviembre,Grecia,300,14,49,63,"(4.697144,-74.140516)"
2013,Noviembre,Dinamarca,208,2,1,3,"(10.408582,-75.538003)"
2017,Febrero,Suiza,756,27,55,82,"(3.541112,-76.384584)"
2018,Junio,Panamá,591,205,178,383,"(3.541112,-76.384584)"
2015,Agosto,Nepal,524,0,4,4,"(4.697144,-74.140516)"
2022,Febrero,Paraguay,600,2,0,2,"(7.128456,-73.183637)"
2015,Marzo,India,356,15,44,59,"(10.445761,-75.516429)"
2018,Julio,Polonia,616,0,1,1,"(4.815061,-75.736532)"
2022,Enero,Georgia,268,2,9,11,"(4.697144,-74.140516)"
2012,Junio,Estados Unidos de América,840,35,49,84,"(12.586067,-81.702563)"
2012,Junio,Ecuador,218,308,434,742,"(6.171601,-75.427454)"
2023,Marzo,Eslovenia,705,1,10,11,"(10.445761,-75.516429)"
2013,Septiembre,Filipinas,608,1,0,1,"(7.128456,-73.183637)"
2018,Marzo,Italia,380,0,1,1,"(4.452882,-75.766298)"
2016,Enero,Alemania,276,88,134,222,"(3.541112,-76.384584)"
2018,Septiembre,Federación de Rusia,643,11,11,22,"(6.171601,-75.427454)"
2022,Septiembre,Cuba,192,0,2,2,"(4.452882,-75.766298)"
2021,Octubre,Panamá,591,147,146,293,"(10.886611,-74.776708)"
2022,Mayo,China,156,0,3,3,"(0.814836,-77.662532)"
2018,Septiembre,Reino Unido de Gran Bretaña e Irlanda del Norte,826,1,1,2,"(0.25129,-76.875963)"
2021,Noviembre,Cabo Verde,132,0,3,3,"(10.445761,-75.516429)"
2023,Marzo,Chad,148,1,1,2,"(4.697144,-74.140516)"
2012,Agosto,Venezuela,862,45,68,113,"(10.886611,-74.776708)"
2023,Febrero,China,156,1,1,2,"(8.36068,-72.409396)"
2017,Diciembre,Países Bajos,528,2,6,8,"(11.360009,-72.129330)"
2021,Enero,Estados Unidos de América,840,2,4,6,"(7.818934,-72.453226)"
2021,Noviembre,Reino Unido de Gran Bretaña e Irlanda del Norte,826,21,45,66,"(10.445761,-75.516429)"
2022,Enero,Vietnam,704,1,1,2,"(10.886611,-74.776708)"
2018,Noviembre,Afganistán,4,0,1,1,"(4.697144,-74.140516)"
2016,Febrero,Noruega,578,0,1,1,"(-4.197703,-69.941278)"
2018,Abril,México,484,0,4,4,"(-4.223468,-69.945098)"
2023,Junio,México,484,1,1,2,"(7.088729,-70.740253)"
2019,Diciembre,Suiza,756,3,8,11,"(12.586067,-81.702563)"
2023,Abril,Camerún,120,1,2,3,"(10.445761,-75.516429)"
2015,Diciembre,Países Bajos,528,1,0,1,"(13.3387613,-81.372937)"
2016,Marzo,Argentina,32,136,219,355,"(0.814836,-77.662532)"
2022,Mayo,Estados Unidos de América,840,2,2,4,"(7.088729,-70.740253)"
2014,Septiembre,Uruguay,858,3,6,9,"(10.408582,-75.538003)"
2015,Junio,Sudáfrica,710,0,1,1,"(0.25129,-76.875963)"
2012,Mayo,Estados Unidos de América,840,909,2338,3247,"(6.171601,-75.427454)"
2018,Diciembre,Reino Unido de Gran Bretaña e Irlanda del Norte,826,1470,2622,4092,"(4.697144,-74.140516)"
2014,Mayo,Chile,152,6,7,13,"(11.360009,-72.129330)"
2014,Marzo,Suecia,752,133,237,370,"(4.697144,-74.140516)"
2022,Septiembre,Uganda,800,1,1,2,"(4.697144,-74.140516)"
2023,Junio,Chile,152,6,16,22,"(7.916725,-72.462544)"
2017,Mayo,Brasil,76,34,82,116,"(3.541112,-76.384584)"
2018,Marzo,Francia,250,12,15,27,"(-4.223468,-69.945098)"
2023,Abril,República Checa,203,1,0,1,"(4.815061,-75.736532)"
2015,Septiembre,Hungría,348,3,5,8,"(6.171601,-75.427454)"
2017,Marzo,Burundi,108,0,1,1,"(4.697144,-74.140516)"
2019,Noviembre,Alemania,276,2,5,7,"(7.818934,-72.453226)"
2014,Septiembre,Guatemala,320,1,5,6,"(11.360009,-72.129330)"
2017,Octubre,Finlandia,246,0,1,1,"(8.635765,-77.346578)"
2013,Febrero,Japón,392,1,21,22,"(3.541112,-76.384584)"
2016,Mayo,Brasil,76,0,3,3,"(7.128456,-73.183637)"
2017,Junio,Brasil,76,2,11,13,"(7.818934,-72.453226)"
2021,Noviembre,Panamá,591,1804,1848,3652,"(4.697144,-74.140516)"
2015,Abril,Suiza,756,18,27,45,"(3.541112,-76.384584)"
2014,Noviembre,Italia,380,35,68,103,"(3.541112,-76.384584)"
2022,Marzo,España,724,31,47,78,"(10.886611,-74.776708)"
2020,Febrero,Guatemala,320,1,21,22,"(10.886611,-74.776708)"
2018,Noviembre,Suiza,756,1,0,1,"(13.3387613,-81.372937)"
2016,Julio,Panamá,591,0,1,1,"(10.971302,-74.765397)"
2019,Julio,España,724,9,3,12,"(12.586067,-81.702563)"
2012,Febrero,República Checa,203,26,48,74,"(4.697144,-74.140516)"
2013,Julio,Puerto Rico/Territorio de Estados Unidos,630,1,1,2,"(3.541112,-76.384584)"
2014,Junio,México,484,37,38,75,"(7.818934,-72.453226)"
2017,Julio,Costa Rica,188,0,2,2,"(4.452882,-75.766298)"
2022,Abril,Canadá,124,1,2,3,"(11.360009,-72.129330)"
2018,Mayo,Ecuador,218,11,10,21,"(10.408582,-75.538003)"
2017,Mayo,Alemania,276,3,4,7,"(7.818934,-72.453226)"
2014,Enero,Australia,36,1,8,9,"(11.360009,-72.129330)"
2018,Febrero,Australia,36,1,4,5,"(-4.197703,-69.941278)"
2012,Marzo,Perú,604,0,1,1,"(4.452882,-75.766298)"
2023,Febrero,Arabia Saudita,682,1,0,1,"(10.886611,-74.776708)"
2019,Agosto,Indonesia,360,1,5,6,"(0.814836,-77.662532)"
2017,Abril,Países Bajos,528,54,74,128,"(3.541112,-76.384584)"
2013,Noviembre,Reino Unido de Gran Bretaña e Irlanda del Norte,826,16,44,60,"(3.541112,-76.384584)"
2017,Abril,Austria,40,4,12,16,"(0.814836,-77.662532)"
2017,Septiembre,Guatemala,320,0,1,1,"(7.818934,-72.453226)"
2018,Diciembre,Sudáfrica,710,3,1,4,"(10.445761,-75.516429)"
2017,Abril,Canadá,124,1,4,5,"(7.128456,-73.183637)"
2020,Diciembre,Venezuela,862,0,2,2,"(7.088729,-70.740253)"
2012,Diciembre,Estados Unidos de América,840,31,66,97,"(12.586067,-81.702563)"
2012,Diciembre,Ecuador,218,1185,1973,3158,"(0.814836,-77.662532)"
2015,Febrero,Trinidad y Tobago,780,5,23,28,"(10.445761,-75.516429)"
2018,Marzo,Alemania,276,193,287,480,"(6.171601,-75.427454)"
2012,Julio,Etiopia,231,3,3,6,"(4.697144,-74.140516)"
2014,Noviembre,Honduras,340,8,21,29,"(10.445761,-75.516429)"
2020,Febrero,Francia,250,2,9,11,"(7.818934,-72.453226)"
2015,Mayo,Bermudas/Territorio Británico de Ultramar,60,1,5,6,"(10.445761,-75.516429)"
2022,Febrero,Estados Unidos de América,840,134,201,335,"(4.452882,-75.766298)"
2022,Noviembre,Burkina Faso,854,3,5,8,"(4.697144,-74.140516)"
2017,Enero,Canadá,124,15,21,36,"(10.408582,-75.538003)"
2022,Abril,Estonia,233,10,12,22,"(4.697144,-74.140516)"
2014,Junio,Turquía,792,0,2,2,"(7.818934,-72.453226)"
2021,Diciembre,España,724,0,1,1,"(8.635765,-77.346578)"
2022,Diciembre,Nicaragua,558,0,1,1,"(10.408582,-75.538003)"
2019,Mayo,Paraguay,600,3,9,12,"(-4.197703,-69.941278)"
2022,Abril,Nicaragua,558,0,1,1,"(1.813928,-78.763924)"
2012,Mayo,Nueva Zelanda,554,1,1,2,"(10.408582,-75.538003)"
2019,Octubre,Portugal,620,0,1,1,"(0.25129,-76.875963)"
2019,Agosto,República Democrática del Congo,180,3,7,10,"(4.697144,-74.140516)"
2017,Junio,Reino Unido de Gran Bretaña e Irlanda del Norte,826,2,5,7,"(11.247723,-74.213989)"
2014,Diciembre,Brasil,76,603,461,1064,"(12.586067,-81.702563)"
2022,Junio,China,156,11,11,22,"(10.445761,-75.516429)"
2013,Noviembre,Finlandia,246,4,2,6,"(0.814836,-77.662532)"
2019,Febrero,Francia,250,113,197,310,"(3.541112,-76.384584)"
2013,Abril,Costa Rica,188,2,5,7,"(4.815061,-75.736532)"
2022,Febrero,Egipto,818,10,23,33,"(4.697144,-74.140516)"
2018,Octubre,Alemania,276,32,38,70,"(10.408582,-75.538003)"
2015,Diciembre,Israel,376,1,8,9,"(0.814836,-77.662532)"
2017,Octubre,Bahréin,48,1,1,2,"(4.697144,-74.140516)"
2021,Julio,República Democrática del Congo,180,0,1,1,"(7.818934,-72.453226)"
2022,Octubre,Hong Kong,344,1,3,4,"(6.171601,-75.427454)"
2021,Enero,Federación de Rusia,643,0,3,3,"(10.971302,-74.765397)"
2021,Diciembre,Zimbabue,716,1,0,1,"(10.408582,-75.538003)"
2017,Noviembre,Estados Unidos de América,840,0,1,1,"(3.893038,-77.067921)"
2012,Abril,Curazao,99999,0,1,1,"(11.360009,-72.129330)"
2017,Diciembre,República de Corea,410,10,6,16,"(0.814836,-77.662532)"
2021,Agosto,Perú,604,1984,2458,4442,"(4.697144,-74.140516)"
2016,Febrero,Irán,364,0,2,2,"(6.171601,-75.427454)"
2013,Junio,Burkina Faso,854,1,1,2,"(4.697144,-74.140516)"
2014,Diciembre,Polonia,616,0,3,3,"(10.886611,-74.776708)"
2014,Enero,Zimbabue,716,1,0,1,"(0.814836,-77.662532)"
2014,Enero,Bélgica,56,0,1,1,"(4.815061,-75.736532)"
2016,Marzo,Canadá,124,431,360,791,"(12.586067,-81.702563)"
2012,Junio,Uganda,800,1,3,4,"(4.697144,-74.140516)"
2022,Noviembre,México,484,1,3,4,"(0.25129,-76.875963)"
2022,Noviembre,Venezuela,862,7208,6752,13961,"(4.697144,-74.140516)"
2013,Diciembre,Ucrania,804,0,1,1,"(10.971302,-74.765397)"
2021,Septiembre,España,724,16,18,34,"(11.360009,-72.129330)"
2022,Mayo,Japón,392,0,2,2,"(4.815061,-75.736532)"
2015,Noviembre,Guatemala,320,549,989,1538,"(4.697144,-74.140516)"
2012,Octubre,Tanzania,834,0,3,3,"(6.171601,-75.427454)"
2022,Marzo,Turquía,792,0,1,1,"(7.916725,-72.462544)"
2016,Enero,Bélgica,56,16,12,28,"(0.814836,-77.662532)"
2012,Julio,Reino Unido de Gran Bretaña e Irlanda del Norte,826,12,22,34,"(10.445761,-75.516429)"
2022,Julio,Eslovaquia,703,2,5,7,"(6.171601,-75.427454)"
2023,Enero,Japón,392,0,8,8,"(0.814836,-77.662532)"
2016,Noviembre,Perú,604,176,108,284,"(12.586067,-81.702563)"
2016,Septiembre,Mozambique,508,3,20,23,"(4.697144,-74.140516)"
2022,Enero,Santa Lucia,662,1,1,2,"(10.886611,-74.776708)"
2018,Diciembre,Bélgica,56,0,1,1,"(11.360009,-72.129330)"
2023,Marzo,Islas Caimán/Territorio Británico de Ultramar,136,0,2,2,"(6.171601,-75.427454)"
2019,Diciembre,Ucrania,804,0,7,7,"(10.971302,-74.765397)"
2019,Marzo,México,484,36,26,62,"(10.408582,-75.538003)"
2020,Enero,Turquía,792,0,0,1,"(10.886611,-74.776708)"
2020,Octubre,Serbia,688,1,0,1,"(3.541112,-76.384584)"
2022,Julio,Canadá,124,2,3,5,"(7.818934,-72.453226)"
2014,Abril,Jamaica,388,3,3,6,"(10.445761,-75.516429)"
2012,Marzo,Brasil,76,0,1,1,"(8.635765,-77.346578)"
2016,Noviembre,El Salvador,222,0,1,1,"(7.818934,-72.453226)"
2012,Diciembre,Santa Lucia,662,0,1,1,"(12.586067,-81.702563)"
2021,Octubre,Desconocido,99999,0,4,4,"(10.445761,-75.516429)"
2017,Abril,República de Irlanda,372,0,1,1,"(10.971302,-74.765397)"
2021,Noviembre,Noruega,578,3,13,16,"(10.445761,-75.516429)"
2014,Septiembre,India,356,0,1,1,"(10.971302,-74.765397)"
2021,Abril,Estados Unidos de América,840,0,1,1,"(6.185799,-67.483929)"
2017,Noviembre,Croacia,191,0,2,2,"(0.25129,-76.875963)"
2017,Enero,República de Corea,410,1,2,3,"(12.586067,-81.702563)"
2021,Julio,Grecia,300,1,7,8,"(6.171601,-75.427454)"
2018,Enero,Costa Rica,188,15,11,26,"(4.815061,-75.736532)"
2019,Marzo,Santa Lucia,662,0,1,1,"(6.171601,-75.427454)"
2019,Noviembre,España,724,1,4,5,"(0.25129,-76.875963)"
2016,Julio,Finlandia,246,1,7,8,"(10.445761,-75.516429)"
2016,Octubre,Ecuador,218,16,13,29,"(10.408582,-75.538003)"
2017,Febrero,Francia,250,2,3,5,"(12.586067,-81.702563)"
2019,Diciembre,Panamá,591,1587,1693,3280,"(6.171601,-75.427454)"
2020,Marzo,Grecia,300,0,3,3,"(10.408582,-75.538003)"
2015,Febrero,Suecia,752,0,1,1,"(7.088729,-70.740253)"
2020,Enero,Nepal,524,1,0,1,"(10.886611,-74.776708)"
2022,Abril,Chipre,196,1,0,1,"(6.171601,-75.427454)"
2022,Septiembre,España,724,1,1,2,"(6.18189,-67.47535)"
2017,Febrero,Polonia,616,0,1,1,"(12.586067,-81.702563)"
2017,Mayo,Uruguay,858,6,5,11,"(4.815061,-75.736532)"
2019,Mayo,Letonia,428,4,9,13,"(4.697144,-74.140516)"
2022,Febrero,Federación de Rusia,643,260,262,522,"(4.697144,-74.140516)"
2014,Diciembre,Polonia,616,9,10,19,"(11.360009,-72.129330)"
2012,Julio,Tailandia,764,1,0,1,"(0.814836,-77.662532)"
2015,Julio,Letonia,428,9,10,19,"(4.697144,-74.140516)"
2015,Junio,China,156,7,7,14,"(10.445761,-75.516429)"
2019,Julio,Austria,40,34,47,81,"(6.171601,-75.427454)"
2022,Mayo,Marruecos,504,2,7,9,"(10.445761,-75.516429)"
2019,Junio,Grecia,300,2,10,12,"(10.445761,-75.516429)"
2015,Junio,Brasil,76,0,1,1,"(0.25129,-76.875963)"
2023,Enero,Israel,376,2,5,7,"(10.886611,-74.776708)"
2018,Diciembre,Perú,604,0,4,4,"(12.5744111,-81.703935)"
2013,Marzo,Panamá,591,1,5,6,"(8.635765,-77.346578)"
2022,Septiembre,Italia,380,1,3,4,"(8.635765,-77.346578)"
2022,Noviembre,Guatemala,320,0,1,1,"(11.360009,-72.129330)"
2021,Febrero,Japón,392,0,1,1,"(10.886611,-74.776708)"
2023,Enero,Italia,380,2,16,18,"(10.408582,-75.538003)"
2014,Junio,Portugal,620,3,13,16,"(3.541112,-76.384584)"
2019,Febrero,Namibia,516,1,0,1,"(4.697144,-74.140516)"
2013,Febrero,Burundi,108,0,1,1,"(4.697144,-74.140516)"
2015,Junio,México,484,479,1030,1509,"(6.171601,-75.427454)"
2015,Diciembre,España,724,265,608,873,"(6.171601,-75.427454)"
2023,Marzo,Portugal,620,20,23,43,"(7.818934,-72.453226)"
2014,Febrero,Australia,36,17,43,60,"(0.814836,-77.662532)"
2014,Junio,Eslovaquia,703,11,12,23,"(4.697144,-74.140516)"
2022,Diciembre,República Dominicana,214,1,6,7,"(7.927209,-72.507910)"
2015,Junio,Tailandia,764,29,21,50,"(4.697144,-74.140516)"
2021,Noviembre,Bosnia y Herzegovina,70,1,0,1,"(10.886611,-74.776708)"
2013,Marzo,Dinamarca,208,1,4,5,"(3.541112,-76.384584)"
2016,Diciembre,Filipinas,608,0,1,1,"(7.128456,-73.183637)"
2015,Mayo,Eslovenia,705,0,4,4,"(3.541112,-76.384584)"
2016,Enero,Granada,308,0,1,1,"(10.886611,-74.776708)"
2012,Julio,Hungría,348,0,2,2,"(0.814836,-77.662532)"
2012,Abril,Estados Unidos de América,840,0,1,1,"(0.25129,-76.875963)"
2016,Enero,Desconocido,99999,5,2,7,"(10.445761,-75.516429)"
2021,Octubre,China,156,0,1,1,"(7.818934,-72.453226)"
2015,Mayo,Costa Rica,188,1,3,4,"(7.818934,-72.453226)"
2013,Abril,Austria,40,1,2,3,"(10.886611,-74.776708)"
2018,Junio,Canadá,124,1075,1574,2649,"(4.697144,-74.140516)"
2015,Diciembre,Guatemala,320,1,0,1,"(13.3387613,-81.372937)"
2012,Noviembre,Polonia,616,0,1,1,"(3.893038,-77.067921)"
2013,Diciembre,Taiwán,158,1,0,1,"(7.818934,-72.453226)"
2018,Noviembre,Albania,8,5,17,22,"(4.697144,-74.140516)"
2017,Agosto,Costa Rica,188,0,3,3,"(4.452882,-75.766298)"
2023,Abril,Italia,380,1,0,1,"(6.18189,-67.47535)"
2012,Octubre,Filipinas,608,0,1,1,"(9.402978,-75.681599)"
2012,Noviembre,México,484,17,40,57,"(7.818934,-72.453226)"
2015,Mayo,Dinamarca,208,0,1,1,"(10.971302,-74.765397)"
2013,Septiembre,Benín,204,1,0,1,"(4.697144,-74.140516)"
2018,Septiembre,Perú,604,23,27,50,"(-4.223468,-69.945098)"
2012,Febrero,Paraguay,600,0,1,1,"(10.886611,-74.776708)"
2012,Agosto,Taiwán,158,0,2,2,"(7.818934,-72.453226)"
2013,Diciembre,Myanmar,104,0,14,14,"(4.697144,-74.140516)"
2016,Diciembre,Alemania,276,0,1,1,"(8.36068,-72.409396)"
2018,Diciembre,Japón,392,1,1,2,"(12.586067,-81.702563)"
2017,Febrero,Venezuela,862,52,43,95,"(3.866713,-67.927521)"
2013,Diciembre,Japón,392,0,2,2,"(7.927209,-72.507910)"
2017,Febrero,Australia,36,17,31,48,"(3.541112,-76.384584)"
2014,Junio,Barbados,52,0,1,1,"(0.814836,-77.662532)"
2018,Febrero,Estonia,233,1,0,1,"(0.814836,-77.662532)"
2015,Marzo,Australia,36,22,82,104,"(6.171601,-75.427454)"
2018,Diciembre,Bélgica,56,12,21,33,"(3.541112,-76.384584)"
2018,Mayo,Nicaragua,558,1,2,3,"(4.815061,-75.736532)"
2017,Diciembre,Bahamas,44,1,0,1,"(11.247723,-74.213989)"
2022,Noviembre,Estados Unidos de América,840,56,76,132,"(10.408582,-75.538003)"
2013,Marzo,Polonia,616,1,2,3,"(-4.197703,-69.941278)"
2013,Octubre,Perú,604,150,126,276,"(10.445761,-75.516429)"
2023,Junio,Tailandia,764,1,0,1,"(10.886611,-74.776708)"
2023,Enero,Hungría,348,5,8,13,"(3.541112,-76.384584)"
2022,Agosto,Nigeria,566,0,7,7,"(6.171601,-75.427454)"
2012,Febrero,Jordania,400,1,4,5,"(4.697144,-74.140516)"
2022,Marzo,Noruega,578,8,10,18,"(10.445761,-75.516429)"
2016,Abril,Georgia,268,1,0,1,"(3.541112,-76.384584)"
2013,Junio,India,356,3,2,5,"(0.814836,-77.662532)"
2017,Julio,Islandia,352,8,19,27,"(4.697144,-74.140516)"
2018,Agosto,Estados Unidos de América,840,16,46,62,"(-4.197703,-69.941278)"
2022,Septiembre,Australia,36,2,8,10,"(10.886611,-74.776708)"
2014,Septiembre,Chipre,196,1,5,6,"(4.697144,-74.140516)"
2020,Enero,Bolivia,68,4,0,4,"(-4.223468,-69.945098)"
2018,Enero,España,724,0,2,2,"(10.971302,-74.765397)"
2017,Diciembre,Austria,40,2,3,5,"(8.635765,-77.346578)"
2023,Febrero,Albania,8,0,1,1,"(3.541112,-76.384584)"
2012,Junio,República de Armenia,51,0,1,1,"(4.697144,-74.140516)"
2020,Febrero,Macedonia,807,0,1,1,"(3.541112,-76.384584)"
2022,Septiembre,Santa Lucia,662,0,1,1,"(0.814836,-77.662532)"
2021,Enero,Belice,84,0,2,2,"(6.171601,-75.427454)"
2018,Abril,Barbados,52,9,12,21,"(4.697144,-74.140516)"
2013,Mayo,Italia,380,1,0,1,"(7.128456,-73.183637)"
2017,Agosto,Israel,376,1,3,4,"(10.408582,-75.538003)"
2022,Marzo,Honduras,340,1,1,2,"(4.815061,-75.736532)"
2023,Marzo,Venezuela,862,289,266,555,"(10.445761,-75.516429)"
2013,Agosto,Ecuador,218,2,1,3,"(4.815061,-75.736532)"
2012,Febrero,Israel,376,32,28,60,"(-4.197703,-69.941278)"
2021,Junio,Emiratos Árabes,784,0,5,5,"(4.697144,-74.140516)"
2022,Enero,Filipinas,608,3,20,23,"(10.445761,-75.516429)"
2013,Julio,Ghana,288,1,1,2,"(4.697144,-74.140516)"
2014,Julio,Uzbekistán,860,1,0,1,"(10.445761,-75.516429)"
2016,Diciembre,Austria,40,0,2,2,"(7.818934,-72.453226)"
